ds,table_name,pg_stat_get_live_tuples,pg_stat_get_dead_tuples,pg_table_size,relid,schemaname,relname,seq_scan,seq_tup_read,idx_scan,idx_tup_fetch,n_tup_ins,n_tup_upd,n_tup_del,n_tup_hot_upd,n_live_tup,n_dead_tup,n_mod_since_analyze,n_ins_since_vacuum,last_vacuum,last_autovacuum,last_analyze,last_autoanalyze,vacuum_count,autovacuum_count,analyze_count,autoanalyze_count
1650439678.5564075,public.usertable,50000,0,58556416,16782,public,usertable,1,0,0,0,50000,0,0,0,50000,0,50000,50000,,,,,0,0,0,0
1650439679.575242,public.usertable,50000,0,58613760,16782,public,usertable,1,0,1,1,50000,0,0,0,50000,0,50000,50000,,,,,0,0,0,0
1650439680.6110828,public.usertable,50064,149,58834944,16782,public,usertable,1,0,344,4699,50139,76,75,10,50064,149,50290,50139,,,,,0,0,0,0
1650439681.6402187,public.usertable,50130,290,59129856,16782,public,usertable,1,0,761,17239,50302,122,172,19,50130,290,50596,50302,,,,,0,0,0,0
1650439682.6684885,public.usertable,50226,482,59482112,16782,public,usertable,1,0,1330,27226,50507,213,281,36,50226,482,51001,50507,,,,,0,0,0,0
1650439683.7008052,public.usertable,50345,676,59826176,16782,public,usertable,1,0,1947,38197,50734,301,389,55,50345,676,51424,50734,,,,,0,0,0,0
1650439684.7313495,public.usertable,50468,857,60162048,16782,public,usertable,1,0,2577,46038,50959,393,491,74,50468,857,51843,50959,,,,,0,0,0,0
1650439685.7606115,public.usertable,50586,1033,60538880,16782,public,usertable,1,0,3187,53224,51176,472,590,93,50586,1033,52238,51176,,,,,0,0,0,0
1650439686.7900755,public.usertable,50752,1209,60915712,16782,public,usertable,1,0,3899,61588,51441,550,689,109,50752,1209,52680,51441,,,,,0,0,0,0
1650439687.8196275,public.usertable,50891,1387,61259776,16782,public,usertable,1,0,4666,73488,51673,643,782,131,50891,1387,53098,51673,,,,,0,0,0,0
1650439688.8482375,public.usertable,50998,1545,61587456,16782,public,usertable,1,0,5211,80835,51885,701,887,138,50998,1545,53473,51885,,,,,0,0,0,0
1650439689.877763,public.usertable,51157,1703,61964288,16782,public,usertable,1,0,5812,90914,52133,773,976,157,51157,1703,53882,52133,,,,,0,0,0,0
1650439690.9065347,public.usertable,51413,1952,62365696,16782,public,usertable,1,0,6923,104867,52532,882,1119,175,51413,1952,54533,52532,,,,,0,0,0,0
1650439691.936425,public.usertable,51565,2114,62734336,16782,public,usertable,1,0,7595,112342,52780,954,1215,187,51565,2114,54949,52780,,,,,0,0,0,0
1650439692.967329,public.usertable,51730,2263,63102976,16782,public,usertable,1,0,8208,117558,53019,1034,1289,200,51730,2263,55342,53019,,,,,0,0,0,0
1650439693.9983056,public.usertable,51864,2426,63438848,16782,public,usertable,1,0,8893,123696,53245,1108,1381,217,51864,2426,55734,53245,,,,,0,0,0,0
1650439695.0268784,public.usertable,52032,2564,63782912,16782,public,usertable,1,0,9577,129813,53495,1169,1463,237,52032,2564,56127,53495,,,,,0,0,0,0
1650439696.0565703,public.usertable,52199,2707,64151552,16782,public,usertable,1,0,10253,135307,53745,1230,1546,246,52199,2707,56521,53745,,,,,0,0,0,0
1650439697.086033,public.usertable,52385,2866,64561152,16782,public,usertable,1,0,10946,140024,54020,1304,1635,264,52385,2866,56959,54020,,,,,0,0,0,0
1650439698.11775,public.usertable,52553,3005,64897024,16782,public,usertable,1,0,11643,147983,54267,1372,1714,280,52553,3005,57353,54267,,,,,0,0,0,0
1650439699.1475646,public.usertable,52687,3125,65216512,16782,public,usertable,1,0,12235,156044,54473,1424,1786,294,52687,3125,57683,54473,,,,,0,0,0,0
1650439700.1766593,public.usertable,52883,3260,65617920,16782,public,usertable,1,0,12964,165668,54756,1486,1873,309,52883,3260,58115,54756,,,,,0,0,0,0
1650439701.206143,public.usertable,53105,3414,66052096,16782,public,usertable,1,0,13724,171771,55067,1553,1962,328,53105,3414,58582,55067,,,,,0,0,0,0
1650439702.2352853,public.usertable,53308,3578,66486272,16782,public,usertable,1,0,14492,178285,55361,1632,2053,350,53308,3578,59046,55361,,,,,0,0,0,0
1650439703.2656333,public.usertable,53529,3732,66920448,16782,public,usertable,1,0,15207,186205,55665,1711,2136,370,53529,3732,59512,55665,,,,,0,0,0,0
1650439704.2949784,public.usertable,53735,3895,67338240,16782,public,usertable,1,0,16007,196203,55970,1782,2235,385,53735,3895,59987,55970,,,,,0,0,0,0
1650439705.3300035,public.usertable,53940,4044,67756032,16782,public,usertable,1,0,16758,200834,56258,1853,2318,407,53940,4044,60429,56258,,,,,0,0,0,0
1650439706.3596013,public.usertable,54152,4200,68190208,16782,public,usertable,1,0,17621,208745,56569,1915,2417,424,54152,4200,60901,56569,,,,,0,0,0,0
1650439707.389462,public.usertable,54378,4349,68616192,16782,public,usertable,1,0,18499,216975,56885,1982,2507,442,54378,4349,61374,56885,,,,,0,0,0,0
1650439708.4179869,public.usertable,54677,4581,69042176,16782,public,usertable,1,0,19712,226486,57324,2091,2647,470,54677,4581,62062,57324,,,,,0,0,0,0
1650439709.450538,public.usertable,54791,4658,69312512,16782,public,usertable,1,0,20109,228180,57485,2123,2694,483,54791,4658,62302,57485,,,,,0,0,0,0
1650439710.4791608,public.usertable,55024,4810,69689344,16782,public,usertable,1,0,20891,233873,57790,2205,2766,503,55024,4810,62761,57790,,,,,0,0,0,0
1650439711.508826,public.usertable,55224,4966,70082560,16782,public,usertable,1,0,21657,239707,58069,2284,2845,526,55224,4966,63198,58069,,,,,0,0,0,0
1650439712.5383823,public.usertable,55404,5065,70402048,16782,public,usertable,1,0,22326,245045,58303,2335,2899,542,55404,5065,63537,58303,,,,,0,0,0,0
1650439713.56838,public.usertable,55569,5166,70696960,16782,public,usertable,1,0,22880,251770,58524,2383,2955,560,55569,5166,63862,58524,,,,,0,0,0,0
1650439714.597374,public.usertable,55688,5276,70967296,16782,public,usertable,1,0,23425,254911,58710,2430,3022,571,55688,5276,64162,58710,,,,,0,0,0,0
1650439715.6278822,public.usertable,55824,5383,71237632,16782,public,usertable,1,0,23965,259730,58907,2481,3083,590,55824,5383,64471,58907,,,,,0,0,0,0
1650439716.660622,public.usertable,55952,5490,71507968,16782,public,usertable,1,0,24530,263824,59092,2534,3140,605,55952,5490,64766,59092,,,,,0,0,0,0
1650439717.6910837,public.usertable,56082,5590,71794688,16782,public,usertable,1,0,25064,270074,59285,2580,3203,619,56082,5590,65068,59285,,,,,0,0,0,0
1650439718.7212286,public.usertable,56247,5680,72097792,16782,public,usertable,1,0,25621,275881,59509,2618,3262,631,56247,5680,65389,59509,,,,,0,0,0,0
1650439719.7559867,public.usertable,56411,5782,72392704,16782,public,usertable,1,0,26147,277682,59727,2669,3316,641,56411,5782,65712,59727,,,,,0,0,0,0
1650439720.788772,public.usertable,56578,5867,72712192,16782,public,usertable,1,0,26685,279873,59938,2711,3360,652,56578,5867,66009,59938,,,,,0,0,0,0
1650439721.819387,public.usertable,56749,5944,72974336,16782,public,usertable,1,0,27173,281973,60152,2746,3403,663,56749,5944,66301,60152,,,,,0,0,0,0
1650439722.849927,public.usertable,56904,6042,73261056,16782,public,usertable,1,0,27760,284737,60359,2792,3455,680,56904,6042,66606,60359,,,,,0,0,0,0
1650439723.880067,public.usertable,57061,6145,73564160,16782,public,usertable,1,0,28404,286767,60578,2834,3517,688,57061,6145,66929,60578,,,,,0,0,0,0
1650439724.9103863,public.usertable,57217,6235,73826304,16782,public,usertable,1,0,28991,289149,60791,2868,3574,700,57217,6235,67233,60791,,,,,0,0,0,0
1650439725.9396129,public.usertable,57326,6361,74113024,16782,public,usertable,1,0,29611,294497,60978,2926,3652,715,57326,6361,67556,60978,,,,,0,0,0,0
1650439726.9694157,public.usertable,57497,6455,74506240,16782,public,usertable,1,0,30171,297030,61205,2968,3708,730,57497,6455,67881,61205,,,,,0,0,0,0
1650439728.0035176,public.usertable,57720,6585,74858496,16782,public,usertable,1,0,30956,300963,61494,3038,3774,751,57720,6585,68306,61494,,,,,0,0,0,0
1650439729.034046,public.usertable,57927,6706,75243520,16782,public,usertable,1,0,31691,306693,61774,3094,3847,779,57927,6706,68715,61774,,,,,0,0,0,0
1650439730.0629334,public.usertable,58229,6919,75644928,16782,public,usertable,1,0,32813,312810,62204,3183,3975,812,58229,6919,69362,62204,,,,,0,0,0,0
1650439731.092826,public.usertable,58451,7056,76054528,16782,public,usertable,1,0,33576,315485,62502,3246,4051,829,58451,7056,69799,62502,,,,,0,0,0,0
1650439732.1224246,public.usertable,58697,7171,76480512,16782,public,usertable,1,0,34338,319590,62812,3304,4115,843,58697,7171,70231,62812,,,,,0,0,0,0
1650439733.155093,public.usertable,58895,7314,76865536,16782,public,usertable,1,0,35135,322587,63087,3376,4192,867,58895,7314,70655,63087,,,,,0,0,0,0
1650439734.1872036,public.usertable,59112,7440,77266944,16782,public,usertable,1,0,35938,326885,63382,3439,4270,891,59112,7440,71091,63382,,,,,0,0,0,0
1650439735.2189648,public.usertable,59300,7558,77619200,16782,public,usertable,1,0,36641,329402,63645,3485,4345,902,59300,7558,71475,63645,,,,,0,0,0,0
1650439736.247657,public.usertable,59482,7639,77938688,16782,public,usertable,1,0,37150,332741,63873,3521,4391,912,59482,7639,71785,63873,,,,,0,0,0,0
1650439737.2763197,public.usertable,59678,7732,78258176,16782,public,usertable,1,0,37729,335677,64123,3563,4445,927,59678,7732,72131,64123,,,,,0,0,0,0
1650439738.305965,public.usertable,59867,7832,78585856,16782,public,usertable,1,0,38327,339182,64372,3615,4505,937,59867,7832,72492,64372,,,,,0,0,0,0
1650439739.3366363,public.usertable,60018,7943,78888960,16782,public,usertable,1,0,38945,340247,64579,3670,4561,961,60018,7943,72810,64579,,,,,0,0,0,0
1650439740.365737,public.usertable,60187,8034,79151104,16782,public,usertable,1,0,39553,344516,64797,3717,4610,979,60187,8034,73124,64797,,,,,0,0,0,0
1650439741.3957577,public.usertable,60321,8124,79429632,16782,public,usertable,1,0,40106,347090,64983,3756,4662,994,60321,8124,73401,64983,,,,,0,0,0,0
1650439742.4264672,public.usertable,60481,8216,79699968,16782,public,usertable,1,0,40681,348793,65199,3796,4718,1009,60481,8216,73713,65199,,,,,0,0,0,0
1650439743.4590774,public.usertable,60632,8299,80011264,16782,public,usertable,1,0,41181,354065,65403,3835,4771,1025,60632,8299,74009,65403,,,,,0,0,0,0
1650439744.4908617,public.usertable,60852,8404,80379904,16782,public,usertable,1,0,41979,360483,65683,3883,4831,1039,60852,8404,74397,65683,,,,,0,0,0,0
1650439745.5200648,public.usertable,61082,8505,80797696,16782,public,usertable,1,0,42700,365125,65974,3934,4892,1056,61082,8505,74800,65974,,,,,0,0,0,0
1650439746.5498288,public.usertable,61326,8637,81231872,16782,public,usertable,1,0,43584,369344,66282,4008,4956,1084,61326,8637,75246,66282,,,,,0,0,0,0
1650439747.58132,public.usertable,61608,8748,81657856,16782,public,usertable,1,0,44443,374698,66622,4074,5014,1104,61608,8748,75710,66622,,,,,0,0,0,0
1650439748.611659,public.usertable,61834,8855,82034688,16782,public,usertable,1,0,45196,379303,66908,4130,5074,1130,61834,8855,76112,66908,,,,,0,0,0,0
1650439749.642867,public.usertable,62046,8973,82403328,16782,public,usertable,1,0,45992,384885,67186,4185,5140,1148,62046,8973,76511,67186,,,,,0,0,0,0
1650439750.6717649,public.usertable,62309,9140,82722816,16782,public,usertable,1,0,47099,392533,67558,4248,5249,1173,62309,9140,77055,67558,,,,,0,0,0,0
1650439751.6999273,public.usertable,62510,9228,83050496,16782,public,usertable,1,0,47730,395130,67804,4293,5294,1186,62510,9228,77391,67804,,,,,0,0,0,0
1650439752.7316356,public.usertable,62672,9333,83353600,16782,public,usertable,1,0,48341,397111,68015,4351,5343,1205,62672,9333,77709,68015,,,,,0,0,0,0
1650439753.759899,public.usertable,62809,9421,83607552,16782,public,usertable,1,0,48897,401109,68210,4388,5401,1217,62809,9421,77999,68210,,,,,0,0,0,0
1650439754.7988012,public.usertable,62950,9512,83869696,16782,public,usertable,1,0,49443,402740,68401,4431,5451,1234,62950,9512,78283,68401,,,,,0,0,0,0
1650439755.8278432,public.usertable,63096,9583,84148224,16782,public,usertable,1,0,49985,405772,68595,4468,5499,1241,63096,9583,78562,68595,,,,,0,0,0,0
1650439756.8563952,public.usertable,63254,9665,84410368,16782,public,usertable,1,0,50571,408602,68806,4502,5552,1253,63254,9665,78860,68806,,,,,0,0,0,0
1650439757.889327,public.usertable,63390,9737,84664320,16782,public,usertable,1,0,51055,410337,68986,4532,5596,1264,63390,9737,79114,68986,,,,,0,0,0,0
1650439758.9176211,public.usertable,63537,9801,84910080,16782,public,usertable,1,0,51549,412952,69175,4560,5638,1281,63537,9801,79373,69175,,,,,0,0,0,0
1650439759.9477386,public.usertable,63692,9910,85221376,16782,public,usertable,1,0,52146,416727,69388,4614,5696,1300,63692,9910,79698,69388,,,,,0,0,0,0
1650439760.9804034,public.usertable,63877,10002,85540864,16782,public,usertable,1,0,52730,418797,69633,4654,5756,1313,63877,10002,80043,69633,,,,,0,0,0,0
1650439762.0095718,public.usertable,64052,10121,85868544,16782,public,usertable,1,0,53493,421373,69880,4702,5828,1328,64052,10121,80410,69880,,,,,0,0,0,0
1650439763.0396588,public.usertable,64223,10224,86212608,16782,public,usertable,1,0,54222,425122,70113,4757,5890,1349,64223,10224,80760,70113,,,,,0,0,0,0
1650439764.0709653,public.usertable,64412,10324,86548480,16782,public,usertable,1,0,54848,428692,70358,4804,5946,1364,64412,10324,81108,70358,,,,,0,0,0,0
1650439765.0996265,public.usertable,64620,10440,86892544,16782,public,usertable,1,0,55583,432441,70631,4859,6011,1383,64620,10440,81501,70631,,,,,0,0,0,0
1650439766.1302083,public.usertable,64810,10537,87244800,16782,public,usertable,1,0,56243,435033,70880,4908,6070,1400,64810,10537,81858,70880,,,,,0,0,0,0
1650439767.1583588,public.usertable,65006,10627,87605248,16782,public,usertable,1,0,56943,438738,71131,4948,6125,1413,65006,10627,82204,71131,,,,,0,0,0,0
1650439768.1878095,public.usertable,65216,10732,87908352,16782,public,usertable,1,0,57642,442243,71400,4995,6184,1428,65216,10732,82579,71400,,,,,0,0,0,0
1650439769.2173924,public.usertable,65417,10825,88293376,16782,public,usertable,1,0,58292,444309,71648,5043,6231,1443,65417,10825,82922,71648,,,,,0,0,0,0
1650439770.2461061,public.usertable,65676,10920,88727552,16782,public,usertable,1,0,59044,448361,71969,5092,6293,1463,65676,10920,83354,71969,,,,,0,0,0,0
1650439771.2753778,public.usertable,66031,11115,89145344,16782,public,usertable,1,0,60341,454264,72428,5192,6397,1502,66031,11115,84017,72428,,,,,0,0,0,0
1650439772.3035648,public.usertable,66295,11227,89579520,16782,public,usertable,1,0,61162,459633,72755,5251,6460,1527,66295,11227,84466,72755,,,,,0,0,0,0
1650439773.3321147,public.usertable,66564,11333,90005504,16782,public,usertable,1,0,61956,464062,73079,5309,6515,1554,66564,11333,84903,73079,,,,,0,0,0,0
1650439774.362937,public.usertable,66804,11444,90406912,16782,public,usertable,1,0,62795,467171,73388,5357,6584,1575,66804,11444,85329,73388,,,,,0,0,0,0
1650439775.391939,public.usertable,66986,11572,90775552,16782,public,usertable,1,0,63571,470996,73655,5408,6669,1596,66986,11572,85732,73655,,,,,0,0,0,0
1650439776.4247682,public.usertable,67210,11665,91144192,16782,public,usertable,1,0,64398,476380,73937,5451,6727,1610,67210,11665,86115,73937,,,,,0,0,0,0
1650439777.454769,public.usertable,67450,11777,91545600,16782,public,usertable,1,0,65250,479414,74235,5512,6785,1634,67450,11777,86532,74235,,,,,0,0,0,0
1650439778.4857225,public.usertable,67661,11879,91906048,16782,public,usertable,1,0,65951,482658,74503,5560,6842,1652,67661,11879,86905,74503,,,,,0,0,0,0
1650439779.5152287,public.usertable,67909,11984,92315648,16782,public,usertable,1,0,66899,485983,74805,5618,6896,1670,67909,11984,87319,74805,,,,,0,0,0,0
1650439780.5433517,public.usertable,68154,12076,92708864,16782,public,usertable,1,0,67726,487980,75101,5663,6947,1685,68154,12076,87711,75101,,,,,0,0,0,0
1650439781.5741286,public.usertable,68388,12188,93102080,16782,public,usertable,1,0,68655,492300,75401,5717,7013,1706,68388,12188,88131,75401,,,,,0,0,0,0
1650439782.60856,public.usertable,68617,12287,93495296,16782,public,usertable,1,0,69453,496558,75689,5761,7072,1722,68617,12287,88522,75689,,,,,0,0,0,0
1650439783.6373363,public.usertable,68860,12399,93880320,16782,public,usertable,1,0,70290,500609,75990,5820,7130,1746,68860,12399,88940,75990,,,,,0,0,0,0
1650439784.667273,public.usertable,69106,12497,94298112,16782,public,usertable,1,0,71184,504418,76285,5877,7179,1766,69106,12497,89341,76285,,,,,0,0,0,0
1650439785.700651,public.usertable,69362,12605,94724096,16782,public,usertable,1,0,71985,506505,76606,5927,7244,1788,69362,12605,89777,76606,,,,,0,0,0,0
1650439786.7294538,public.usertable,69626,12708,95125504,16782,public,usertable,1,0,72836,509724,76930,5973,7304,1804,69626,12708,90207,76930,,,,,0,0,0,0
1650439787.7598014,public.usertable,69853,12820,95510528,16782,public,usertable,1,0,73630,512594,77218,6029,7365,1825,69853,12820,90612,77218,,,,,0,0,0,0
1650439788.788467,public.usertable,70069,12923,95911936,16782,public,usertable,1,0,74431,517853,77495,6081,7426,1840,70069,12923,91002,77495,,,,,0,0,0,0
1650439789.8191388,public.usertable,70464,13067,96337920,16782,public,usertable,1,0,75682,523964,77972,6155,7508,1868,70464,13067,91635,77972,,,,,0,0,0,0
1650439790.8476508,public.usertable,70741,13185,96796672,16782,public,usertable,1,0,76547,526507,78313,6214,7572,1885,70741,13185,92099,78313,,,,,0,0,0,0
1650439791.877789,public.usertable,71009,13273,97214464,16782,public,usertable,1,0,77300,529858,78642,6255,7633,1901,71009,13273,92530,78642,,,,,0,0,0,0
1650439792.9070716,public.usertable,71289,13376,97665024,16782,public,usertable,1,0,78150,533987,78979,6305,7690,1919,71289,13376,92974,78979,,,,,0,0,0,0
1650439793.9368238,public.usertable,71575,13473,98107392,16782,public,usertable,1,0,78962,537201,79320,6351,7745,1938,71575,13473,93416,79320,,,,,0,0,0,0
1650439794.9729214,public.usertable,71819,13594,98533376,16782,public,usertable,1,0,79848,540236,79646,6395,7827,1954,71819,13594,93868,79646,,,,,0,0,0,0
1650439796.0021663,public.usertable,72082,13705,98967552,16782,public,usertable,1,0,80707,543266,79976,6445,7894,1975,72082,13705,94315,79976,,,,,0,0,0,0
1650439797.0330722,public.usertable,72308,13835,99360768,16782,public,usertable,1,0,81594,546300,80274,6506,7966,1999,72308,13835,94746,80274,,,,,0,0,0,0
1650439798.063302,public.usertable,72563,13924,99778560,16782,public,usertable,1,0,82441,549175,80585,6546,8022,2017,72563,13924,95153,80585,,,,,0,0,0,0
1650439799.0936818,public.usertable,72843,14012,100196352,16782,public,usertable,1,0,83306,552590,80915,6591,8072,2035,72843,14012,95578,80915,,,,,0,0,0,0
1650439800.1230578,public.usertable,73109,14117,100638720,16782,public,usertable,1,0,84161,556971,81245,6640,8136,2058,73109,14117,96021,81245,,,,,0,0,0,0
1650439801.1556416,public.usertable,73394,14220,101072896,16782,public,usertable,1,0,85063,561304,81589,6693,8195,2078,73394,14220,96477,81589,,,,,0,0,0,0
1650439802.1840587,public.usertable,73576,14337,101425152,16782,public,usertable,1,0,85893,563830,81839,6753,8263,2104,73576,14337,96855,81839,,,,,0,0,0,0
1650439803.2150276,public.usertable,73827,14443,101842944,16782,public,usertable,1,0,86709,567911,82153,6803,8326,2122,73827,14443,97282,82153,,,,,0,0,0,0
1650439804.245279,public.usertable,74074,14551,102260736,16782,public,usertable,1,0,87497,572072,82464,6851,8390,2145,74074,14551,97705,82464,,,,,0,0,0,0
1650439805.273343,public.usertable,74355,14626,102662144,16782,public,usertable,1,0,88327,574948,82784,6897,8429,2160,74355,14626,98110,82784,,,,,0,0,0,0
1650439806.3059874,public.usertable,74621,14723,103096320,16782,public,usertable,1,0,89189,579912,83108,6942,8487,2187,74621,14723,98537,83108,,,,,0,0,0,0
1650439807.3391895,public.usertable,75047,14872,103538688,16782,public,usertable,1,0,90509,585001,83617,7018,8570,2220,75047,14872,99205,83617,,,,,0,0,0,0
1650439808.3693361,public.usertable,75295,14961,103923712,16782,public,usertable,1,0,91308,586490,83919,7059,8624,2236,75295,14961,99602,83919,,,,,0,0,0,0
1650439809.3981776,public.usertable,75546,15044,104325120,16782,public,usertable,1,0,92154,589997,84224,7098,8678,2251,75546,15044,100000,84224,,,,,0,0,0,0
1650439810.4257705,public.usertable,75797,15143,104734720,16782,public,usertable,1,0,92958,592826,84536,7143,8739,2269,75797,15143,100418,84536,,,,,0,0,0,0
1650439811.4561791,public.usertable,76042,15219,105095168,16782,public,usertable,1,0,93653,596399,84823,7178,8781,2284,76042,15219,100782,84823,,,,,0,0,0,0
1650439812.4876819,public.usertable,76252,15286,105414656,16782,public,usertable,1,0,94251,597660,85073,7208,8821,2297,76252,15286,101102,85073,,,,,0,0,0,0
1650439813.5169723,public.usertable,76442,15343,105693184,16782,public,usertable,1,0,94825,601007,85304,7231,8862,2311,76442,15343,101397,85304,,,,,0,0,0,0
1650439814.5476756,public.usertable,76615,15393,105947136,16782,public,usertable,1,0,95356,601948,85509,7250,8894,2323,76615,15393,101653,85509,,,,,0,0,0,0
1650439815.5795271,public.usertable,76757,15463,106192896,16782,public,usertable,1,0,95866,603674,85696,7277,8939,2331,76757,15463,101912,85696,,,,,0,0,0,0
1650439816.609531,public.usertable,76916,15537,106455040,16782,public,usertable,1,0,96459,606448,85908,7298,8992,2340,76916,15537,102198,85908,,,,,0,0,0,0
1650439817.637949,public.usertable,77072,15598,106717184,16782,public,usertable,1,0,96920,607763,86100,7324,9028,2350,77072,15598,102452,86100,,,,,0,0,0,0
1650439818.6678681,public.usertable,77262,15652,106987520,16782,public,usertable,1,0,97509,609471,86314,7359,9052,2368,77262,15652,102725,86314,,,,,0,0,0,0
1650439819.698994,public.usertable,77424,15708,107257856,16782,public,usertable,1,0,98090,612754,86514,7389,9090,2378,77424,15708,102993,86514,,,,,0,0,0,0
1650439820.7349699,public.usertable,77600,15777,107610112,16782,public,usertable,1,0,98620,614111,86726,7423,9126,2388,77600,15777,103275,86726,,,,,0,0,0,0
1650439821.767359,public.usertable,77859,15890,108027904,16782,public,usertable,1,0,99489,619867,87048,7482,9189,2414,77859,15890,103719,87048,,,,,0,0,0,0
1650439822.7985768,public.usertable,78140,15985,108445696,16782,public,usertable,1,0,100400,622523,87395,7515,9255,2430,78140,15985,104165,87395,,,,,0,0,0,0
1650439823.8302464,public.usertable,78385,16091,108863488,16782,public,usertable,1,0,101299,626279,87713,7559,9328,2450,78385,16091,104600,87713,,,,,0,0,0,0
1650439824.8591776,public.usertable,78640,16201,109330432,16782,public,usertable,1,0,102164,628622,88034,7606,9394,2469,78640,16201,105034,88034,,,,,0,0,0,0
1650439825.890768,public.usertable,78938,16312,109797376,16782,public,usertable,1,0,103166,632156,88407,7650,9469,2484,78938,16312,105526,88407,,,,,0,0,0,0
1650439826.9219801,public.usertable,79374,16464,110231552,16782,public,usertable,1,0,104506,639034,88925,7731,9551,2523,79374,16464,106207,88925,,,,,0,0,0,0
1650439827.9514818,public.usertable,79645,16580,110665728,16782,public,usertable,1,0,105466,641888,89262,7783,9617,2544,79645,16580,106662,89262,,,,,0,0,0,0
1650439828.980418,public.usertable,79851,16652,110977024,16782,public,usertable,1,0,106118,644113,89502,7823,9651,2565,79851,16652,106976,89502,,,,,0,0,0,0
1650439830.0093386,public.usertable,80046,16721,111288320,16782,public,usertable,1,0,106802,647987,89745,7854,9699,2578,80046,16721,107298,89745,,,,,0,0,0,0
1650439831.0379753,public.usertable,80268,16789,111616000,16782,public,usertable,1,0,107414,649697,90000,7892,9732,2599,80268,16789,107624,90000,,,,,0,0,0,0
1650439832.0691426,public.usertable,80449,16862,111919104,16782,public,usertable,1,0,108064,653015,90234,7921,9785,2614,80449,16862,107940,90234,,,,,0,0,0,0
1650439833.100086,public.usertable,80618,16930,112197632,16782,public,usertable,1,0,108597,656716,90437,7955,9819,2630,80618,16930,108211,90437,,,,,0,0,0,0
1650439834.1292603,public.usertable,80815,16973,112467968,16782,public,usertable,1,0,109190,659446,90664,7981,9849,2634,80815,16973,108494,90664,,,,,0,0,0,0
1650439835.1582272,public.usertable,80994,17031,112730112,16782,public,usertable,1,0,109707,663011,90877,8006,9883,2646,80994,17031,108766,90877,,,,,0,0,0,0
1650439836.1858053,public.usertable,81159,17099,113025024,16782,public,usertable,1,0,110311,665540,91079,8042,9920,2664,81159,17099,109041,91079,,,,,0,0,0,0
1650439837.2143092,public.usertable,81380,17151,113344512,16782,public,usertable,1,0,110956,669676,91333,8074,9953,2681,81380,17151,109360,91333,,,,,0,0,0,0
1650439838.242513,public.usertable,81565,17223,113655808,16782,public,usertable,1,0,111632,670634,91570,8106,10005,2688,81565,17223,109681,91570,,,,,0,0,0,0
1650439839.2719626,public.usertable,81792,17313,114032640,16782,public,usertable,1,0,112373,672117,91839,8157,10047,2712,81792,17313,110043,91839,,,,,0,0,0,0
1650439840.3003798,public.usertable,82024,17405,114376704,16782,public,usertable,1,0,113104,674440,92126,8198,10102,2731,82024,17405,110426,92126,,,,,0,0,0,0
1650439841.3292794,public.usertable,82243,17469,114745344,16782,public,usertable,1,0,113858,676637,92387,8226,10144,2742,82243,17469,110757,92387,,,,,0,0,0,0
1650439842.3600173,public.usertable,82465,17537,115007488,16782,public,usertable,1,0,114496,677179,92648,8255,10183,2754,82465,17537,111086,92648,,,,,0,0,0,0
1650439843.3914099,public.usertable,82595,17588,115228672,16782,public,usertable,1,0,114949,677595,92807,8283,10212,2768,82595,17588,111302,92807,,,,,0,0,0,0
1650439844.4210806,public.usertable,82767,17642,115499008,16782,public,usertable,1,0,115536,679252,93008,8312,10241,2780,82767,17642,111561,93008,,,,,0,0,0,0
1650439845.4499803,public.usertable,82934,17709,115752960,16782,public,usertable,1,0,116127,680478,93210,8346,10276,2794,82934,17709,111832,93210,,,,,0,0,0,0
1650439846.479378,public.usertable,83089,17761,115998720,16782,public,usertable,1,0,116608,682038,93401,8368,10312,2806,83089,17761,112081,93401,,,,,0,0,0,0
1650439847.5081491,public.usertable,83382,17855,116318208,16782,public,usertable,1,0,117528,684799,93748,8420,10366,2834,83382,17855,112534,93748,,,,,0,0,0,0
1650439848.5387592,public.usertable,83605,17918,116645888,16782,public,usertable,1,0,118291,687638,94004,8460,10399,2860,83605,17918,112863,94004,,,,,0,0,0,0
1650439849.5682845,public.usertable,83826,17985,116973568,16782,public,usertable,1,0,118981,690371,94260,8494,10434,2876,83826,17985,113188,94260,,,,,0,0,0,0
1650439850.5998898,public.usertable,84026,18071,117317632,16782,public,usertable,1,0,119740,692629,94518,8525,10492,2887,84026,18071,113535,94518,,,,,0,0,0,0
1650439851.628595,public.usertable,84250,18144,117653504,16782,public,usertable,1,0,120414,694546,94785,8556,10535,2902,84250,18144,113876,94785,,,,,0,0,0,0
1650439852.6584494,public.usertable,84527,18241,118112256,16782,public,usertable,1,0,121366,697682,95118,8603,10591,2916,84527,18241,114312,95118,,,,,0,0,0,0
1650439853.695069,public.usertable,84811,18331,118546432,16782,public,usertable,1,0,122300,701023,95453,8650,10642,2932,84811,18331,114745,95453,,,,,0,0,0,0
1650439854.7246187,public.usertable,85112,18419,118988800,16782,public,usertable,1,0,123185,703508,95809,8691,10697,2953,85112,18419,115197,95809,,,,,0,0,0,0
1650439855.7547193,public.usertable,85364,18514,119406592,16782,public,usertable,1,0,124108,708056,96129,8732,10765,2964,85364,18514,115626,96129,,,,,0,0,0,0
1650439856.7833977,public.usertable,85636,18608,119848960,16782,public,usertable,1,0,124988,710224,96461,8774,10825,2980,85636,18608,116060,96461,,,,,0,0,0,0
1650439857.8151457,public.usertable,85937,18706,120315904,16782,public,usertable,1,0,125913,713823,96825,8817,10888,2997,85937,18706,116530,96825,,,,,0,0,0,0
1650439858.8452022,public.usertable,86238,18808,120799232,16782,public,usertable,1,0,126890,715076,97177,8872,10939,3015,86238,18808,116988,97177,,,,,0,0,0,0
1650439859.8762965,public.usertable,86549,18892,121266176,16782,public,usertable,1,0,127843,718092,97539,8917,10990,3035,86549,18892,117446,97539,,,,,0,0,0,0
1650439860.9051716,public.usertable,86862,18970,121708544,16782,public,usertable,1,0,128692,721920,97897,8960,11035,3051,86862,18970,117892,97897,,,,,0,0,0,0
1650439861.9360962,public.usertable,87162,19051,122150912,16782,public,usertable,1,0,129659,725576,98240,9013,11078,3079,87162,19051,118331,98240,,,,,0,0,0,0
1650439862.9681177,public.usertable,87431,19152,122560512,16782,public,usertable,1,0,130599,727625,98574,9053,11143,3099,87431,19152,118770,98574,,,,,0,0,0,0
1650439864.0033805,public.usertable,87699,19235,122986496,16782,public,usertable,1,0,131430,730898,98891,9090,11192,3110,87699,19235,119173,98891,,,,,0,0,0,0
1650439865.035044,public.usertable,88097,19353,123396096,16782,public,usertable,1,0,132646,734794,99374,9141,11277,3135,88097,19353,119792,99374,,,,,0,0,0,0
1650439866.066544,public.usertable,88373,19442,123822080,16782,public,usertable,1,0,133631,736877,99706,9178,11333,3150,88373,19442,120217,99706,,,,,0,0,0,0
1650439867.0949793,public.usertable,88696,19525,124280832,16782,public,usertable,1,0,134661,739348,100073,9223,11377,3172,88696,19525,120673,100073,,,,,0,0,0,0
1650439868.1239746,public.usertable,88966,19613,124706816,16782,public,usertable,1,0,135539,741666,100395,9269,11429,3187,88966,19613,121093,100395,,,,,0,0,0,0
1650439869.1545959,public.usertable,89251,19687,125124608,16782,public,usertable,1,0,136348,743873,100721,9309,11470,3203,89251,19687,121500,100721,,,,,0,0,0,0
1650439870.1852653,public.usertable,89523,19783,125566976,16782,public,usertable,1,0,137323,747847,101055,9352,11532,3225,89523,19783,121939,101055,,,,,0,0,0,0
1650439871.2160625,public.usertable,89798,19872,125968384,16782,public,usertable,1,0,138129,749845,101383,9391,11585,3245,89798,19872,122359,101383,,,,,0,0,0,0
1650439872.246069,public.usertable,90080,19956,126402560,16782,public,usertable,1,0,138953,753213,101725,9421,11645,3255,90080,19956,122791,101725,,,,,0,0,0,0
1650439873.2751968,public.usertable,90367,20046,126844928,16782,public,usertable,1,0,139867,754422,102072,9456,11705,3270,90367,20046,123233,102072,,,,,0,0,0,0
1650439874.3040874,public.usertable,90650,20115,127254528,16782,public,usertable,1,0,140601,757507,102397,9496,11747,3288,90650,20115,123640,102397,,,,,0,0,0,0
1650439875.334155,public.usertable,90900,20201,127655936,16782,public,usertable,1,0,141473,760663,102698,9537,11798,3308,90900,20201,124033,102698,,,,,0,0,0,0
1650439876.3635213,public.usertable,91163,20287,128049152,16782,public,usertable,1,0,142361,762970,103014,9574,11851,3324,91163,20287,124439,103014,,,,,0,0,0,0
1650439877.395852,public.usertable,91412,20371,128450560,16782,public,usertable,1,0,143191,766538,103320,9608,11908,3337,91412,20371,124836,103320,,,,,0,0,0,0
1650439878.4286022,public.usertable,91694,20454,128876544,16782,public,usertable,1,0,144036,767589,103644,9651,11950,3353,91694,20454,125245,103644,,,,,0,0,0,0
1650439879.4591494,public.usertable,92010,20536,129327104,16782,public,usertable,1,0,145052,771493,104006,9695,11996,3374,92010,20536,125697,104006,,,,,0,0,0,0
1650439880.488729,public.usertable,92278,20607,129736704,16782,public,usertable,1,0,145831,773935,104327,9721,12049,3383,92278,20607,126097,104327,,,,,0,0,0,0
1650439881.5193136,public.usertable,92550,20706,130195456,16782,public,usertable,1,0,146740,776880,104655,9770,12105,3400,92550,20706,126530,104655,,,,,0,0,0,0
1650439882.5491138,public.usertable,92834,20811,130621440,16782,public,usertable,1,0,147725,780078,104993,9823,12159,3429,92834,20811,126975,104993,,,,,0,0,0,0
1650439883.5803468,public.usertable,93143,20895,131063808,16782,public,usertable,1,0,148640,782648,105351,9859,12208,3450,93143,20895,127418,105351,,,,,0,0,0,0
1650439884.6109853,public.usertable,93564,21032,131506176,16782,public,usertable,1,0,150026,787944,105856,9927,12292,3476,93564,21032,128075,105856,,,,,0,0,0,0
1650439885.6404681,public.usertable,93857,21128,131956736,16782,public,usertable,1,0,150930,790709,106203,9971,12346,3502,93857,21128,128520,106203,,,,,0,0,0,0
1650439886.6714268,public.usertable,94222,21202,132456448,16782,public,usertable,1,0,151835,794494,106605,10016,12383,3520,94222,21202,129004,106605,,,,,0,0,0,0
1650439887.701331,public.usertable,94521,21283,132898816,16782,public,usertable,1,0,152760,797041,106950,10055,12429,3535,94521,21283,129434,106950,,,,,0,0,0,0
1650439888.7325943,public.usertable,94810,21376,133365760,16782,public,usertable,1,0,153710,799645,107294,10104,12484,3552,94810,21376,129882,107294,,,,,0,0,0,0
1650439889.762214,public.usertable,95097,21461,133799936,16782,public,usertable,1,0,154728,802102,107639,10139,12542,3569,95097,21461,130320,107639,,,,,0,0,0,0
1650439890.7907174,public.usertable,95395,21546,134250496,16782,public,usertable,1,0,155693,803509,107991,10176,12596,3588,95395,21546,130763,107991,,,,,0,0,0,0
1650439891.8200104,public.usertable,95696,21636,134701056,16782,public,usertable,1,0,156599,806186,108343,10220,12647,3603,95696,21636,131210,108343,,,,,0,0,0,0
1650439892.8514383,public.usertable,95972,21738,135143424,16782,public,usertable,1,0,157614,808978,108669,10276,12697,3626,95972,21738,131642,108669,,,,,0,0,0,0
1650439893.8837147,public.usertable,96274,21825,135569408,16782,public,usertable,1,0,158546,812988,109023,10317,12749,3639,96274,21825,132089,109023,,,,,0,0,0,0
1650439894.9137044,public.usertable,96537,21903,136003584,16782,public,usertable,1,0,159360,814954,109333,10358,12796,3655,96537,21903,132487,109333,,,,,0,0,0,0
1650439895.9421546,public.usertable,96858,21968,136454144,16782,public,usertable,1,0,160261,816101,109704,10388,12846,3670,96858,21968,132938,109704,,,,,0,0,0,0
1650439896.9724886,public.usertable,97165,22022,136912896,16782,public,usertable,1,0,161081,819723,110047,10422,12882,3687,97165,22022,133351,110047,,,,,0,0,0,0
1650439898.0019755,public.usertable,97451,22104,137330688,16782,public,usertable,1,0,161959,821632,110384,10456,12933,3702,97451,22104,133773,110384,,,,,0,0,0,0
1650439899.0308414,public.usertable,97763,22173,137781248,16782,public,usertable,1,0,162909,824701,110741,10489,12978,3719,97763,22173,134208,110741,,,,,0,0,0,0
1650439900.0609925,public.usertable,98041,22253,138141696,16782,public,usertable,1,0,163856,828452,111066,10537,13025,3741,98041,22253,134628,111066,,,,,0,0,0,0
1650439901.090149,public.usertable,98228,22325,138436608,16782,public,usertable,1,0,164568,830688,111300,10567,13072,3755,98228,22325,134939,111300,,,,,0,0,0,0
1650439902.1217349,public.usertable,98422,22367,138674176,16782,public,usertable,1,0,165150,832298,111518,10591,13096,3768,98422,22367,135205,111518,,,,,0,0,0,0
1650439903.1523767,public.usertable,98591,22419,138969088,16782,public,usertable,1,0,165699,833561,111716,10614,13125,3773,98591,22419,135455,111716,,,,,0,0,0,0
1650439904.1822338,public.usertable,98885,22509,139247616,16782,public,usertable,1,0,166730,835503,112060,10658,13175,3794,98885,22509,135893,112060,,,,,0,0,0,0
1650439905.2105784,public.usertable,99070,22557,139517952,16782,public,usertable,1,0,167349,838405,112280,10681,13210,3807,99070,22557,136171,112280,,,,,0,0,0,0
1650439906.2385528,public.usertable,99255,22599,139796480,16782,public,usertable,1,0,167797,838665,112491,10698,13236,3812,99255,22599,136425,112491,,,,,0,0,0,0
1650439907.2657323,public.usertable,99467,22637,140107776,16782,public,usertable,1,0,168397,841304,112730,10719,13263,3820,99467,22637,136712,112730,,,,,0,0,0,0
1650439908.2949584,public.usertable,99668,22696,140410880,16782,public,usertable,1,0,169095,843471,112971,10745,13303,3828,99668,22696,137019,112971,,,,,0,0,0,0
1650439909.326837,public.usertable,99887,22761,140738560,16782,public,usertable,1,0,169737,844147,113225,10777,13338,3843,99887,22761,137340,113225,,,,,0,0,0,0
1650439910.3567395,public.usertable,100189,22834,141205504,16782,public,usertable,1,0,170648,846509,113568,10814,13379,3854,100189,22834,137761,113568,,,,,0,0,0,0
1650439911.3864262,public.usertable,100508,22906,141656064,16782,public,usertable,1,0,171549,848652,113931,10848,13423,3868,100508,22906,138202,113931,,,,,0,0,0,0
1650439912.4167576,public.usertable,100800,23002,142098432,16782,public,usertable,1,0,172454,850301,114279,10891,13479,3891,100800,23002,138649,114279,,,,,0,0,0,0
1650439913.4472528,public.usertable,101100,23089,142548992,16782,public,usertable,1,0,173524,855139,114630,10947,13530,3923,101100,23089,139107,114630,,,,,0,0,0,0
1650439914.4769928,public.usertable,101437,23154,143015936,16782,public,usertable,1,0,174453,857022,115007,10978,13570,3939,101437,23154,139555,115007,,,,,0,0,0,0
1650439915.506026,public.usertable,101743,23228,143482880,16782,public,usertable,1,0,175426,859711,115364,11012,13621,3952,101743,23228,139997,115364,,,,,0,0,0,0
1650439916.5355177,public.usertable,102091,23297,143966208,16782,public,usertable,1,0,176369,862125,115745,11052,13654,3972,102091,23297,140451,115745,,,,,0,0,0,0
1650439917.5647857,public.usertable,102398,23374,144424960,16782,public,usertable,1,0,177236,864655,116106,11081,13708,3981,102398,23374,140895,116106,,,,,0,0,0,0
1650439918.5949059,public.usertable,102735,23459,144900096,16782,public,usertable,1,0,178152,867281,116490,11119,13755,3996,102735,23459,141364,116490,,,,,0,0,0,0
1650439919.6287386,public.usertable,103032,23547,145342464,16782,public,usertable,1,0,179081,869009,116842,11157,13810,4016,103032,23547,141809,116842,,,,,0,0,0,0
1650439920.6592479,public.usertable,103308,23622,145752064,16782,public,usertable,1,0,179981,871763,117165,11194,13857,4030,103308,23622,142216,117165,,,,,0,0,0,0
1650439921.6874936,public.usertable,103579,23694,146153472,16782,public,usertable,1,0,180880,874694,117491,11225,13912,4047,103579,23694,142628,117491,,,,,0,0,0,0
1650439922.7197058,public.usertable,103865,23761,146587648,16782,public,usertable,1,0,181685,878201,117822,11253,13957,4059,103865,23761,143032,117822,,,,,0,0,0,0
1650439923.749491,public.usertable,104323,23843,147021824,16782,public,usertable,1,0,183029,882562,118338,11295,14015,4076,104323,23843,143648,118338,,,,,0,0,0,0
1650439924.7780664,public.usertable,104600,23901,147415040,16782,public,usertable,1,0,183795,884094,118653,11320,14053,4089,104600,23901,144026,118653,,,,,0,0,0,0
1650439925.8089423,public.usertable,104902,23967,147849216,16782,public,usertable,1,0,184666,885744,118997,11350,14095,4102,104902,23967,144442,118997,,,,,0,0,0,0
1650439926.8400493,public.usertable,105238,24045,148340736,16782,public,usertable,1,0,185646,888424,119379,11390,14141,4122,105238,24045,144910,119379,,,,,0,0,0,0
1650439927.8732553,public.usertable,105561,24124,148799488,16782,public,usertable,1,0,186616,892339,119741,11433,14180,4142,105561,24124,145354,119741,,,,,0,0,0,0
1650439928.9041994,public.usertable,105875,24205,149250048,16782,public,usertable,1,0,187577,894847,120101,11473,14226,4164,105875,24205,145800,120101,,,,,0,0,0,0
1650439929.9324846,public.usertable,106180,24286,149700608,16782,public,usertable,1,0,188637,897797,120462,11510,14282,4182,106180,24286,146254,120462,,,,,0,0,0,0
1650439930.961976,public.usertable,106445,24380,150118400,16782,public,usertable,1,0,189625,901000,120793,11548,14348,4203,106445,24380,146689,120793,,,,,0,0,0,0
1650439931.9897318,public.usertable,106740,24451,150552576,16782,public,usertable,1,0,190470,904177,121132,11583,14392,4219,106740,24451,147107,121132,,,,,0,0,0,0
1650439933.0210466,public.usertable,107030,24530,150986752,16782,public,usertable,1,0,191418,905781,121475,11616,14445,4238,107030,24530,147536,121475,,,,,0,0,0,0
1650439934.051921,public.usertable,107341,24608,151429120,16782,public,usertable,1,0,192384,909553,121825,11659,14484,4261,107341,24608,147968,121825,,,,,0,0,0,0
1650439935.0830848,public.usertable,107644,24676,151830528,16782,public,usertable,1,0,193395,914181,122165,11701,14521,4285,107644,24676,148387,122165,,,,,0,0,0,0
1650439936.1119125,public.usertable,107894,24738,152199168,16782,public,usertable,1,0,194162,916239,122447,11735,14553,4301,107894,24738,148735,122447,,,,,0,0,0,0
1650439937.1417553,public.usertable,108151,24817,152592384,16782,public,usertable,1,0,194965,918177,122747,11772,14596,4319,108151,24817,149115,122747,,,,,0,0,0,0
1650439938.1711528,public.usertable,108393,24883,152936448,16782,public,usertable,1,0,195796,920261,123032,11801,14639,4328,108393,24883,149472,123032,,,,,0,0,0,0
1650439939.2025666,public.usertable,108612,24942,153255936,16782,public,usertable,1,0,196492,920685,123292,11820,14680,4339,108612,24942,149792,123292,,,,,0,0,0,0
1650439940.2338104,public.usertable,108865,24997,153583616,16782,public,usertable,1,0,197312,922837,123580,11845,14715,4352,108865,24997,150140,123580,,,,,0,0,0,0
1650439941.2652464,public.usertable,109049,25052,153878528,16782,public,usertable,1,0,197870,924946,123794,11877,14745,4373,109049,25052,150416,123794,,,,,0,0,0,0
1650439942.2974029,public.usertable,109355,25120,154157056,16782,public,usertable,1,0,198760,927723,124141,11910,14786,4389,109355,25120,150837,124141,,,,,0,0,0,0
1650439943.326018,public.usertable,109566,25171,154460160,16782,public,usertable,1,0,199374,928791,124387,11930,14821,4403,109566,25171,151138,124387,,,,,0,0,0,0
1650439944.3554332,public.usertable,109794,25226,154804224,16782,public,usertable,1,0,200068,929592,124652,11949,14858,4412,109794,25226,151459,124652,,,,,0,0,0,0
1650439945.3869157,public.usertable,110017,25285,155123712,16782,public,usertable,1,0,200724,932377,124908,11977,14891,4424,110017,25285,151776,124908,,,,,0,0,0,0
1650439946.4183984,public.usertable,110260,25338,155467776,16782,public,usertable,1,0,201427,935269,125183,12009,14923,4440,110260,25338,152115,125183,,,,,0,0,0,0
1650439947.4486804,public.usertable,110487,25380,155779072,16782,public,usertable,1,0,202025,936670,125437,12029,14950,4450,110487,25380,152416,125437,,,,,0,0,0,0
1650439948.4796643,public.usertable,110756,25440,156180480,16782,public,usertable,1,0,202809,938555,125737,12061,14981,4463,110756,25440,152779,125737,,,,,0,0,0,0
1650439949.512358,public.usertable,111054,25499,156581888,16782,public,usertable,1,0,203732,942213,126073,12091,15019,4484,111054,25499,153183,126073,,,,,0,0,0,0
1650439950.5414379,public.usertable,111298,25553,156942336,16782,public,usertable,1,0,204456,944638,126351,12121,15053,4501,111298,25553,153525,126351,,,,,0,0,0,0
1650439951.5716662,public.usertable,111578,25622,157351936,16782,public,usertable,1,0,205377,947673,126677,12151,15099,4512,111578,25622,153927,126677,,,,,0,0,0,0
1650439952.60459,public.usertable,111851,25692,157753344,16782,public,usertable,1,0,206205,949979,126992,12183,15141,4525,111851,25692,154316,126992,,,,,0,0,0,0
1650439953.6336823,public.usertable,112112,25758,158146560,16782,public,usertable,1,0,207015,951199,127293,12217,15181,4538,112112,25758,154691,127293,,,,,0,0,0,0
1650439954.6653519,public.usertable,112390,25819,158523392,16782,public,usertable,1,0,207834,954845,127609,12248,15219,4556,112390,25819,155076,127609,,,,,0,0,0,0
1650439955.696799,public.usertable,112657,25883,158916608,16782,public,usertable,1,0,208615,955993,127911,12278,15254,4572,112657,25883,155443,127911,,,,,0,0,0,0
1650439956.727431,public.usertable,112942,25931,159334400,16782,public,usertable,1,0,209587,958844,128229,12309,15287,4586,112942,25931,155825,128229,,,,,0,0,0,0
1650439957.7585983,public.usertable,113231,26006,159744000,16782,public,usertable,1,0,210484,960065,128560,12344,15329,4595,113231,26006,156233,128560,,,,,0,0,0,0
1650439958.7867582,public.usertable,113513,26067,160161792,16782,public,usertable,1,0,211297,961161,128876,12372,15363,4610,113513,26067,156611,128876,,,,,0,0,0,0
1650439959.8164856,public.usertable,113846,26130,160612352,16782,public,usertable,1,0,212221,962929,129237,12411,15391,4636,113846,26130,157039,129237,,,,,0,0,0,0
1650439960.846337,public.usertable,114141,26210,161021952,16782,public,usertable,1,0,213089,963815,129581,12447,15440,4651,114141,26210,157468,129581,,,,,0,0,0,0
1650439961.875559,public.usertable,114527,26307,161406976,16782,public,usertable,1,0,214264,965787,130032,12487,15505,4669,114527,26307,158024,130032,,,,,0,0,0,0
1650439962.904808,public.usertable,114791,26364,161783808,16782,public,usertable,1,0,215055,967136,130331,12522,15540,4684,114791,26364,158393,130331,,,,,0,0,0,0
1650439963.936071,public.usertable,115076,26427,162193408,16782,public,usertable,1,0,215907,968972,130656,12551,15580,4697,115076,26427,158787,130656,,,,,0,0,0,0
1650439964.9668114,public.usertable,115376,26489,162627584,16782,public,usertable,1,0,216815,971634,130996,12587,15620,4718,115376,26489,159203,130996,,,,,0,0,0,0
1650439965.9989417,public.usertable,115654,26583,163061760,16782,public,usertable,1,0,217729,974087,131328,12632,15674,4740,115654,26583,159634,131328,,,,,0,0,0,0
1650439967.027751,public.usertable,115974,26646,163512320,16782,public,usertable,1,0,218720,976406,131682,12672,15708,4755,115974,26646,160062,131682,,,,,0,0,0,0
1650439968.0589373,public.usertable,116284,26730,163962880,16782,public,usertable,1,0,219641,978533,132039,12713,15755,4772,116284,26730,160507,132039,,,,,0,0,0,0
1650439969.0900826,public.usertable,116624,26793,164438016,16782,public,usertable,1,0,220582,980161,132419,12743,15795,4787,116624,26793,160957,132419,,,,,0,0,0,0
1650439970.1213653,public.usertable,116947,26863,164904960,16782,public,usertable,1,0,221556,982965,132791,12770,15844,4801,116947,26863,161405,132791,,,,,0,0,0,0
1650439971.153964,public.usertable,117264,26931,165339136,16782,public,usertable,1,0,222440,985237,133151,12801,15887,4820,117264,26931,161839,133151,,,,,0,0,0,0
1650439972.1862056,public.usertable,117505,27002,165699584,16782,public,usertable,1,0,223197,987108,133443,12824,15938,4830,117505,27002,162205,133443,,,,,0,0,0,0
1650439973.2177548,public.usertable,117745,27059,166043648,16782,public,usertable,1,0,223908,988877,133717,12852,15972,4845,117745,27059,162541,133717,,,,,0,0,0,0
1650439974.248286,public.usertable,118003,27113,166436864,16782,public,usertable,1,0,224634,990603,134000,12882,15997,4857,118003,27113,162879,134000,,,,,0,0,0,0
1650439975.2771924,public.usertable,118290,27168,166846464,16782,public,usertable,1,0,225594,993594,134321,12912,16031,4867,118290,27168,163264,134321,,,,,0,0,0,0
1650439976.3063204,public.usertable,118568,27219,167231488,16782,public,usertable,1,0,226385,994566,134635,12936,16067,4879,118568,27219,163638,134635,,,,,0,0,0,0
1650439977.3385212,public.usertable,118833,27292,167641088,16782,public,usertable,1,0,227292,997167,134945,12972,16112,4898,118833,27292,164029,134945,,,,,0,0,0,0
1650439978.3716938,public.usertable,119153,27351,168091648,16782,public,usertable,1,0,228151,998177,135300,12996,16147,4906,119153,27351,164443,135300,,,,,0,0,0,0
1650439979.40046,public.usertable,119457,27413,168509440,16782,public,usertable,1,0,228988,999975,135637,13029,16180,4924,119457,27413,164846,135637,,,,,0,0,0,0
1650439980.4300523,public.usertable,119863,27495,168869888,16782,public,usertable,1,0,230228,1003256,136089,13077,16226,4950,119863,27495,165392,136089,,,,,0,0,0,0
1650439981.4617918,public.usertable,120135,27561,169254912,16782,public,usertable,1,0,230958,1005019,136396,13110,16261,4964,120135,27561,165767,136396,,,,,0,0,0,0
1650439982.4897602,public.usertable,120432,27630,169697280,16782,public,usertable,1,0,231815,1008391,136737,13143,16305,4976,120432,27630,166185,136737,,,,,0,0,0,0
1650439983.5192175,public.usertable,120703,27711,170106880,16782,public,usertable,1,0,232700,1010966,137059,13180,16356,4994,120703,27711,166595,137059,,,,,0,0,0,0
1650439984.5573292,public.usertable,121021,27777,170565632,16782,public,usertable,1,0,233668,1013431,137413,13216,16392,5011,121021,27777,167021,137413,,,,,0,0,0,0
1650439985.5877507,public.usertable,121260,27837,170917888,16782,public,usertable,1,0,234484,1015952,137702,13241,16442,5026,121260,27837,167385,137702,,,,,0,0,0,0
1650439986.6175725,public.usertable,121475,27890,171212800,16782,public,usertable,1,0,235107,1017326,137945,13270,16470,5043,121475,27890,167685,137945,,,,,0,0,0,0
1650439987.6495392,public.usertable,121728,27953,171565056,16782,public,usertable,1,0,235852,1019297,138235,13301,16507,5057,121728,27953,168043,138235,,,,,0,0,0,0
1650439988.68465,public.usertable,121933,27999,171859968,16782,public,usertable,1,0,236456,1020612,138463,13326,16530,5069,121933,27999,168319,138463,,,,,0,0,0,0
1650439989.715414,public.usertable,122150,28041,172187648,16782,public,usertable,1,0,237089,1022622,138710,13345,16560,5075,122150,28041,168615,138710,,,,,0,0,0,0
1650439990.744997,public.usertable,122374,28097,172507136,16782,public,usertable,1,0,237762,1023857,138964,13375,16590,5090,122374,28097,168929,138964,,,,,0,0,0,0
1650439991.7748568,public.usertable,122595,28139,172785664,16782,public,usertable,1,0,238376,1027315,139210,13401,16615,5101,122595,28139,169226,139210,,,,,0,0,0,0
1650439992.805615,public.usertable,122779,28191,173064192,16782,public,usertable,1,0,238919,1028500,139423,13427,16644,5111,122779,28191,169494,139423,,,,,0,0,0,0
1650439993.8346322,public.usertable,123016,28233,173441024,16782,public,usertable,1,0,239584,1030158,139682,13456,16666,5123,123016,28233,169804,139682,,,,,0,0,0,0
1650439994.8636587,public.usertable,123268,28283,173776896,16782,public,usertable,1,0,240315,1031729,139965,13478,16697,5135,123268,28283,170140,139965,,,,,0,0,0,0
1650439995.8930404,public.usertable,123501,28339,174129152,16782,public,usertable,1,0,241126,1033888,140241,13498,16740,5144,123501,28339,170479,140241,,,,,0,0,0,0
1650439996.9236062,public.usertable,123736,28379,174465024,16782,public,usertable,1,0,241877,1036372,140507,13521,16771,5153,123736,28379,170799,140507,,,,,0,0,0,0
1650439997.9544003,public.usertable,123952,28435,174776320,16782,public,usertable,1,0,242591,1037058,140755,13548,16803,5162,123952,28435,171106,140755,,,,,0,0,0,0
1650439998.9833837,public.usertable,124341,28497,175136768,16782,public,usertable,1,0,243669,1040351,141179,13580,16838,5175,124341,28497,171597,141179,,,,,0,0,0,0
1650440000.014546,public.usertable,124567,28537,175456256,16782,public,usertable,1,0,244294,1043053,141430,13608,16863,5193,124567,28537,171901,141430,,,,,0,0,0,0
1650440001.0428681,public.usertable,124844,28608,175857664,16782,public,usertable,1,0,245185,1045127,141751,13640,16907,5209,124844,28608,172298,141751,,,,,0,0,0,0
1650440002.0718462,public.usertable,125139,28675,176283648,16782,public,usertable,1,0,246107,1046903,142084,13673,16945,5226,125139,28675,172702,142084,,,,,0,0,0,0
1650440003.100592,public.usertable,125425,28730,176685056,16782,public,usertable,1,0,246969,1049220,142406,13697,16981,5237,125425,28730,173084,142406,,,,,0,0,0,0
1650440004.129139,public.usertable,125666,28782,177004544,16782,public,usertable,1,0,247672,1050149,142671,13725,17005,5248,125666,28782,173401,142671,,,,,0,0,0,0
1650440005.1593745,public.usertable,125923,28816,177364992,16782,public,usertable,1,0,248392,1052635,142955,13747,17032,5261,125923,28816,173734,142955,,,,,0,0,0,0
1650440006.1903775,public.usertable,126148,28849,177659904,16782,public,usertable,1,0,249016,1054444,143206,13768,17058,5272,126148,28849,174032,143206,,,,,0,0,0,0
1650440007.2192829,public.usertable,126338,28890,177946624,16782,public,usertable,1,0,249615,1055554,143424,13787,17086,5282,126338,28890,174297,143424,,,,,0,0,0,0
1650440008.2497213,public.usertable,126553,28932,178257920,16782,public,usertable,1,0,250321,1058620,143664,13811,17111,5295,126553,28932,174586,143664,,,,,0,0,0,0
1650440009.2796118,public.usertable,126805,28974,178610176,16782,public,usertable,1,0,251034,1060097,143942,13830,17137,5304,126805,28974,174909,143942,,,,,0,0,0,0
1650440010.309245,public.usertable,127025,29016,178946048,16782,public,usertable,1,0,251599,1061939,144190,13848,17165,5308,127025,29016,175203,144190,,,,,0,0,0,0
1650440011.346165,public.usertable,127295,29072,179298304,16782,public,usertable,1,0,252455,1063532,144494,13877,17199,5323,127295,29072,175570,144494,,,,,0,0,0,0
1650440012.3769798,public.usertable,127512,29121,179576832,16782,public,usertable,1,0,253163,1064442,144743,13899,17231,5334,127512,29121,175873,144743,,,,,0,0,0,0
1650440013.4054532,public.usertable,127711,29167,179871744,16782,public,usertable,1,0,253766,1065789,144973,13918,17262,5342,127711,29167,176153,144973,,,,,0,0,0,0
1650440014.435997,public.usertable,127905,29211,180158464,16782,public,usertable,1,0,254408,1068087,145199,13934,17294,5350,127905,29211,176427,145199,,,,,0,0,0,0
1650440015.4642968,public.usertable,128083,29249,180420608,16782,public,usertable,1,0,254912,1069448,145400,13955,17317,5361,128083,29249,176672,145400,,,,,0,0,0,0
1650440016.4931972,public.usertable,128288,29285,180682752,16782,public,usertable,1,0,255435,1070498,145627,13972,17339,5370,128288,29285,176938,145627,,,,,0,0,0,0
1650440017.5242245,public.usertable,128486,29316,180944896,16782,public,usertable,1,0,255961,1072125,145844,13989,17358,5379,128486,29316,177191,145844,,,,,0,0,0,0
1650440018.553989,public.usertable,128673,29362,181280768,16782,public,usertable,1,0,256573,1075227,146056,14016,17383,5391,128673,29362,177455,146056,,,,,0,0,0,0
1650440019.5854654,public.usertable,128978,29416,181706752,16782,public,usertable,1,0,257405,1076575,146394,14038,17416,5399,128978,29416,177848,146394,,,,,0,0,0,0
1650440020.6169505,public.usertable,129413,29516,182132736,16782,public,usertable,1,0,258737,1080414,146886,14086,17473,5423,129413,29516,178445,146886,,,,,0,0,0,0
1650440021.6461685,public.usertable,129708,29571,182534144,16782,public,usertable,1,0,259511,1081615,147212,14113,17504,5435,129708,29571,178829,147212,,,,,0,0,0,0
1650440022.678887,public.usertable,129961,29624,182902784,16782,public,usertable,1,0,260226,1082794,147502,14132,17541,5448,129961,29624,179175,147502,,,,,0,0,0,0
1650440023.709704,public.usertable,130200,29680,183238656,16782,public,usertable,1,0,260976,1085899,147777,14158,17577,5458,130200,29680,179512,147777,,,,,0,0,0,0
1650440024.740819,public.usertable,130455,29743,183623680,16782,public,usertable,1,0,261679,1087883,148065,14192,17610,5475,130455,29743,179867,148065,,,,,0,0,0,0
1650440025.7716775,public.usertable,130720,29796,183975936,16782,public,usertable,1,0,262513,1090027,148358,14222,17638,5492,130720,29796,180218,148358,,,,,0,0,0,0
1650440026.8007116,public.usertable,131009,29857,184401920,16782,public,usertable,1,0,263422,1091799,148676,14259,17667,5506,131009,29857,180602,148676,,,,,0,0,0,0
1650440027.8308234,public.usertable,131313,29917,184819712,16782,public,usertable,1,0,264331,1092976,149017,14285,17704,5517,131313,29917,181006,149017,,,,,0,0,0,0
1650440028.860828,public.usertable,131635,29977,185294848,16782,public,usertable,1,0,265264,1097297,149379,14307,17744,5530,131635,29977,181430,149379,,,,,0,0,0,0
1650440029.889715,public.usertable,131993,30041,185769984,16782,public,usertable,1,0,266407,1099920,149771,14342,17778,5549,131993,30041,181891,149771,,,,,0,0,0,0
1650440030.9190512,public.usertable,132298,30116,186204160,16782,public,usertable,1,0,267404,1100906,150115,14378,17817,5569,132298,30116,182310,150115,,,,,0,0,0,0
1650440031.9493794,public.usertable,132594,30193,186654720,16782,public,usertable,1,0,268476,1103045,150465,14412,17871,5586,132594,30193,182748,150465,,,,,0,0,0,0
1650440032.977155,public.usertable,132883,30260,187072512,16782,public,usertable,1,0,269424,1106471,150792,14449,17909,5602,132883,30260,183150,150792,,,,,0,0,0,0
1650440034.008542,public.usertable,133196,30340,187514880,16782,public,usertable,1,0,270340,1108911,151151,14485,17955,5615,133196,30340,183591,151151,,,,,0,0,0,0
1650440035.0372105,public.usertable,133512,30411,187981824,16782,public,usertable,1,0,271381,1110399,151512,14513,18000,5635,133512,30411,184025,151512,,,,,0,0,0,0
1650440036.0654233,public.usertable,133857,30470,188440576,16782,public,usertable,1,0,272321,1112048,151886,14545,18029,5647,133857,30470,184460,151886,,,,,0,0,0,0
1650440037.096525,public.usertable,134152,30545,188833792,16782,public,usertable,1,0,273317,1113518,152229,14576,18077,5664,134152,30545,184882,152229,,,,,0,0,0,0
1650440038.1257415,public.usertable,134586,30624,189259776,16782,public,usertable,1,0,274695,1117830,152717,14615,18131,5681,134586,30624,185463,152717,,,,,0,0,0,0
1650440039.157498,public.usertable,134891,30673,189693952,16782,public,usertable,1,0,275519,1119907,153058,14638,18167,5690,134891,30673,185863,153058,,,,,0,0,0,0
1650440040.1883652,public.usertable,135178,30720,190087168,16782,public,usertable,1,0,276299,1121982,153370,14662,18192,5699,135178,30720,186224,153370,,,,,0,0,0,0
1650440041.2187893,public.usertable,135455,30782,190480384,16782,public,usertable,1,0,277218,1123253,153686,14687,18231,5711,135455,30782,186604,153686,,,,,0,0,0,0
1650440042.2492542,public.usertable,135733,30840,190873600,16782,public,usertable,1,0,278021,1126657,153996,14721,18263,5723,135733,30840,186980,153996,,,,,0,0,0,0
1650440043.2798793,public.usertable,136023,30892,191283200,16782,public,usertable,1,0,278860,1127940,154314,14751,18291,5741,136023,30892,187356,154314,,,,,0,0,0,0
1650440044.3142242,public.usertable,136281,30949,191651840,16782,public,usertable,1,0,279660,1130062,154613,14774,18332,5754,136281,30949,187719,154613,,,,,0,0,0,0
1650440045.3450873,public.usertable,136583,31005,192045056,16782,public,usertable,1,0,280530,1131502,154942,14806,18359,5774,136583,31005,188107,154942,,,,,0,0,0,0
1650440046.3741183,public.usertable,136887,31065,192503808,16782,public,usertable,1,0,281498,1133719,155286,14829,18399,5785,136887,31065,188514,155286,,,,,0,0,0,0
1650440047.4035103,public.usertable,137256,31119,192962560,16782,public,usertable,1,0,282578,1136439,155691,14859,18435,5801,137256,31119,188985,155691,,,,,0,0,0,0
1650440048.4337823,public.usertable,137543,31179,193396736,16782,public,usertable,1,0,283478,1137859,156015,14886,18472,5810,137543,31179,189373,156015,,,,,0,0,0,0
1650440049.4625375,public.usertable,137850,31239,193855488,16782,public,usertable,1,0,284408,1139962,156363,14914,18513,5823,137850,31239,189790,156363,,,,,0,0,0,0
1650440050.4950912,public.usertable,138202,31298,194347008,16782,public,usertable,1,0,285435,1141878,156755,14946,18553,5838,138202,31298,190254,156755,,,,,0,0,0,0
1650440051.5252032,public.usertable,138514,31365,194789376,16782,public,usertable,1,0,286385,1144032,157107,14982,18593,5854,138514,31365,190682,157107,,,,,0,0,0,0
1650440052.5543618,public.usertable,138831,31430,195223552,16782,public,usertable,1,0,287405,1146088,157468,15006,18637,5868,138831,31430,191111,157468,,,,,0,0,0,0
1650440053.582415,public.usertable,139160,31488,195682304,16782,public,usertable,1,0,288352,1148167,157826,15041,18666,5884,139160,31488,191533,157826,,,,,0,0,0,0
1650440054.6107945,public.usertable,139484,31540,196116480,16782,public,usertable,1,0,289297,1150281,158183,15070,18699,5900,139484,31540,191952,158183,,,,,0,0,0,0
1650440055.640664,public.usertable,139793,31605,196567040,16782,public,usertable,1,0,290292,1151560,158535,15094,18742,5911,139793,31605,192371,158535,,,,,0,0,0,0
1650440056.6716678,public.usertable,140292,31698,197025792,16782,public,usertable,1,0,291821,1154501,159090,15136,18798,5935,140292,31698,193024,159090,,,,,0,0,0,0
1650440057.7017326,public.usertable,140636,31753,197500928,16782,public,usertable,1,0,292831,1157440,159467,15169,18831,5950,140636,31753,193467,159467,,,,,0,0,0,0
1650440058.73327,public.usertable,140955,31824,197967872,16782,public,usertable,1,0,293720,1158494,159831,15200,18876,5966,140955,31824,193907,159831,,,,,0,0,0,0
1650440059.765927,public.usertable,141305,31881,198451200,16782,public,usertable,1,0,294740,1160727,160209,15236,18904,5985,141305,31881,194349,160209,,,,,0,0,0,0
1650440060.80121,public.usertable,141639,31951,198893568,16782,public,usertable,1,0,295625,1162628,160586,15264,18947,5998,141639,31951,194797,160586,,,,,0,0,0,0
1650440061.829899,public.usertable,141942,32023,199344128,16782,public,usertable,1,0,296573,1165258,160925,15303,18983,6017,141942,32023,195211,160925,,,,,0,0,0,0
1650440062.858215,public.usertable,142308,32076,199835648,16782,public,usertable,1,0,297608,1166827,161325,15324,19017,6026,142308,32076,195666,161325,,,,,0,0,0,0
1650440063.886889,public.usertable,142649,32123,200310784,16782,public,usertable,1,0,298525,1169324,161705,15340,19056,6034,142649,32123,196101,161705,,,,,0,0,0,0
1650440064.9165337,public.usertable,142983,32177,200769536,16782,public,usertable,1,0,299455,1172344,162072,15366,19089,6047,142983,32177,196527,162072,,,,,0,0,0,0
1650440065.9470034,public.usertable,143317,32247,201244672,16782,public,usertable,1,0,300435,1175628,162450,15395,19133,6059,143317,32247,196978,162450,,,,,0,0,0,0
1650440066.979553,public.usertable,143664,32309,201719808,16782,public,usertable,1,0,301332,1178754,162834,15428,19170,6077,143664,32309,197432,162834,,,,,0,0,0,0
1650440068.0114887,public.usertable,144000,32362,202170368,16782,public,usertable,1,0,302384,1181749,163200,15455,19200,6096,144000,32362,197855,163200,,,,,0,0,0,0
1650440069.0412881,public.usertable,144343,32415,202645504,16782,public,usertable,1,0,303384,1182640,163576,15488,19233,6115,144343,32415,198297,163576,,,,,0,0,0,0
1650440070.0726254,public.usertable,144655,32479,203063296,16782,public,usertable,1,0,304374,1187823,163925,15521,19270,6131,144655,32479,198716,163925,,,,,0,0,0,0
1650440071.10358,public.usertable,144935,32529,203448320,16782,public,usertable,1,0,305212,1190066,164243,15542,19308,6141,144935,32529,199093,164243,,,,,0,0,0,0
1650440072.1342447,public.usertable,145249,32581,203890688,16782,public,usertable,1,0,306144,1191075,164590,15564,19341,6155,145249,32581,199495,164590,,,,,0,0,0,0
1650440073.163764,public.usertable,145558,32641,204341248,16782,public,usertable,1,0,306994,1192105,164935,15592,19377,6167,145558,32641,199904,164935,,,,,0,0,0,0
1650440074.1961966,public.usertable,145878,32720,204800000,16782,public,usertable,1,0,308002,1193817,165304,15626,19426,6181,145878,32720,200356,165304,,,,,0,0,0,0
1650440075.2288203,public.usertable,146204,32772,205234176,16782,public,usertable,1,0,309041,1195321,165662,15648,19458,6190,146204,32772,200768,165662,,,,,0,0,0,0
1650440076.2569249,public.usertable,146677,32857,205684736,16782,public,usertable,1,0,310504,1198248,166184,15700,19507,6216,146677,32857,201391,166184,,,,,0,0,0,0
1650440077.2880156,public.usertable,146966,32916,206102528,16782,public,usertable,1,0,311456,1200532,166514,15729,19548,6228,146966,32916,201791,166514,,,,,0,0,0,0
1650440078.3182368,public.usertable,147226,32966,206479360,16782,public,usertable,1,0,312363,1202311,166811,15750,19585,6236,147226,32966,202146,166811,,,,,0,0,0,0
1650440079.3529122,public.usertable,147536,33022,206913536,16782,public,usertable,1,0,313322,1205274,167157,15774,19621,6243,147536,33022,202552,167157,,,,,0,0,0,0
1650440080.3817995,public.usertable,147872,33073,207372288,16782,public,usertable,1,0,314420,1207389,167528,15796,19656,6254,147872,33073,202980,167528,,,,,0,0,0,0
1650440081.4121044,public.usertable,148161,33144,207806464,16782,public,usertable,1,0,315351,1209794,167860,15831,19699,6266,148161,33144,203390,167860,,,,,0,0,0,0
1650440082.442172,public.usertable,148507,33183,208273408,16782,public,usertable,1,0,316350,1211622,168241,15862,19734,6282,148507,33183,203837,168241,,,,,0,0,0,0
1650440083.4745646,public.usertable,148838,33243,208723968,16782,public,usertable,1,0,317305,1213126,168609,15886,19771,6294,148838,33243,204266,168609,,,,,0,0,0,0
1650440084.504527,public.usertable,149183,33297,209199104,16782,public,usertable,1,0,318339,1215260,168993,15912,19810,6308,149183,33297,204715,168993,,,,,0,0,0,0
1650440085.5349994,public.usertable,149519,33353,209690624,16782,public,usertable,1,0,319366,1218485,169365,15947,19846,6325,149519,33353,205158,169365,,,,,0,0,0,0
1650440086.565133,public.usertable,149850,33409,210124800,16782,public,usertable,1,0,320312,1220210,169736,15972,19886,6338,149850,33409,205594,169736,,,,,0,0,0,0
1650440087.5942614,public.usertable,150164,33473,210567168,16782,public,usertable,1,0,321361,1222177,170095,15998,19931,6351,150164,33473,206024,170095,,,,,0,0,0,0
1650440088.622831,public.usertable,150499,33535,211034112,16782,public,usertable,1,0,322401,1223779,170468,16026,19969,6366,150499,33535,206463,170468,,,,,0,0,0,0
1650440089.6518612,public.usertable,150801,33607,211501056,16782,public,usertable,1,0,323382,1225890,170820,16054,20019,6380,150801,33607,206893,170820,,,,,0,0,0,0
1650440090.682452,public.usertable,151140,33663,211968000,16782,public,usertable,1,0,324433,1227946,171196,16083,20056,6394,151140,33663,207335,171196,,,,,0,0,0,0
1650440091.712169,public.usertable,151473,33709,212443136,16782,public,usertable,1,0,325502,1230476,171564,16110,20091,6408,151473,33709,207765,171564,,,,,0,0,0,0
1650440092.7403808,public.usertable,151860,33755,212951040,16782,public,usertable,1,0,326561,1231948,171985,16134,20125,6419,151860,33755,208244,171985,,,,,0,0,0,0
1650440093.7700217,public.usertable,152214,33819,213434368,16782,public,usertable,1,0,327527,1234012,172373,16168,20159,6434,152214,33819,208700,172373,,,,,0,0,0,0
1650440094.7999463,public.usertable,152718,33902,213893120,16782,public,usertable,1,0,328993,1236722,172933,16210,20215,6455,152718,33902,209358,172933,,,,,0,0,0,0
1650440095.828331,public.usertable,153059,33970,214368256,16782,public,usertable,1,0,329901,1238302,173309,16246,20250,6476,153059,33970,209805,173309,,,,,0,0,0,0
1650440096.857726,public.usertable,153399,34021,214843392,16782,public,usertable,1,0,330952,1243618,173682,16275,20283,6488,153399,34021,210240,173682,,,,,0,0,0,0
1650440097.8913665,public.usertable,153742,34081,215318528,16782,public,usertable,1,0,331883,1244742,174063,16301,20321,6506,153742,34081,210685,174063,,,,,0,0,0,0
1650440098.9205177,public.usertable,154080,34139,215769088,16782,public,usertable,1,0,332835,1246001,174431,16334,20351,6524,154080,34139,211116,174431,,,,,0,0,0,0
1650440099.9498885,public.usertable,154433,34185,216227840,16782,public,usertable,1,0,333822,1246436,174817,16350,20384,6532,154433,34185,211551,174817,,,,,0,0,0,0
1650440100.9804516,public.usertable,154734,34237,216653824,16782,public,usertable,1,0,334799,1249071,175148,16385,20414,6553,154734,34237,211947,175148,,,,,0,0,0,0
1650440102.010216,public.usertable,155050,34290,217096192,16782,public,usertable,1,0,335673,1250066,175497,16407,20447,6563,155050,34290,212351,175497,,,,,0,0,0,0
1650440103.0392966,public.usertable,155378,34343,217530368,16782,public,usertable,1,0,336583,1252000,175854,16435,20476,6576,155378,34343,212765,175854,,,,,0,0,0,0
1650440104.0692518,public.usertable,155664,34396,217948160,16782,public,usertable,1,0,337395,1256040,176178,16463,20514,6589,155664,34396,213155,176178,,,,,0,0,0,0
1650440105.1045012,public.usertable,155982,34438,218365952,16782,public,usertable,1,0,338344,1259545,176530,16483,20548,6598,155982,34438,213561,176530,,,,,0,0,0,0
1650440106.133226,public.usertable,156298,34495,218824704,16782,public,usertable,1,0,339320,1262320,176878,16513,20580,6614,156298,34495,213971,176878,,,,,0,0,0,0
1650440107.1653945,public.usertable,156630,34552,219291648,16782,public,usertable,1,0,340417,1263845,177250,16535,20620,6621,156630,34552,214405,177250,,,,,0,0,0,0
1650440108.1940181,public.usertable,156968,34607,219725824,16782,public,usertable,1,0,341420,1264629,177614,16565,20646,6638,156968,34607,214825,177614,,,,,0,0,0,0
1650440109.2246335,public.usertable,157241,34662,220119040,16782,public,usertable,1,0,342205,1265531,177913,16598,20672,6655,157241,34662,215183,177913,,,,,0,0,0,0
1650440110.253562,public.usertable,157554,34717,220561408,16782,public,usertable,1,0,343059,1266703,178262,16621,20708,6658,157554,34717,215591,178262,,,,,0,0,0,0
1650440111.2817504,public.usertable,157872,34763,220979200,16782,public,usertable,1,0,343832,1267934,178609,16646,20737,6666,157872,34763,215992,178609,,,,,0,0,0,0
1650440112.3137372,public.usertable,158169,34817,221396992,16782,public,usertable,1,0,344752,1268868,178933,16673,20764,6681,158169,34817,216370,178933,,,,,0,0,0,0
1650440113.3445168,public.usertable,158657,34884,221831168,16782,public,usertable,1,0,346136,1270540,179463,16705,20806,6703,158657,34884,216974,179463,,,,,0,0,0,0
1650440114.3788655,public.usertable,158960,34926,222248960,16782,public,usertable,1,0,347002,1272417,179798,16723,20838,6710,158960,34926,217359,179798,,,,,0,0,0,0
1650440115.4092116,public.usertable,159261,34978,222658560,16782,public,usertable,1,0,347885,1273700,180131,16746,20870,6725,159261,34978,217747,180131,,,,,0,0,0,0
1650440116.4421284,public.usertable,159553,35028,223059968,16782,public,usertable,1,0,348718,1276297,180452,16769,20899,6736,159553,35028,218120,180452,,,,,0,0,0,0
1650440117.4705162,public.usertable,159885,35064,223494144,16782,public,usertable,1,0,349583,1280145,180810,16790,20925,6750,159885,35064,218525,180810,,,,,0,0,0,0
1650440118.5017517,public.usertable,160210,35112,223928320,16782,public,usertable,1,0,350487,1280464,181162,16812,20952,6760,160210,35112,218926,181162,,,,,0,0,0,0
1650440119.5315356,public.usertable,160505,35165,224346112,16782,public,usertable,1,0,351264,1281205,181491,16836,20986,6771,160505,35165,219313,181491,,,,,0,0,0,0
1650440120.5628238,public.usertable,160818,35224,224796672,16782,public,usertable,1,0,352094,1281960,181839,16863,21021,6784,160818,35224,219723,181839,,,,,0,0,0,0
1650440121.59407,public.usertable,161158,35272,225230848,16782,public,usertable,1,0,353080,1284080,182207,16894,21049,6803,161158,35272,220150,182207,,,,,0,0,0,0
1650440122.6230721,public.usertable,161472,35330,225697792,16782,public,usertable,1,0,354023,1286130,182562,16921,21090,6819,161472,35330,220573,182562,,,,,0,0,0,0
1650440123.6516948,public.usertable,161792,35377,226140160,16782,public,usertable,1,0,354909,1288230,182906,16954,21114,6831,161792,35377,220974,182906,,,,,0,0,0,0
1650440124.6845143,public.usertable,162140,35425,226598912,16782,public,usertable,1,0,355847,1289005,183285,16972,21145,6837,162140,35425,221402,183285,,,,,0,0,0,0
1650440125.7149963,public.usertable,162482,35499,227090432,16782,public,usertable,1,0,356975,1290654,183667,17008,21185,6855,162482,35499,221860,183667,,,,,0,0,0,0
1650440126.7460082,public.usertable,162804,35555,227532800,16782,public,usertable,1,0,358017,1293905,184031,17038,21227,6872,162804,35555,222296,184031,,,,,0,0,0,0
1650440127.7818422,public.usertable,163108,35617,227991552,16782,public,usertable,1,0,359057,1296682,184381,17065,21273,6887,163108,35617,222719,184381,,,,,0,0,0,0
1650440128.8097975,public.usertable,163427,35680,228442112,16782,public,usertable,1,0,360022,1300186,184738,17100,21311,6900,163427,35680,223149,184738,,,,,0,0,0,0
1650440129.8398597,public.usertable,163770,35739,228909056,16782,public,usertable,1,0,361051,1302117,185113,17137,21343,6917,163770,35739,223593,185113,,,,,0,0,0,0
1650440130.872883,public.usertable,164265,35812,229351424,16782,public,usertable,1,0,362404,1304433,185645,17178,21380,6932,164265,35812,224203,185645,,,,,0,0,0,0
1650440131.9039276,public.usertable,164565,35866,229761024,16782,public,usertable,1,0,363364,1306328,185981,17204,21416,6948,164565,35866,224601,185981,,,,,0,0,0,0
1650440132.934366,public.usertable,164900,35905,230211584,16782,public,usertable,1,0,364301,1309437,186336,17228,21436,6962,164900,35905,225000,186336,,,,,0,0,0,0
1650440133.9637303,public.usertable,165232,35952,230645760,16782,public,usertable,1,0,365321,1311162,186697,17250,21465,6973,165232,35952,225412,186697,,,,,0,0,0,0
1650440134.993963,public.usertable,165570,36005,231120896,16782,public,usertable,1,0,366225,1312516,187068,17276,21498,6987,165570,36005,225842,187068,,,,,0,0,0,0
1650440136.0257487,public.usertable,165895,36068,231563264,16782,public,usertable,1,0,367255,1313922,187429,17306,21534,7001,165895,36068,226269,187429,,,,,0,0,0,0
1650440137.0553362,public.usertable,166212,36121,232005632,16782,public,usertable,1,0,368273,1316629,187775,17339,21563,7015,166212,36121,226677,187775,,,,,0,0,0,0
1650440138.0856607,public.usertable,166537,36177,232456192,16782,public,usertable,1,0,369144,1318545,188140,17355,21603,7021,166537,36177,227098,188140,,,,,0,0,0,0
1650440139.115128,public.usertable,166840,36240,232882176,16782,public,usertable,1,0,370059,1319431,188486,17377,21646,7036,166840,36240,227509,188486,,,,,0,0,0,0
1650440140.143805,public.usertable,167153,36290,233324544,16782,public,usertable,1,0,370974,1320920,188833,17399,21680,7046,167153,36290,227912,188833,,,,,0,0,0,0
1650440141.1739533,public.usertable,167495,36333,233750528,16782,public,usertable,1,0,371932,1324582,189194,17428,21699,7062,167495,36333,228321,189194,,,,,0,0,0,0
1650440142.201303,public.usertable,167795,36390,234192896,16782,public,usertable,1,0,372859,1326631,189526,17460,21731,7080,167795,36390,228717,189526,,,,,0,0,0,0
1650440143.2308939,public.usertable,168124,36443,234643456,16782,public,usertable,1,0,373785,1328307,189885,17488,21761,7091,168124,36443,229134,189885,,,,,0,0,0,0
1650440144.2613318,public.usertable,168455,36478,235085824,16782,public,usertable,1,0,374841,1329205,190240,17504,21785,7098,168455,36478,229529,190240,,,,,0,0,0,0
1650440145.2901423,public.usertable,168798,36527,235536384,16782,public,usertable,1,0,375805,1331226,190619,17529,21821,7114,168798,36527,229969,190619,,,,,0,0,0,0
1650440146.3209863,public.usertable,169132,36576,235986944,16782,public,usertable,1,0,376831,1334159,190977,17566,21845,7131,169132,36576,230388,190977,,,,,0,0,0,0
1650440147.351698,public.usertable,169443,36630,236445696,16782,public,usertable,1,0,377857,1335420,191328,17589,21885,7144,169443,36630,230802,191328,,,,,0,0,0,0
1650440148.381928,public.usertable,169782,36688,236879872,16782,public,usertable,1,0,378889,1336851,191699,17619,21917,7161,169782,36688,231235,191699,,,,,0,0,0,0
1650440149.4146855,public.usertable,170271,36774,237338624,16782,public,usertable,1,0,380369,1339776,192237,17663,21966,7186,170271,36774,231866,192237,,,,,0,0,0,0
1650440150.4448788,public.usertable,170597,36828,237797376,16782,public,usertable,1,0,381388,1341568,192597,17688,22000,7198,170597,36828,232285,192597,,,,,0,0,0,0
1650440151.4745708,public.usertable,170946,36872,238256128,16782,public,usertable,1,0,382363,1343628,192971,17710,22025,7210,170946,36872,232706,192971,,,,,0,0,0,0
1650440152.5064702,public.usertable,171267,36928,238698496,16782,public,usertable,1,0,383385,1346290,193329,17733,22062,7224,171267,36928,233124,193329,,,,,0,0,0,0
1650440153.534334,public.usertable,171567,36975,239108096,16782,public,usertable,1,0,384150,1349135,193657,17756,22090,7231,171567,36975,233503,193657,,,,,0,0,0,0
1650440154.56267,public.usertable,171820,37003,239427584,16782,public,usertable,1,0,384789,1350562,193927,17769,22107,7239,171820,37003,233803,193927,,,,,0,0,0,0
1650440155.591081,public.usertable,172132,37056,239878144,16782,public,usertable,1,0,385777,1352554,194277,17793,22145,7254,172132,37056,234215,194277,,,,,0,0,0,0
1650440156.6246119,public.usertable,172491,37106,240353280,16782,public,usertable,1,0,386771,1353491,194662,17821,22171,7271,172491,37106,234654,194662,,,,,0,0,0,0
1650440157.655582,public.usertable,172845,37154,240844800,16782,public,usertable,1,0,387875,1355327,195053,17846,22208,7283,172845,37154,235107,195053,,,,,0,0,0,0
1650440158.685184,public.usertable,173167,37196,241229824,16782,public,usertable,1,0,388845,1356692,195402,17871,22235,7295,173167,37196,235508,195402,,,,,0,0,0,0
1650440159.71714,public.usertable,173392,37229,241516544,16782,public,usertable,1,0,389490,1358205,195649,17890,22257,7306,173392,37229,235796,195649,,,,,0,0,0,0
1650440160.7468214,public.usertable,173607,37259,241836032,16782,public,usertable,1,0,390157,1359179,195883,17901,22276,7311,173607,37259,236060,195883,,,,,0,0,0,0
1650440161.773793,public.usertable,173835,37295,242147328,16782,public,usertable,1,0,390873,1362123,196134,17919,22299,7321,173835,37295,236352,196134,,,,,0,0,0,0
1650440162.8034542,public.usertable,174089,37338,242507776,16782,public,usertable,1,0,391618,1363889,196414,17939,22325,7328,174089,37338,236678,196414,,,,,0,0,0,0
1650440163.8338394,public.usertable,174353,37382,242860032,16782,public,usertable,1,0,392381,1364828,196704,17958,22351,7339,174353,37382,237013,196704,,,,,0,0,0,0
1650440164.8626194,public.usertable,174602,37420,243212288,16782,public,usertable,1,0,393057,1367878,196983,17975,22381,7345,174602,37420,237339,196983,,,,,0,0,0,0
1650440165.8950796,public.usertable,174897,37458,243597312,16782,public,usertable,1,0,393944,1370585,197308,17991,22411,7358,174897,37458,237710,197308,,,,,0,0,0,0
1650440166.9239173,public.usertable,175168,37496,243998720,16782,public,usertable,1,0,394744,1371700,197606,18006,22438,7367,175168,37496,238050,197606,,,,,0,0,0,0
1650440167.952743,public.usertable,175481,37547,244416512,16782,public,usertable,1,0,395593,1372873,197951,18029,22470,7382,175481,37547,238450,197951,,,,,0,0,0,0
1650440168.982009,public.usertable,175955,37610,244842496,16782,public,usertable,1,0,396966,1375678,198458,18064,22503,7398,175955,37610,239025,198458,,,,,0,0,0,0
1650440170.012008,public.usertable,176215,37663,245227520,16782,public,usertable,1,0,397780,1376849,198756,18085,22541,7404,176215,37663,239382,198756,,,,,0,0,0,0
1650440171.0422008,public.usertable,176482,37702,245587968,16782,public,usertable,1,0,398583,1378061,199044,18106,22562,7409,176482,37702,239712,199044,,,,,0,0,0,0
1650440172.0715199,public.usertable,176820,37743,246038528,16782,public,usertable,1,0,399617,1381003,199407,18132,22587,7419,176820,37743,240126,199407,,,,,0,0,0,0
1650440173.1027348,public.usertable,177168,37804,246521856,16782,public,usertable,1,0,400677,1382286,199796,18157,22628,7431,177168,37804,240581,199796,,,,,0,0,0,0
1650440174.1336217,public.usertable,177503,37861,247005184,16782,public,usertable,1,0,401703,1384634,200172,18185,22669,7446,177503,37861,241026,200172,,,,,0,0,0,0
1650440175.1633575,public.usertable,177847,37913,247463936,16782,public,usertable,1,0,402742,1385965,200550,18209,22703,7465,177847,37913,241462,200550,,,,,0,0,0,0
1650440176.1927054,public.usertable,178190,37963,247922688,16782,public,usertable,1,0,403799,1387442,200922,18232,22732,7477,178190,37963,241886,200922,,,,,0,0,0,0
1650440177.2215824,public.usertable,178538,38022,248406016,16782,public,usertable,1,0,404814,1390248,201307,18259,22769,7491,178538,38022,242335,201307,,,,,0,0,0,0
1650440178.2545083,public.usertable,178880,38079,248864768,16782,public,usertable,1,0,405826,1391615,201678,18289,22798,7505,178880,38079,242765,201678,,,,,0,0,0,0
1650440179.286601,public.usertable,179233,38130,249339904,16782,public,usertable,1,0,406766,1393115,202062,18317,22829,7521,179233,38130,243208,202062,,,,,0,0,0,0
1650440180.317153,public.usertable,179557,38172,249741312,16782,public,usertable,1,0,407732,1394492,202411,18340,22854,7534,179557,38172,243605,202411,,,,,0,0,0,0
1650440181.3506544,public.usertable,179830,38219,250126336,16782,public,usertable,1,0,408621,1395775,202714,18359,22884,7544,179830,38219,243957,202714,,,,,0,0,0,0
1650440182.3819106,public.usertable,180114,38255,250486784,16782,public,usertable,1,0,409344,1397033,203021,18374,22907,7552,180114,38255,244302,203021,,,,,0,0,0,0
1650440183.4111798,public.usertable,180362,38301,250855424,16782,public,usertable,1,0,410246,1397631,203292,18403,22930,7566,180362,38301,244625,203292,,,,,0,0,0,0
1650440184.441925,public.usertable,180666,38338,251256832,16782,public,usertable,1,0,410990,1398149,203619,18420,22953,7573,180666,38338,244992,203619,,,,,0,0,0,0
1650440185.470293,public.usertable,180959,38394,251674624,16782,public,usertable,1,0,411883,1399248,203945,18447,22986,7587,180959,38394,245378,203945,,,,,0,0,0,0
1650440186.5001395,public.usertable,181487,38464,252182528,16782,public,usertable,1,0,413328,1401541,204523,18481,23036,7600,181487,38464,246040,204523,,,,,0,0,0,0
1650440187.529483,public.usertable,181803,38524,252624896,16782,public,usertable,1,0,414233,1404079,204880,18508,23077,7614,181803,38524,246465,204880,,,,,0,0,0,0
1650440188.5596144,public.usertable,182165,38556,253108224,16782,public,usertable,1,0,415234,1408018,205262,18536,23097,7629,182165,38556,246895,205262,,,,,0,0,0,0
1650440189.58896,public.usertable,182536,38590,253599744,16782,public,usertable,1,0,416241,1409223,205654,18557,23118,7636,182536,38590,247329,205654,,,,,0,0,0,0
1650440190.6189077,public.usertable,182878,38633,254033920,16782,public,usertable,1,0,417138,1409857,206025,18574,23147,7644,182878,38633,247746,206025,,,,,0,0,0,0
1650440191.6491876,public.usertable,183157,38664,254402560,16782,public,usertable,1,0,417883,1410631,206323,18589,23166,7652,183157,38664,248078,206323,,,,,0,0,0,0
1650440192.681241,public.usertable,183451,38707,254812160,16782,public,usertable,1,0,418761,1411893,206648,18605,23197,7660,183451,38707,248450,206648,,,,,0,0,0,0
1650440193.7120733,public.usertable,183765,38748,255238144,16782,public,usertable,1,0,419781,1413915,206993,18621,23228,7670,183765,38748,248842,206993,,,,,0,0,0,0
1650440194.7418318,public.usertable,184084,38800,255680512,16782,public,usertable,1,0,420808,1417351,207354,18647,23270,7686,184084,38800,249271,207354,,,,,0,0,0,0
1650440195.7750967,public.usertable,184428,38841,256155648,16782,public,usertable,1,0,421906,1418933,207727,18669,23299,7697,184428,38841,249695,207727,,,,,0,0,0,0
1650440196.8056915,public.usertable,184770,38884,256589824,16782,public,usertable,1,0,422867,1421216,208096,18693,23326,7712,184770,38884,250115,208096,,,,,0,0,0,0
1650440197.8336318,public.usertable,185110,38926,257056768,16782,public,usertable,1,0,423750,1423454,208461,18718,23351,7728,185110,38926,250530,208461,,,,,0,0,0,0
1650440198.8628848,public.usertable,185442,38963,257490944,16782,public,usertable,1,0,424723,1424758,208818,18734,23376,7739,185442,38963,250928,208818,,,,,0,0,0,0
1650440199.8914452,public.usertable,185801,38998,257957888,16782,public,usertable,1,0,425702,1425787,209197,18752,23396,7749,185801,38998,251345,209197,,,,,0,0,0,0
1650440200.9197721,public.usertable,186119,39034,258351104,16782,public,usertable,1,0,426636,1427717,209542,18773,23423,7758,186119,39034,251738,209542,,,,,0,0,0,0
1650440201.9489255,public.usertable,186421,39077,258768896,16782,public,usertable,1,0,427410,1428551,209867,18794,23446,7767,186421,39077,252107,209867,,,,,0,0,0,0
1650440202.977799,public.usertable,186739,39115,259194880,16782,public,usertable,1,0,428369,1430570,210209,18819,23470,7781,186739,39115,252498,210209,,,,,0,0,0,0
1650440204.0067463,public.usertable,187058,39172,259649536,16782,public,usertable,1,0,429413,1431758,210565,18842,23507,7795,187058,39172,252914,210565,,,,,0,0,0,0
1650440205.0354927,public.usertable,187389,39218,260112384,16782,public,usertable,1,0,430343,1433842,210923,18867,23534,7809,187389,39218,253324,210923,,,,,0,0,0,0
1650440206.0673249,public.usertable,187874,39304,260530176,16782,public,usertable,1,0,431817,1435514,211448,18916,23574,7833,187874,39304,253938,211448,,,,,0,0,0,0
1650440207.0976417,public.usertable,188216,39348,260972544,16782,public,usertable,1,0,432693,1437256,211811,18939,23595,7842,188216,39348,254345,211811,,,,,0,0,0,0
1650440208.1269786,public.usertable,188487,39397,261349376,16782,public,usertable,1,0,433567,1438703,212103,18967,23616,7859,188487,39397,254686,212103,,,,,0,0,0,0
1650440209.155319,public.usertable,188809,39446,261775360,16782,public,usertable,1,0,434519,1439741,212450,18994,23641,7875,188809,39446,255085,212450,,,,,0,0,0,0
1650440210.1842837,public.usertable,189107,39499,262193152,16782,public,usertable,1,0,435431,1441675,212784,19018,23677,7887,189107,39499,255479,212784,,,,,0,0,0,0
1650440211.2141953,public.usertable,189494,39537,262717440,16782,public,usertable,1,0,436488,1444829,213193,19041,23699,7896,189494,39537,255933,213193,,,,,0,0,0,0
1650440212.244839,public.usertable,189862,39583,263200768,16782,public,usertable,1,0,437505,1445796,213588,19066,23726,7909,189862,39583,256380,213588,,,,,0,0,0,0
1650440213.2756672,public.usertable,190227,39633,263684096,16782,public,usertable,1,0,438406,1447597,213982,19092,23755,7924,190227,39633,256829,213982,,,,,0,0,0,0
1650440214.3040094,public.usertable,190563,39688,264151040,16782,public,usertable,1,0,439409,1448938,214359,19118,23796,7939,190563,39688,257273,214359,,,,,0,0,0,0
1650440215.3337314,public.usertable,190917,39755,264650752,16782,public,usertable,1,0,440422,1450245,214751,19149,23834,7951,190917,39755,257734,214751,,,,,0,0,0,0
1650440216.3628485,public.usertable,191294,39801,265134080,16782,public,usertable,1,0,441459,1451209,215157,19171,23863,7964,191294,39801,258191,215157,,,,,0,0,0,0
1650440217.3910277,public.usertable,191639,39861,265633792,16782,public,usertable,1,0,442442,1452935,215541,19193,23902,7975,191639,39861,258636,215541,,,,,0,0,0,0
1650440218.4227118,public.usertable,192019,39904,266141696,16782,public,usertable,1,0,443488,1454434,215955,19215,23936,7986,192019,39904,259106,215955,,,,,0,0,0,0
1650440219.4515238,public.usertable,192395,39972,266649600,16782,public,usertable,1,0,444622,1455072,216376,19239,23981,7997,192395,39972,259596,216376,,,,,0,0,0,0
1650440220.4800122,public.usertable,192766,40016,267141120,16782,public,usertable,1,0,445735,1458010,216773,19262,24007,8007,192766,40016,260042,216773,,,,,0,0,0,0
1650440221.5096428,public.usertable,193100,40060,267583488,16782,public,usertable,1,0,446710,1460124,217138,19282,24038,8020,193100,40060,260458,217138,,,,,0,0,0,0
1650440222.540934,public.usertable,193438,40098,268025856,16782,public,usertable,1,0,447701,1462515,217499,19311,24061,8039,193438,40098,260871,217499,,,,,0,0,0,0
1650440223.5689855,public.usertable,193765,40138,268460032,16782,public,usertable,1,0,448656,1464577,217852,19328,24087,8051,193765,40138,261267,217852,,,,,0,0,0,0
1650440224.6007965,public.usertable,194288,40195,268935168,16782,public,usertable,1,0,450156,1465606,218407,19355,24119,8062,194288,40195,261881,218407,,,,,0,0,0,0
1650440225.6315825,public.usertable,194646,40244,269402112,16782,public,usertable,1,0,451141,1467967,218792,19379,24146,8081,194646,40244,262317,218792,,,,,0,0,0,0
1650440226.6619563,public.usertable,194974,40297,269852672,16782,public,usertable,1,0,452096,1469099,219155,19403,24181,8096,194974,40297,262739,219155,,,,,0,0,0,0
1650440227.693441,public.usertable,195335,40345,270344192,16782,public,usertable,1,0,453032,1470319,219547,19423,24212,8100,195335,40345,263182,219547,,,,,0,0,0,0
1650440228.7267325,public.usertable,195687,40391,270802944,16782,public,usertable,1,0,454000,1471556,219927,19443,24240,8112,195687,40391,263610,219927,,,,,0,0,0,0
1650440229.75884,public.usertable,196037,40451,271286272,16782,public,usertable,1,0,455053,1472779,220314,19469,24277,8129,196037,40451,264060,220314,,,,,0,0,0,0
1650440230.7895164,public.usertable,196371,40501,271736832,16782,public,usertable,1,0,456049,1473871,220682,19492,24311,8144,196371,40501,264485,220682,,,,,0,0,0,0
1650440231.8189552,public.usertable,196700,40555,272146432,16782,public,usertable,1,0,456869,1474521,221041,19520,24341,8159,196700,40555,264902,221041,,,,,0,0,0,0
1650440232.850101,public.usertable,197040,40592,272613376,16782,public,usertable,1,0,457806,1475757,221408,19538,24368,8164,197040,40592,265314,221408,,,,,0,0,0,0
1650440233.8783107,public.usertable,197396,40634,273088512,16782,public,usertable,1,0,458847,1476628,221788,19561,24392,8177,197396,40634,265741,221788,,,,,0,0,0,0
1650440234.9121974,public.usertable,197747,40672,273555456,16782,public,usertable,1,0,459754,1480067,222166,19579,24419,8184,197747,40672,266164,222166,,,,,0,0,0,0
1650440235.942601,public.usertable,198100,40722,274030592,16782,public,usertable,1,0,460770,1481438,222550,19603,24450,8193,198100,40722,266603,222550,,,,,0,0,0,0
1650440236.973203,public.usertable,198437,40778,274497536,16782,public,usertable,1,0,461792,1482291,222918,19633,24481,8203,198437,40778,267032,222918,,,,,0,0,0,0
1650440238.0025198,public.usertable,198791,40823,274972672,16782,public,usertable,1,0,462811,1483883,223297,19660,24506,8216,198791,40823,267463,223297,,,,,0,0,0,0
1650440239.0309932,public.usertable,199136,40880,275464192,16782,public,usertable,1,0,463864,1485634,223673,19691,24537,8235,199136,40880,267901,223673,,,,,0,0,0,0
1650440240.0618587,public.usertable,199520,40922,275939328,16782,public,usertable,1,0,464980,1487716,224079,19714,24559,8249,199520,40922,268352,224079,,,,,0,0,0,0
1650440241.0926316,public.usertable,199868,40977,276414464,16782,public,usertable,1,0,466055,1488876,224457,19743,24589,8263,199868,40977,268789,224457,,,,,0,0,0,0
1650440242.1212633,public.usertable,200221,41036,276905984,16782,public,usertable,1,0,467078,1489746,224850,19763,24629,8276,200221,41036,269242,224850,,,,,0,0,0,0
1650440243.151192,public.usertable,200590,41086,277405696,16782,public,usertable,1,0,468166,1491334,225254,19781,24664,8283,200590,41086,269699,225254,,,,,0,0,0,0
1650440244.1793618,public.usertable,200960,41138,277864448,16782,public,usertable,1,0,469213,1492113,225657,19800,24697,8293,200960,41138,270154,225657,,,,,0,0,0,0
1650440245.207822,public.usertable,201469,41207,278339584,16782,public,usertable,1,0,470770,1496160,226217,19827,24748,8304,201469,41207,270792,226217,,,,,0,0,0,0
1650440246.2378216,public.usertable,201843,41250,278839296,16782,public,usertable,1,0,471920,1498801,226619,19850,24776,8315,201843,41250,271245,226619,,,,,0,0,0,0
1650440247.2703977,public.usertable,202210,41306,279339008,16782,public,usertable,1,0,472954,1500744,227024,19872,24814,8328,202210,41306,271710,227024,,,,,0,0,0,0
1650440248.2988505,public.usertable,202587,41352,279830528,16782,public,usertable,1,0,473955,1501908,227428,19898,24841,8342,202587,41352,272167,227428,,,,,0,0,0,0
1650440249.3276837,public.usertable,202964,41397,280330240,16782,public,usertable,1,0,475054,1503177,227832,19921,24868,8358,202964,41397,272621,227832,,,,,0,0,0,0
1650440250.3588846,public.usertable,203315,41445,280797184,16782,public,usertable,1,0,476074,1504475,228213,19944,24898,8373,203315,41445,273055,228213,,,,,0,0,0,0
1650440251.3905485,public.usertable,203666,41481,281255936,16782,public,usertable,1,0,477105,1505779,228588,19966,24922,8387,203666,41481,273476,228588,,,,,0,0,0,0
1650440252.4212236,public.usertable,203959,41524,281665536,16782,public,usertable,1,0,477915,1507362,228914,19984,24955,8393,203959,41524,273853,228914,,,,,0,0,0,0
1650440253.4532187,public.usertable,204288,41564,282116096,16782,public,usertable,1,0,478862,1509613,229274,19999,24986,8398,204288,41564,274259,229274,,,,,0,0,0,0
1650440254.4869123,public.usertable,204643,41589,282574848,16782,public,usertable,1,0,479747,1511544,229643,20016,25000,8403,204643,41589,274659,229643,,,,,0,0,0,0
1650440255.516504,public.usertable,204993,41642,283066368,16782,public,usertable,1,0,480809,1512101,230029,20040,25036,8410,204993,41642,275105,230029,,,,,0,0,0,0
1650440256.5452578,public.usertable,205363,41681,283557888,16782,public,usertable,1,0,481835,1514176,230422,20065,25059,8422,205363,41681,275546,230422,,,,,0,0,0,0
1650440257.5751224,public.usertable,205711,41738,284016640,16782,public,usertable,1,0,482783,1515424,230809,20087,25098,8430,205711,41738,275994,230809,,,,,0,0,0,0
1650440258.6046429,public.usertable,206057,41783,284475392,16782,public,usertable,1,0,483904,1517789,231186,20116,25129,8447,206057,41783,276431,231186,,,,,0,0,0,0
1650440259.6336417,public.usertable,206398,41822,284942336,16782,public,usertable,1,0,484937,1519662,231555,20136,25157,8456,206398,41822,276848,231555,,,,,0,0,0,0
1650440260.66486,public.usertable,206735,41855,285409280,16782,public,usertable,1,0,485959,1521396,231922,20152,25187,8464,206735,41855,277261,231922,,,,,0,0,0,0
1650440261.6948543,public.usertable,207086,41891,285884416,16782,public,usertable,1,0,486946,1522783,232301,20165,25215,8470,207086,41891,277681,232301,,,,,0,0,0,0
1650440262.7245228,public.usertable,207604,41959,286334976,16782,public,usertable,1,0,488526,1524866,232861,20203,25257,8490,207604,41959,278321,232861,,,,,0,0,0,0
1650440263.7537405,public.usertable,207994,41997,286842880,16782,public,usertable,1,0,489601,1526659,233276,20224,25282,8500,207994,41997,278782,233276,,,,,0,0,0,0
1650440264.7826748,public.usertable,208370,42050,287342592,16782,public,usertable,1,0,490615,1528460,233681,20249,25311,8514,208370,42050,279241,233681,,,,,0,0,0,0
1650440265.8126447,public.usertable,208738,42107,287842304,16782,public,usertable,1,0,491676,1529454,234083,20272,25345,8527,208738,42107,279700,234083,,,,,0,0,0,0
1650440266.8413968,public.usertable,209117,42154,288333824,16782,public,usertable,1,0,492647,1530416,234482,20301,25365,8544,209117,42154,280148,234482,,,,,0,0,0,0
1650440267.870979,public.usertable,209497,42186,288825344,16782,public,usertable,1,0,493699,1532633,234884,20314,25387,8550,209497,42186,280585,234884,,,,,0,0,0,0
1650440268.9013038,public.usertable,209871,42231,289316864,16782,public,usertable,1,0,494681,1533720,235289,20335,25418,8560,209871,42231,281042,235289,,,,,0,0,0,0
1650440269.932634,public.usertable,210231,42279,289808384,16782,public,usertable,1,0,495818,1535403,235679,20357,25448,8570,210231,42279,281484,235679,,,,,0,0,0,0
1650440270.9639103,public.usertable,210589,42323,290275328,16782,public,usertable,1,0,496848,1536139,236063,20380,25474,8585,210589,42323,281917,236063,,,,,0,0,0,0
1650440271.9958854,public.usertable,210938,42368,290742272,16782,public,usertable,1,0,497789,1537934,236446,20397,25508,8596,210938,42368,282351,236446,,,,,0,0,0,0
1650440273.0264819,public.usertable,211280,42407,291192832,16782,public,usertable,1,0,498782,1538584,236819,20407,25539,8603,211280,42407,282765,236819,,,,,0,0,0,0
1650440274.054841,public.usertable,211643,42440,291659776,16782,public,usertable,1,0,499745,1539281,237204,20421,25561,8613,211643,42440,283186,237204,,,,,0,0,0,0
1650440275.08798,public.usertable,211983,42490,292126720,16782,public,usertable,1,0,500679,1540314,237577,20443,25594,8627,211983,42490,283614,237577,,,,,0,0,0,0
1650440276.11679,public.usertable,212334,42541,292601856,16782,public,usertable,1,0,501640,1541692,237953,20470,25619,8640,212334,42541,284042,237953,,,,,0,0,0,0
1650440277.1467957,public.usertable,212678,42601,293068800,16782,public,usertable,1,0,502733,1543548,238334,20496,25656,8655,212678,42601,284486,238334,,,,,0,0,0,0
1650440278.1757019,public.usertable,213027,42641,293552128,16782,public,usertable,1,0,503651,1544879,238710,20515,25683,8662,213027,42641,284908,238710,,,,,0,0,0,0
1650440279.2057283,public.usertable,213402,42673,294027264,16782,public,usertable,1,0,504688,1546101,239112,20533,25710,8666,213402,42673,285355,239112,,,,,0,0,0,0
1650440280.2354405,public.usertable,213751,42722,294518784,16782,public,usertable,1,0,505716,1548070,239486,20563,25735,8679,213751,42722,285784,239486,,,,,0,0,0,0
1650440281.2652802,public.usertable,214276,42793,294969344,16782,public,usertable,1,0,507185,1550665,240045,20603,25769,8699,214276,42793,286417,240045,,,,,0,0,0,0
1650440282.294768,public.usertable,214635,42824,295436288,16782,public,usertable,1,0,508142,1552129,240427,20625,25792,8710,214635,42824,286844,240427,,,,,0,0,0,0
1650440283.3307238,public.usertable,214959,42870,295870464,16782,public,usertable,1,0,509128,1553037,240786,20641,25827,8722,214959,42870,287254,240786,,,,,0,0,0,0
1650440284.3661952,public.usertable,215295,42916,296321024,16782,public,usertable,1,0,510181,1554266,241144,20667,25849,8737,215295,42916,287660,241144,,,,,0,0,0,0
1650440285.3964598,public.usertable,215647,42974,296812544,16782,public,usertable,1,0,511118,1554811,241528,20693,25881,8748,215647,42974,288102,241528,,,,,0,0,0,0
1650440286.4256473,public.usertable,216022,43017,297304064,16782,public,usertable,1,0,512096,1556101,241932,20709,25910,8761,216022,43017,288551,241932,,,,,0,0,0,0
1650440287.4560606,public.usertable,216414,43063,297795584,16782,public,usertable,1,0,513197,1557475,242347,20732,25933,8775,216414,43063,289012,242347,,,,,0,0,0,0
1650440288.4859235,public.usertable,216754,43112,298262528,16782,public,usertable,1,0,514149,1559590,242715,20756,25961,8786,216754,43112,289432,242715,,,,,0,0,0,0
1650440289.5174878,public.usertable,217139,43155,298778624,16782,public,usertable,1,0,515143,1560625,243130,20777,25991,8798,217139,43155,289898,243130,,,,,0,0,0,0
1650440290.5481162,public.usertable,217518,43204,299286528,16782,public,usertable,1,0,516192,1561308,243539,20799,26021,8806,217518,43204,290359,243539,,,,,0,0,0,0
1650440291.576743,public.usertable,217895,43252,299786240,16782,public,usertable,1,0,517290,1562601,243946,20820,26051,8816,217895,43252,290817,243946,,,,,0,0,0,0
1650440292.6062121,public.usertable,218259,43303,300294144,16782,public,usertable,1,0,518401,1563887,244345,20840,26086,8823,218259,43303,291271,244345,,,,,0,0,0,0
1650440293.6374104,public.usertable,218576,43345,300728320,16782,public,usertable,1,0,519310,1565395,244679,20870,26103,8834,218576,43345,291652,244679,,,,,0,0,0,0
1650440294.673456,public.usertable,218949,43386,301219840,16782,public,usertable,1,0,520331,1567102,245084,20890,26135,8845,218949,43386,292109,245084,,,,,0,0,0,0
1650440295.703729,public.usertable,219314,43431,301694976,16782,public,usertable,1,0,521218,1568403,245475,20915,26161,8859,219314,43431,292551,245475,,,,,0,0,0,0
1650440296.7365272,public.usertable,219660,43483,302170112,16782,public,usertable,1,0,522212,1569857,245845,20944,26185,8872,219660,43483,292974,245845,,,,,0,0,0,0
1650440297.767082,public.usertable,220008,43519,302661632,16782,public,usertable,1,0,523392,1572965,246229,20966,26221,8882,220008,43519,293416,246229,,,,,0,0,0,0
1650440298.7959003,public.usertable,220601,43584,303177728,16782,public,usertable,1,0,524996,1574168,246861,21005,26260,8905,220601,43584,294126,246861,,,,,0,0,0,0
1650440299.82699,public.usertable,220963,43625,303661056,16782,public,usertable,1,0,526039,1576527,247252,21024,26289,8916,220963,43625,294565,247252,,,,,0,0,0,0
1650440300.85892,public.usertable,221337,43661,304152576,16782,public,usertable,1,0,527143,1578317,247650,21046,26313,8929,221337,43661,295009,247650,,,,,0,0,0,0
1650440301.8876812,public.usertable,221713,43696,304635904,16782,public,usertable,1,0,528136,1580515,248047,21066,26334,8939,221713,43696,295447,248047,,,,,0,0,0,0
1650440302.9169996,public.usertable,222081,43736,305127424,16782,public,usertable,1,0,529265,1582160,248441,21087,26360,8951,222081,43736,295888,248441,,,,,0,0,0,0
1650440303.9480834,public.usertable,222442,43796,305602560,16782,public,usertable,1,0,530302,1583505,248830,21122,26388,8970,222442,43796,296340,248830,,,,,0,0,0,0
1650440304.9779778,public.usertable,222795,43853,306085888,16782,public,usertable,1,0,531451,1585241,249219,21145,26424,8979,222795,43853,296788,249219,,,,,0,0,0,0
1650440306.0074244,public.usertable,223159,43895,306569216,16782,public,usertable,1,0,532662,1586212,249608,21167,26449,8989,223159,43895,297224,249608,,,,,0,0,0,0
1650440307.0376558,public.usertable,223546,43941,307093504,16782,public,usertable,1,0,533782,1586852,250024,21190,26478,9000,223546,43941,297692,250024,,,,,0,0,0,0
1650440308.07012,public.usertable,223926,43988,307609600,16782,public,usertable,1,0,534805,1587615,250436,21209,26510,9011,223926,43988,298155,250436,,,,,0,0,0,0
1650440309.107099,public.usertable,224298,44018,308092928,16782,public,usertable,1,0,535817,1589030,250828,21228,26530,9020,224298,44018,298586,250828,,,,,0,0,0,0
1650440310.1380363,public.usertable,224670,44057,308576256,16782,public,usertable,1,0,536876,1590650,251222,21251,26552,9031,224670,44057,299025,251222,,,,,0,0,0,0
1650440311.1691496,public.usertable,225032,44095,309051392,16782,public,usertable,1,0,537923,1592458,251612,21265,26580,9038,225032,44095,299457,251612,,,,,0,0,0,0
1650440312.1988153,public.usertable,225386,44119,309485568,16782,public,usertable,1,0,538995,1594051,251983,21283,26597,9048,225386,44119,299863,251983,,,,,0,0,0,0
1650440313.2291193,public.usertable,225740,44148,309960704,16782,public,usertable,1,0,540016,1595358,252359,21300,26619,9057,225740,44148,300278,252359,,,,,0,0,0,0
1650440314.258775,public.usertable,226096,44180,310435840,16782,public,usertable,1,0,541082,1596034,252740,21312,26644,9065,226096,44180,300696,252740,,,,,0,0,0,0
1650440315.289514,public.usertable,226460,44220,310902784,16782,public,usertable,1,0,542101,1598478,253130,21330,26670,9075,226460,44220,301130,253130,,,,,0,0,0,0
1650440316.320141,public.usertable,226965,44283,311361536,16782,public,usertable,1,0,543706,1600570,253681,21359,26716,9090,226965,44283,301756,253681,,,,,0,0,0,0
1650440317.348489,public.usertable,227338,44316,311836672,16782,public,usertable,1,0,544834,1601331,254072,21376,26734,9098,227338,44316,302182,254072,,,,,0,0,0,0
1650440318.3766904,public.usertable,227681,44355,312295424,16782,public,usertable,1,0,545873,1602908,254439,21397,26758,9106,227681,44355,302594,254439,,,,,0,0,0,0
1650440319.4067569,public.usertable,228065,44393,312795136,16782,public,usertable,1,0,546863,1603888,254846,21412,26781,9109,228065,44393,303039,254846,,,,,0,0,0,0
1650440320.4359045,public.usertable,228419,44423,313262080,16782,public,usertable,1,0,547899,1604898,255219,21428,26800,9115,228419,44423,303447,255219,,,,,0,0,0,0
1650440321.4645715,public.usertable,228786,44473,313761792,16782,public,usertable,1,0,548978,1606159,255615,21453,26829,9128,228786,44473,303897,255615,,,,,0,0,0,0
1650440322.4963,public.usertable,229179,44516,314286080,16782,public,usertable,1,0,550026,1606775,256036,21470,26857,9134,229179,44516,304363,256036,,,,,0,0,0,0
1650440323.5337849,public.usertable,229575,44563,314802176,16782,public,usertable,1,0,551094,1608461,256459,21496,26884,9145,229575,44563,304839,256459,,,,,0,0,0,0
1650440324.5624924,public.usertable,229922,44598,315236352,16782,public,usertable,1,0,552051,1609897,256832,21507,26910,9151,229922,44598,305249,256832,,,,,0,0,0,0
1650440325.593284,public.usertable,230306,44641,315752448,16782,public,usertable,1,0,553157,1611104,257244,21524,26938,9159,230306,44641,305706,257244,,,,,0,0,0,0
1650440326.624001,public.usertable,230693,44686,316276736,16782,public,usertable,1,0,554203,1612529,257661,21545,26968,9167,230693,44686,306174,257661,,,,,0,0,0,0
1650440327.652357,public.usertable,231096,44735,316817408,16782,public,usertable,1,0,555457,1614568,258094,21569,26998,9175,231096,44735,306661,258094,,,,,0,0,0,0
1650440328.683852,public.usertable,231459,44798,317300736,16782,public,usertable,1,0,556493,1615829,258493,21599,27034,9194,231459,44798,307126,258493,,,,,0,0,0,0
1650440329.7134154,public.usertable,231799,44847,317759488,16782,public,usertable,1,0,557629,1618852,258863,21623,27064,9204,231799,44847,307550,258863,,,,,0,0,0,0
1650440330.741684,public.usertable,232178,44897,318275584,16782,public,usertable,1,0,558672,1619885,259274,21644,27096,9216,232178,44897,308014,259274,,,,,0,0,0,0
1650440331.7735784,public.usertable,232561,44936,318767104,16782,public,usertable,1,0,559792,1621506,259677,21671,27116,9232,232561,44936,308464,259677,,,,,0,0,0,0
1650440332.802586,public.usertable,232920,44983,319250432,16782,public,usertable,1,0,560871,1622462,260067,21689,27147,9242,232920,44983,308903,260067,,,,,0,0,0,0
1650440333.8334742,public.usertable,233302,45025,319741952,16782,public,usertable,1,0,562001,1623601,260481,21711,27179,9257,233302,45025,309371,260481,,,,,0,0,0,0
1650440334.8656583,public.usertable,233866,45082,320249856,16782,public,usertable,1,0,563606,1626218,261082,21741,27216,9273,233866,45082,310039,261082,,,,,0,0,0,0
1650440335.8962946,public.usertable,234244,45123,320749568,16782,public,usertable,1,0,564591,1627635,261483,21759,27239,9278,234244,45123,310481,261483,,,,,0,0,0,0
1650440336.9248548,public.usertable,234640,45162,321265664,16782,public,usertable,1,0,565707,1629000,261898,21784,27258,9289,234640,45162,310940,261898,,,,,0,0,0,0
1650440337.9534092,public.usertable,235017,45202,321748992,16782,public,usertable,1,0,566707,1630440,262298,21806,27281,9301,235017,45202,311385,262298,,,,,0,0,0,0
1650440338.9857624,public.usertable,235381,45252,322240512,16782,public,usertable,1,0,567651,1631580,262696,21830,27315,9316,235381,45252,311841,262696,,,,,0,0,0,0
1650440340.0155728,public.usertable,235700,45305,322682880,16782,public,usertable,1,0,568735,1632414,263051,21851,27351,9326,235700,45305,312253,263051,,,,,0,0,0,0
1650440341.0458083,public.usertable,236023,45348,323117056,16782,public,usertable,1,0,569629,1633986,263409,21867,27386,9331,236023,45348,312662,263409,,,,,0,0,0,0
1650440342.0755837,public.usertable,236349,45393,323567616,16782,public,usertable,1,0,570683,1636574,263766,21887,27417,9342,236349,45393,313070,263766,,,,,0,0,0,0
1650440343.1049213,public.usertable,236679,45441,324018176,16782,public,usertable,1,0,571760,1638598,264128,21911,27449,9354,236679,45441,313488,264128,,,,,0,0,0,0
1650440344.136823,public.usertable,237039,45480,324485120,16782,public,usertable,1,0,572759,1639395,264510,21934,27471,9366,237039,45480,313915,264510,,,,,0,0,0,0
1650440345.1666312,public.usertable,237398,45514,324943872,16782,public,usertable,1,0,573711,1639850,264893,21951,27495,9377,237398,45514,314339,264893,,,,,0,0,0,0
1650440346.196046,public.usertable,237719,45549,325369856,16782,public,usertable,1,0,574607,1640558,265240,21964,27521,9382,237719,45549,314725,265240,,,,,0,0,0,0
1650440347.225588,public.usertable,238049,45600,325853184,16782,public,usertable,1,0,575614,1642076,265604,21986,27555,9395,238049,45600,315145,265604,,,,,0,0,0,0
1650440348.2543495,public.usertable,238443,45630,326311936,16782,public,usertable,1,0,576750,1644310,266020,22008,27577,9409,238443,45630,315605,266020,,,,,0,0,0,0
1650440349.2849917,public.usertable,238760,45674,326746112,16782,public,usertable,1,0,577712,1645547,266359,22033,27599,9420,238760,45674,315991,266359,,,,,0,0,0,0
1650440350.3157482,public.usertable,239092,45714,327213056,16782,public,usertable,1,0,578732,1646737,266719,22048,27627,9432,239092,45714,316394,266719,,,,,0,0,0,0
1650440351.3457255,public.usertable,239432,45745,327639040,16782,public,usertable,1,0,579658,1647599,267076,22065,27644,9439,239432,45745,316785,267076,,,,,0,0,0,0
1650440352.37582,public.usertable,239740,45794,328056832,16782,public,usertable,1,0,580683,1648657,267410,22092,27670,9453,239740,45794,317172,267410,,,,,0,0,0,0
1650440353.4052906,public.usertable,240078,45819,328474624,16782,public,usertable,1,0,581544,1649503,267763,22108,27685,9462,240078,45819,317556,267763,,,,,0,0,0,0
1650440354.4358428,public.usertable,240547,45859,328876032,16782,public,usertable,1,0,582985,1650747,268256,22129,27709,9471,240547,45859,318094,268256,,,,,0,0,0,0
1650440355.4653077,public.usertable,240822,45883,329236480,16782,public,usertable,1,0,583697,1651790,268540,22146,27718,9480,240822,45883,318404,268540,,,,,0,0,0,0
1650440356.4940066,public.usertable,241174,45909,329678848,16782,public,usertable,1,0,584571,1653488,268908,22164,27734,9490,241174,45909,318806,268908,,,,,0,0,0,0
1650440357.5247328,public.usertable,241473,45932,330072064,16782,public,usertable,1,0,585468,1654250,269225,22176,27752,9496,241473,45932,319153,269225,,,,,0,0,0,0
1650440358.5571933,public.usertable,241753,45963,330448896,16782,public,usertable,1,0,586288,1655521,269528,22188,27775,9505,241753,45963,319491,269528,,,,,0,0,0,0
1650440359.5877542,public.usertable,242102,45993,330907648,16782,public,usertable,1,0,587337,1656518,269900,22203,27798,9514,242102,45993,319901,269900,,,,,0,0,0,0
1650440360.6178517,public.usertable,242439,46025,331325440,16782,public,usertable,1,0,588332,1657186,270258,22217,27819,9523,242439,46025,320294,270258,,,,,0,0,0,0
1650440361.6472833,public.usertable,242773,46062,331767808,16782,public,usertable,1,0,589338,1658618,270617,22233,27844,9532,242773,46062,320694,270617,,,,,0,0,0,0
1650440362.6758347,public.usertable,243099,46100,332201984,16782,public,usertable,1,0,590253,1659612,270961,22261,27862,9542,243099,46100,321084,270961,,,,,0,0,0,0
1650440363.7048595,public.usertable,243391,46126,332537856,16782,public,usertable,1,0,591105,1660299,271272,22272,27881,9548,243391,46126,321425,271272,,,,,0,0,0,0
1650440364.7340667,public.usertable,243687,46161,332980224,16782,public,usertable,1,0,591904,1661498,271589,22288,27902,9560,243687,46161,321779,271589,,,,,0,0,0,0
1650440365.7657135,public.usertable,243961,46195,333291520,16782,public,usertable,1,0,592707,1662754,271883,22304,27922,9569,243961,46195,322109,271883,,,,,0,0,0,0
1650440366.7966616,public.usertable,244255,46228,333733888,16782,public,usertable,1,0,593531,1664366,272200,22325,27945,9578,244255,46228,322470,272200,,,,,0,0,0,0
1650440367.826285,public.usertable,244595,46263,334209024,16782,public,usertable,1,0,594433,1665030,272559,22344,27964,9584,244595,46263,322867,272559,,,,,0,0,0,0
1650440368.855287,public.usertable,244983,46298,334692352,16782,public,usertable,1,0,595419,1666155,272969,22359,27986,9592,244983,46298,323314,272969,,,,,0,0,0,0
1650440369.8847353,public.usertable,245343,46333,335142912,16782,public,usertable,1,0,596443,1667285,273350,22376,28007,9599,245343,46333,323733,273350,,,,,0,0,0,0
1650440370.9140253,public.usertable,245615,46355,335503360,16782,public,usertable,1,0,597142,1668138,273639,22391,28024,9606,245615,46355,324054,273639,,,,,0,0,0,0
1650440371.9421968,public.usertable,245958,46389,335970304,16782,public,usertable,1,0,598077,1670121,274001,22410,28043,9616,245958,46389,324454,274001,,,,,0,0,0,0
1650440372.9725025,public.usertable,246316,46421,336453632,16782,public,usertable,1,0,599151,1671960,274383,22433,28067,9629,246316,46421,324883,274383,,,,,0,0,0,0
1650440374.0038,public.usertable,246897,46480,336953344,16782,public,usertable,1,0,600723,1673570,274996,22463,28099,9648,246897,46480,325558,274996,,,,,0,0,0,0
1650440375.0365844,public.usertable,247263,46529,337436672,16782,public,usertable,1,0,601796,1675092,275390,22488,28127,9662,247263,46529,326005,275390,,,,,0,0,0,0
1650440376.0674472,public.usertable,247625,46571,337928192,16782,public,usertable,1,0,602827,1676280,275781,22502,28156,9672,247625,46571,326439,275781,,,,,0,0,0,0
1650440377.0957682,public.usertable,248004,46608,338411520,16782,public,usertable,1,0,603918,1676607,276182,22518,28178,9682,248004,46608,326878,276182,,,,,0,0,0,0
1650440378.1285663,public.usertable,248366,46638,338894848,16782,public,usertable,1,0,604869,1677677,276567,22534,28201,9687,248366,46638,327302,276567,,,,,0,0,0,0
1650440379.1584003,public.usertable,248727,46673,339361792,16782,public,usertable,1,0,605881,1679016,276951,22552,28224,9697,248727,46673,327727,276951,,,,,0,0,0,0
1650440380.1894276,public.usertable,249105,46710,339836928,16782,public,usertable,1,0,606893,1680447,277346,22577,28241,9712,249105,46710,328164,277346,,,,,0,0,0,0
1650440381.2177808,public.usertable,249449,46754,340312064,16782,public,usertable,1,0,607966,1681525,277714,22601,28265,9723,249449,46754,328580,277714,,,,,0,0,0,0
1650440382.246401,public.usertable,249831,46784,340795392,16782,public,usertable,1,0,609016,1683204,278118,22622,28287,9729,249831,46784,329027,278118,,,,,0,0,0,0
1650440383.2758703,public.usertable,250164,46808,341229568,16782,public,usertable,1,0,609958,1684242,278468,22633,28304,9734,250164,46808,329405,278468,,,,,0,0,0,0
1650440384.3052897,public.usertable,250461,46853,341655552,16782,public,usertable,1,0,610985,1685005,278794,22651,28333,9744,250461,46853,329778,278794,,,,,0,0,0,0
1650440385.3360617,public.usertable,250850,46885,342106112,16782,public,usertable,1,0,612025,1686153,279207,22667,28357,9752,250850,46885,330231,279207,,,,,0,0,0,0
1650440386.3657546,public.usertable,251174,46928,342581248,16782,public,usertable,1,0,612985,1687227,279553,22693,28379,9767,251174,46928,330625,279553,,,,,0,0,0,0
1650440387.3978462,public.usertable,251535,46976,343072768,16782,public,usertable,1,0,614104,1687964,279948,22712,28413,9772,251535,46976,331073,279948,,,,,0,0,0,0
1650440388.4294326,public.usertable,251900,47022,343556096,16782,public,usertable,1,0,615233,1689275,280344,22728,28444,9783,251900,47022,331516,280344,,,,,0,0,0,0
1650440389.4593525,public.usertable,252271,47071,344064000,16782,public,usertable,1,0,616297,1690226,280750,22746,28479,9794,252271,47071,331975,280750,,,,,0,0,0,0
1650440390.4897978,public.usertable,252661,47115,344571904,16782,public,usertable,1,0,617491,1691190,281164,22770,28503,9805,252661,47115,332437,281164,,,,,0,0,0,0
1650440391.5220342,public.usertable,253239,47178,345088000,16782,public,usertable,1,0,619173,1693403,281784,22798,28545,9819,253239,47178,333127,281784,,,,,0,0,0,0
1650440392.550699,public.usertable,253610,47214,345571328,16782,public,usertable,1,0,620354,1694768,282184,22811,28574,9828,253610,47214,333569,282184,,,,,0,0,0,0
1650440393.5814962,public.usertable,253975,47257,346054656,16782,public,usertable,1,0,621350,1696279,282575,22834,28600,9839,253975,47257,334009,282575,,,,,0,0,0,0
1650440394.6117218,public.usertable,254357,47302,346562560,16782,public,usertable,1,0,622421,1696873,282983,22857,28626,9851,254357,47302,334466,282983,,,,,0,0,0,0
1650440395.6428666,public.usertable,254754,47342,347078656,16782,public,usertable,1,0,623518,1697905,283404,22876,28650,9860,254754,47342,334930,283404,,,,,0,0,0,0
1650440396.6737301,public.usertable,255154,47384,347602944,16782,public,usertable,1,0,624697,1698373,283826,22899,28672,9874,255154,47384,335397,283826,,,,,0,0,0,0
1650440397.7046673,public.usertable,255562,47421,348127232,16782,public,usertable,1,0,625759,1699111,284254,22917,28692,9884,255562,47421,335863,284254,,,,,0,0,0,0
1650440398.7353158,public.usertable,255941,47453,348635136,16782,public,usertable,1,0,626880,1701286,284661,22935,28720,9893,255941,47453,336316,284661,,,,,0,0,0,0
1650440399.764116,public.usertable,256320,47494,349134848,16782,public,usertable,1,0,627895,1702724,285070,22950,28750,9899,256320,47494,336770,285070,,,,,0,0,0,0
1650440400.7935936,public.usertable,256697,47537,349618176,16782,public,usertable,1,0,628898,1704189,285474,22969,28777,9908,256697,47537,337220,285474,,,,,0,0,0,0
1650440401.824831,public.usertable,257044,47571,350076928,16782,public,usertable,1,0,629826,1705503,285847,22984,28803,9913,257044,47571,337634,285847,,,,,0,0,0,0
1650440402.8541002,public.usertable,257411,47602,350560256,16782,public,usertable,1,0,630809,1706576,286236,22996,28825,9919,257411,47602,338057,286236,,,,,0,0,0,0
1650440403.8839324,public.usertable,257776,47634,351027200,16782,public,usertable,1,0,631808,1707321,286614,23020,28838,9932,257776,47634,338472,286614,,,,,0,0,0,0
1650440404.9132206,public.usertable,258155,47678,351510528,16782,public,usertable,1,0,632819,1707957,287018,23039,28863,9942,258155,47678,338920,287018,,,,,0,0,0,0
1650440405.9447105,public.usertable,258516,47720,352002048,16782,public,usertable,1,0,633829,1710317,287406,23061,28890,9956,258516,47720,339357,287406,,,,,0,0,0,0
1650440406.9744923,public.usertable,258892,47763,352485376,16782,public,usertable,1,0,634913,1712154,287806,23084,28914,9966,258892,47763,339804,287806,,,,,0,0,0,0
1650440408.0051303,public.usertable,259255,47800,352960512,16782,public,usertable,1,0,635919,1714645,288189,23103,28934,9978,259255,47800,340226,288189,,,,,0,0,0,0
1650440409.0358083,public.usertable,259600,47843,353411072,16782,public,usertable,1,0,636917,1715436,288566,23117,28966,9985,259600,47843,340649,288566,,,,,0,0,0,0
1650440410.0645232,public.usertable,260169,47901,353927168,16782,public,usertable,1,0,638611,1717023,289168,23149,28999,10006,260169,47901,341316,289168,,,,,0,0,0,0
1650440411.0940206,public.usertable,260548,47936,354410496,16782,public,usertable,1,0,639632,1718099,289573,23160,29025,10012,260548,47936,341758,289573,,,,,0,0,0,0
1650440412.1232135,public.usertable,260908,47965,354893824,16782,public,usertable,1,0,640640,1719531,289955,23177,29047,10019,260908,47965,342179,289955,,,,,0,0,0,0
1650440413.1563387,public.usertable,261268,47999,355360768,16782,public,usertable,1,0,641689,1721047,290338,23197,29070,10030,261268,47999,342605,290338,,,,,0,0,0,0
1650440414.1876006,public.usertable,261654,48026,355835904,16782,public,usertable,1,0,642761,1722536,290737,23218,29083,10045,261654,48026,343038,290737,,,,,0,0,0,0
1650440415.2182627,public.usertable,261993,48065,356294656,16782,public,usertable,1,0,643725,1724402,291102,23233,29109,10050,261993,48065,343444,291102,,,,,0,0,0,0
1650440416.2467282,public.usertable,262314,48083,356704256,16782,public,usertable,1,0,644577,1725609,291434,23245,29120,10058,262314,48083,343799,291434,,,,,0,0,0,0
1650440417.2756672,public.usertable,262677,48106,357171200,16782,public,usertable,1,0,645593,1728112,291815,23262,29138,10066,262677,48106,344215,291815,,,,,0,0,0,0
1650440418.3068063,public.usertable,263007,48147,357597184,16782,public,usertable,1,0,646571,1729600,292168,23282,29161,10077,263007,48147,344611,292168,,,,,0,0,0,0
1650440419.3388672,public.usertable,263344,48178,358014976,16782,public,usertable,1,0,647425,1729861,292521,23297,29177,10085,263344,48178,344995,292521,,,,,0,0,0,0
1650440420.3694549,public.usertable,263674,48218,358490112,16782,public,usertable,1,0,648374,1730532,292873,23317,29199,10099,263674,48218,345389,292873,,,,,0,0,0,0
1650440421.3993495,public.usertable,264048,48264,358981632,16782,public,usertable,1,0,649430,1731267,293277,23334,29229,10107,264048,48264,345840,293277,,,,,0,0,0,0
1650440422.4294055,public.usertable,264437,48294,359473152,16782,public,usertable,1,0,650563,1732204,293686,23346,29249,10114,264437,48294,346281,293686,,,,,0,0,0,0
1650440423.4597795,public.usertable,264811,48323,359964672,16782,public,usertable,1,0,651711,1733908,294079,23366,29268,10121,264811,48323,346713,294079,,,,,0,0,0,0
1650440424.4889526,public.usertable,265200,48373,360505344,16782,public,usertable,1,0,652775,1734933,294497,23390,29297,10134,265200,48373,347184,294497,,,,,0,0,0,0
1650440425.5178201,public.usertable,265591,48407,360980480,16782,public,usertable,1,0,653856,1735593,294912,23405,29321,10140,265591,48407,347638,294912,,,,,0,0,0,0
1650440426.546815,public.usertable,265953,48453,361480192,16782,public,usertable,1,0,654912,1736266,295302,23430,29349,10157,265953,48453,348081,295302,,,,,0,0,0,0
1650440427.5782702,public.usertable,266348,48493,361988096,16782,public,usertable,1,0,655978,1736916,295717,23450,29369,10167,266348,48493,348536,295717,,,,,0,0,0,0
1650440428.60729,public.usertable,266910,48539,362463232,16782,public,usertable,1,0,657501,1738101,296305,23478,29395,10181,266910,48539,349178,296305,,,,,0,0,0,0
1650440429.6362615,public.usertable,267283,48576,362938368,16782,public,usertable,1,0,658533,1739164,296695,23501,29412,10197,267283,48576,349608,296695,,,,,0,0,0,0
1650440430.6661463,public.usertable,267649,48624,363421696,16782,public,usertable,1,0,659779,1740292,297094,23518,29445,10205,267649,48624,350057,297094,,,,,0,0,0,0
1650440431.6949997,public.usertable,267985,48669,363880448,16782,public,usertable,1,0,660906,1741303,297460,23537,29475,10214,267985,48669,350472,297460,,,,,0,0,0,0
1650440432.723895,public.usertable,268361,48700,364363776,16782,public,usertable,1,0,661960,1742834,297861,23551,29500,10221,268361,48700,350912,297861,,,,,0,0,0,0
1650440433.7523193,public.usertable,268719,48742,364838912,16782,public,usertable,1,0,663134,1744536,298245,23569,29526,10230,268719,48742,351340,298245,,,,,0,0,0,0
1650440434.782621,public.usertable,269116,48780,365346816,16782,public,usertable,1,0,664205,1745032,298664,23586,29548,10239,269116,48780,351798,298664,,,,,0,0,0,0
1650440435.8139179,public.usertable,269488,48813,365846528,16782,public,usertable,1,0,665313,1747154,299056,23608,29568,10251,269488,48813,352232,299056,,,,,0,0,0,0
1650440436.8434777,public.usertable,269886,48843,366346240,16782,public,usertable,1,0,666354,1748410,299473,23622,29587,10255,269886,48843,352682,299473,,,,,0,0,0,0
1650440437.8765714,public.usertable,270252,48873,366821376,16782,public,usertable,1,0,667332,1750419,299859,23637,29607,10264,270252,48873,353103,299859,,,,,0,0,0,0
1650440438.907304,public.usertable,270612,48912,367321088,16782,public,usertable,1,0,668302,1751180,300246,23654,29634,10276,270612,48912,353534,300246,,,,,0,0,0,0
1650440439.9382665,public.usertable,271014,48938,367820800,16782,public,usertable,1,0,669389,1752684,300663,23672,29649,10286,271014,48938,353984,300663,,,,,0,0,0,0
1650440440.9666884,public.usertable,271391,48981,368320512,16782,public,usertable,1,0,670408,1754008,301062,23695,29671,10300,271391,48981,354428,301062,,,,,0,0,0,0
1650440441.9956512,public.usertable,271774,49012,368795648,16782,public,usertable,1,0,671496,1755663,301465,23710,29691,10310,271774,49012,354866,301465,,,,,0,0,0,0
1650440443.025141,public.usertable,272136,49037,369278976,16782,public,usertable,1,0,672594,1757571,301850,23724,29714,10317,272136,49037,355288,301850,,,,,0,0,0,0
1650440444.0545335,public.usertable,272521,49077,369770496,16782,public,usertable,1,0,673683,1758064,302261,23739,29740,10328,272521,49077,355740,302261,,,,,0,0,0,0
1650440445.0890863,public.usertable,272875,49113,370229248,16782,public,usertable,1,0,674642,1759460,302638,23759,29763,10340,272875,49113,356160,302638,,,,,0,0,0,0
1650440446.1177206,public.usertable,273237,49169,370712576,16782,public,usertable,1,0,675731,1760483,303035,23781,29798,10350,273237,49169,356614,303035,,,,,0,0,0,0
1650440447.1462662,public.usertable,273589,49207,371154944,16782,public,usertable,1,0,676796,1761342,303410,23799,29821,10358,273589,49207,357030,303410,,,,,0,0,0,0
1650440448.177551,public.usertable,274157,49264,371671040,16782,public,usertable,1,0,678356,1763555,304006,23833,29849,10371,274157,49264,357688,304006,,,,,0,0,0,0
1650440449.206761,public.usertable,274572,49290,372203520,16782,public,usertable,1,0,679367,1764251,304439,23848,29867,10380,274572,49290,358154,304439,,,,,0,0,0,0
1650440450.2351003,public.usertable,274966,49312,372695040,16782,public,usertable,1,0,680437,1766144,304855,23858,29889,10385,274966,49312,358602,304855,,,,,0,0,0,0
1650440451.2653875,public.usertable,275358,49345,373211136,16782,public,usertable,1,0,681567,1767041,305270,23874,29912,10395,275358,49345,359056,305270,,,,,0,0,0,0
1650440452.2949786,public.usertable,275743,49375,373694464,16782,public,usertable,1,0,682665,1767812,305670,23893,29927,10404,275743,49375,359490,305670,,,,,0,0,0,0
1650440453.3249578,public.usertable,276075,49412,374136832,16782,public,usertable,1,0,683771,1770321,306025,23911,29950,10413,276075,49412,359886,306025,,,,,0,0,0,0
1650440454.3552856,public.usertable,276436,49448,374611968,16782,public,usertable,1,0,684752,1771566,306409,23925,29973,10419,276436,49448,360307,306409,,,,,0,0,0,0
1650440455.3878162,public.usertable,276849,49483,375136256,16782,public,usertable,1,0,685892,1773573,306843,23945,29994,10428,276849,49483,360782,306843,,,,,0,0,0,0
1650440456.4167137,public.usertable,277211,49517,375627776,16782,public,usertable,1,0,686901,1775006,307228,23963,30017,10439,277211,49517,361208,307228,,,,,0,0,0,0
1650440457.4454033,public.usertable,277573,49551,376102912,16782,public,usertable,1,0,688035,1776277,307616,23977,30043,10446,277573,49551,361636,307616,,,,,0,0,0,0
1650440458.4737425,public.usertable,277957,49577,376578048,16782,public,usertable,1,0,689084,1777003,308019,23988,30062,10452,277957,49577,362069,308019,,,,,0,0,0,0
1650440459.506415,public.usertable,278303,49614,377044992,16782,public,usertable,1,0,690056,1778515,308388,24012,30085,10463,278303,49614,362485,308388,,,,,0,0,0,0
1650440460.536815,public.usertable,278703,49650,377552896,16782,public,usertable,1,0,691120,1779477,308810,24027,30107,10476,278703,49650,362944,308810,,,,,0,0,0,0
1650440461.5659397,public.usertable,279056,49683,377995264,16782,public,usertable,1,0,692220,1781294,309189,24041,30133,10483,279056,49683,363363,309189,,,,,0,0,0,0
1650440462.599827,public.usertable,279392,49716,378445824,16782,public,usertable,1,0,693167,1782506,309552,24056,30160,10495,279392,49716,363768,309552,,,,,0,0,0,0
1650440463.6292524,public.usertable,279765,49747,378937344,16782,public,usertable,1,0,694201,1784270,309945,24072,30180,10506,279765,49747,364197,309945,,,,,0,0,0,0
1650440464.6605206,public.usertable,280144,49779,379437056,16782,public,usertable,1,0,695206,1785866,310343,24094,30199,10515,280144,49779,364636,310343,,,,,0,0,0,0
1650440465.6910121,public.usertable,280493,49823,379904000,16782,public,usertable,1,0,696143,1787304,310714,24116,30221,10527,280493,49823,365051,310714,,,,,0,0,0,0
1650440466.719772,public.usertable,281081,49879,380411904,16782,public,usertable,1,0,697762,1788818,311333,24146,30252,10542,281081,49879,365731,311333,,,,,0,0,0,0
1650440467.7480085,public.usertable,281465,49921,380911616,16782,public,usertable,1,0,698839,1789098,311741,24165,30276,10551,281465,49921,366182,311741,,,,,0,0,0,0
1650440468.778753,public.usertable,281828,49940,381362176,16782,public,usertable,1,0,699770,1790938,312118,24180,30290,10564,281828,49940,366588,312118,,,,,0,0,0,0
1650440469.8057494,public.usertable,282226,49967,381878272,16782,public,usertable,1,0,700797,1792412,312535,24194,30309,10571,282226,49967,367038,312535,,,,,0,0,0,0
1650440470.8384442,public.usertable,282588,50001,382353408,16782,public,usertable,1,0,701873,1793501,312923,24208,30335,10576,282588,50001,367466,312923,,,,,0,0,0,0
1650440471.8687193,public.usertable,282965,50025,382828544,16782,public,usertable,1,0,702829,1795367,313318,24217,30353,10580,282965,50025,367888,313318,,,,,0,0,0,0
1650440472.8996518,public.usertable,283336,50057,383303680,16782,public,usertable,1,0,703836,1796824,313707,24234,30371,10591,283336,50057,368312,313707,,,,,0,0,0,0
1650440473.9313662,public.usertable,283710,50093,383803392,16782,public,usertable,1,0,704914,1797536,314102,24254,30392,10601,283710,50093,368748,314102,,,,,0,0,0,0
1650440474.9602535,public.usertable,284053,50123,384196608,16782,public,usertable,1,0,705932,1798196,314460,24272,30407,10608,284053,50123,369139,314460,,,,,0,0,0,0
1650440475.9913023,public.usertable,284323,50150,384548864,16782,public,usertable,1,0,706680,1798673,314749,24285,30426,10616,284323,50150,369460,314749,,,,,0,0,0,0
1650440477.021478,public.usertable,284599,50178,384909312,16782,public,usertable,1,0,707494,1799562,315044,24295,30445,10622,284599,50178,369784,315044,,,,,0,0,0,0
1650440478.0507913,public.usertable,284879,50204,385335296,16782,public,usertable,1,0,708225,1800109,315340,24306,30461,10626,284879,50204,370107,315340,,,,,0,0,0,0
1650440479.0822897,public.usertable,285254,50245,385835008,16782,public,usertable,1,0,709253,1800822,315737,24333,30483,10643,285254,50245,370553,315737,,,,,0,0,0,0
1650440480.111583,public.usertable,285666,50282,386351104,16782,public,usertable,1,0,710380,1801256,316171,24349,30505,10650,285666,50282,371025,316171,,,,,0,0,0,0
1650440481.1418009,public.usertable,286049,50327,386875392,16782,public,usertable,1,0,711518,1802244,316582,24370,30533,10665,286049,50327,371485,316582,,,,,0,0,0,0
1650440482.1725237,public.usertable,286442,50361,387383296,16782,public,usertable,1,0,712593,1804000,317003,24386,30561,10678,286442,50361,371950,317003,,,,,0,0,0,0
1650440483.204043,public.usertable,286853,50392,387891200,16782,public,usertable,1,0,713786,1804773,317436,24401,30583,10685,286853,50392,372420,317436,,,,,0,0,0,0
1650440484.2338896,public.usertable,287231,50424,388399104,16782,public,usertable,1,0,714923,1805999,317840,24414,30609,10693,287231,50424,372863,317840,,,,,0,0,0,0
1650440485.265724,public.usertable,287799,50479,388890624,16782,public,usertable,1,0,716432,1807595,318441,24439,30642,10700,287799,50479,373522,318441,,,,,0,0,0,0
1650440486.2967432,public.usertable,288189,50504,389382144,16782,public,usertable,1,0,717532,1808605,318848,24456,30659,10711,288189,50504,373963,318848,,,,,0,0,0,0
1650440487.3252885,public.usertable,288583,50524,389890048,16782,public,usertable,1,0,718604,1810237,319259,24471,30676,10719,288583,50524,374406,319259,,,,,0,0,0,0
1650440488.3550835,public.usertable,288960,50563,390381568,16782,public,usertable,1,0,719695,1812513,319668,24483,30708,10728,288960,50563,374859,319668,,,,,0,0,0,0
1650440489.3865602,public.usertable,289328,50598,390856704,16782,public,usertable,1,0,720707,1813639,320060,24498,30732,10738,289328,50598,375290,320060,,,,,0,0,0,0
1650440490.4170337,public.usertable,289726,50624,391372800,16782,public,usertable,1,0,721759,1815726,320476,24511,30750,10746,289726,50624,375737,320476,,,,,0,0,0,0
1650440491.4471407,public.usertable,290096,50654,391831552,16782,public,usertable,1,0,722806,1817520,320862,24530,30766,10757,290096,50654,376158,320862,,,,,0,0,0,0
1650440492.4758582,public.usertable,290444,50675,392282112,16782,public,usertable,1,0,723739,1819651,321225,24544,30781,10764,290444,50675,376550,321225,,,,,0,0,0,0
1650440493.5114138,public.usertable,290799,50713,392732672,16782,public,usertable,1,0,724671,1820773,321602,24562,30803,10776,290799,50713,376967,321602,,,,,0,0,0,0
1650440494.5402,public.usertable,291142,50748,393183232,16782,public,usertable,1,0,725661,1821350,321967,24576,30825,10781,291142,50748,377368,321967,,,,,0,0,0,0
1650440495.5697513,public.usertable,291493,50781,393641984,16782,public,usertable,1,0,726594,1823422,322340,24593,30847,10789,291493,50781,377780,322340,,,,,0,0,0,0
1650440496.5985756,public.usertable,291815,50815,394084352,16782,public,usertable,1,0,727517,1824313,322684,24607,30869,10794,291815,50815,378160,322684,,,,,0,0,0,0
1650440497.6293607,public.usertable,292194,50851,394534912,16782,public,usertable,1,0,728540,1825562,323080,24629,30886,10810,292194,50851,378595,323080,,,,,0,0,0,0
1650440498.66297,public.usertable,292487,50879,394919936,16782,public,usertable,1,0,729479,1825758,323393,24640,30906,10817,292487,50879,378939,323393,,,,,0,0,0,0
1650440499.69416,public.usertable,292801,50919,395321344,16782,public,usertable,1,0,730391,1826438,323731,24656,30930,10824,292801,50919,379317,323731,,,,,0,0,0,0
1650440500.72419,public.usertable,293085,50953,395747328,16782,public,usertable,1,0,731215,1826674,324037,24670,30952,10833,293085,50953,379659,324037,,,,,0,0,0,0
1650440501.7590525,public.usertable,293453,50984,396214272,16782,public,usertable,1,0,732174,1827738,324423,24683,30970,10838,293453,50984,380076,324423,,,,,0,0,0,0
1650440502.789811,public.usertable,293815,51013,396673024,16782,public,usertable,1,0,733125,1828610,324799,24703,30984,10850,293815,51013,380486,324799,,,,,0,0,0,0
1650440503.819974,public.usertable,294347,51061,397131776,16782,public,usertable,1,0,734693,1830327,325362,24726,31015,10862,294347,51061,381103,325362,,,,,0,0,0,0
1650440504.8510625,public.usertable,294723,51078,397615104,16782,public,usertable,1,0,735829,1831263,325756,24735,31033,10865,294723,51078,381524,325756,,,,,0,0,0,0
1650440505.881779,public.usertable,295081,51109,398073856,16782,public,usertable,1,0,736879,1832555,326129,24756,31048,10877,295081,51109,381933,326129,,,,,0,0,0,0
1650440506.9154742,public.usertable,295461,51135,398573568,16782,public,usertable,1,0,737962,1834289,326524,24775,31063,10886,295461,51135,382362,326524,,,,,0,0,0,0
1650440507.9449103,public.usertable,295843,51167,399065088,16782,public,usertable,1,0,738897,1835169,326925,24790,31082,10895,295843,51167,382797,326925,,,,,0,0,0,0
1650440508.9766648,public.usertable,296166,51195,399474688,16782,public,usertable,1,0,739849,1835995,327266,24803,31100,10903,296166,51195,383169,327266,,,,,0,0,0,0
1650440510.0067773,public.usertable,296501,51219,399908864,16782,public,usertable,1,0,740782,1837176,327617,24816,31116,10912,296501,51219,383549,327617,,,,,0,0,0,0
1650440511.036781,public.usertable,296886,51247,400408576,16782,public,usertable,1,0,741940,1838204,328021,24828,31135,10919,296886,51247,383984,328021,,,,,0,0,0,0
1650440512.0685127,public.usertable,297279,51277,400908288,16782,public,usertable,1,0,743003,1838857,328432,24846,31153,10924,297279,51277,384431,328432,,,,,0,0,0,0
1650440513.0996296,public.usertable,297579,51304,401244160,16782,public,usertable,1,0,743838,1839077,328748,24859,31169,10932,297579,51304,384776,328748,,,,,0,0,0,0
1650440514.1281133,public.usertable,297826,51324,401588224,16782,public,usertable,1,0,744550,1839394,329012,24864,31186,10935,297826,51324,385062,329012,,,,,0,0,0,0
1650440515.1602764,public.usertable,298119,51351,401956864,16782,public,usertable,1,0,745390,1840401,329316,24881,31197,10943,298119,51351,385394,329316,,,,,0,0,0,0
1650440516.1909685,public.usertable,298352,51365,402227200,16782,public,usertable,1,0,745991,1840554,329560,24884,31208,10944,298352,51365,385652,329560,,,,,0,0,0,0
1650440517.2241764,public.usertable,298575,51384,402530304,16782,public,usertable,1,0,746598,1841636,329797,24894,31222,10949,298575,51384,385913,329797,,,,,0,0,0,0
1650440518.2544067,public.usertable,298834,51402,402882560,16782,public,usertable,1,0,747431,1842418,330065,24907,31231,10958,298834,51402,386203,330065,,,,,0,0,0,0
1650440519.2857192,public.usertable,299124,51432,403300352,16782,public,usertable,1,0,748252,1842536,330370,24922,31246,10968,299124,51432,386538,330370,,,,,0,0,0,0
1650440520.314378,public.usertable,299487,51461,403750912,16782,public,usertable,1,0,749160,1842824,330750,24934,31263,10975,299487,51461,386947,330750,,,,,0,0,0,0
1650440521.3435168,public.usertable,299828,51494,404168704,16782,public,usertable,1,0,750151,1843940,331115,24947,31287,10984,299828,51494,387349,331115,,,,,0,0,0,0
1650440522.3745267,public.usertable,300305,51537,404586496,16782,public,usertable,1,0,751399,1845046,331615,24974,31310,11003,300305,51537,387899,331615,,,,,0,0,0,0
1650440523.4042196,public.usertable,300663,51573,405053440,16782,public,usertable,1,0,752417,1846067,331997,24987,31334,11009,300663,51573,388318,331997,,,,,0,0,0,0
1650440524.4351711,public.usertable,301044,51596,405536768,16782,public,usertable,1,0,753434,1846871,332393,25000,31349,11018,301044,51596,388742,332393,,,,,0,0,0,0
1650440525.467576,public.usertable,301423,51623,406028288,16782,public,usertable,1,0,754377,1847163,332787,25013,31364,11025,301423,51623,389164,332787,,,,,0,0,0,0
1650440526.4983783,public.usertable,301837,51647,406544384,16782,public,usertable,1,0,755454,1849053,333216,25024,31379,11031,301837,51647,389619,333216,,,,,0,0,0,0
1650440527.528218,public.usertable,302253,51670,407060480,16782,public,usertable,1,0,756391,1850164,333645,25035,31392,11037,302253,51670,390072,333645,,,,,0,0,0,0
1650440528.5573654,public.usertable,302627,51696,407527424,16782,public,usertable,1,0,757366,1850922,334033,25047,31406,11043,302627,51696,390486,334033,,,,,0,0,0,0
1650440529.5876098,public.usertable,303009,51707,408010752,16782,public,usertable,1,0,758405,1852013,334429,25063,31420,11054,303009,51707,390912,334429,,,,,0,0,0,0
1650440530.6169503,public.usertable,303386,51735,408502272,16782,public,usertable,1,0,759537,1852718,334820,25085,31434,11063,303386,51735,391339,334820,,,,,0,0,0,0
1650440531.646343,public.usertable,303760,51755,408977408,16782,public,usertable,1,0,760640,1854276,335208,25102,31448,11071,303760,51755,391758,335208,,,,,0,0,0,0
1650440532.6771863,public.usertable,304111,51780,409419776,16782,public,usertable,1,0,761702,1855513,335577,25117,31466,11076,304111,51780,392160,335577,,,,,0,0,0,0
1650440533.7057974,public.usertable,304491,51813,409919488,16782,public,usertable,1,0,762780,1856525,335973,25136,31482,11087,304491,51813,392591,335973,,,,,0,0,0,0
1650440534.7366219,public.usertable,304864,51836,410378240,16782,public,usertable,1,0,763838,1857484,336365,25145,31501,11091,304864,51836,393011,336365,,,,,0,0,0,0
1650440535.765882,public.usertable,305214,51867,410861568,16782,public,usertable,1,0,764852,1858264,336736,25159,31522,11099,305214,51867,393417,336736,,,,,0,0,0,0
1650440536.7977676,public.usertable,305600,51889,411336704,16782,public,usertable,1,0,765809,1859131,337139,25171,31539,11105,305600,51889,393849,337139,,,,,0,0,0,0
1650440537.8263547,public.usertable,305939,51923,411770880,16782,public,usertable,1,0,766790,1859487,337498,25188,31559,11109,305939,51923,394245,337498,,,,,0,0,0,0
1650440538.85518,public.usertable,306271,51942,412155904,16782,public,usertable,1,0,767793,1861307,337844,25198,31573,11113,306271,51942,394615,337844,,,,,0,0,0,0
1650440539.8851106,public.usertable,306545,51970,412532736,16782,public,usertable,1,0,768547,1861687,338138,25208,31593,11117,306545,51970,394939,338138,,,,,0,0,0,0
1650440540.9156623,public.usertable,307019,52014,412950528,16782,public,usertable,1,0,769739,1862970,338638,25229,31619,11130,307019,52014,395486,338638,,,,,0,0,0,0
1650440541.9445379,public.usertable,307362,52039,413392896,16782,public,usertable,1,0,770603,1863949,338994,25244,31632,11140,307362,52039,395870,338994,,,,,0,0,0,0
1650440542.976201,public.usertable,307694,52059,413818880,16782,public,usertable,1,0,771439,1865778,339341,25258,31647,11145,307694,52059,396246,339341,,,,,0,0,0,0
1650440544.0058916,public.usertable,308023,52086,414236672,16782,public,usertable,1,0,772365,1867344,339693,25268,31670,11151,308023,52086,396631,339693,,,,,0,0,0,0
1650440545.0377624,public.usertable,308339,52122,414638080,16782,public,usertable,1,0,773248,1868285,340029,25287,31690,11163,308339,52122,397006,340029,,,,,0,0,0,0
1650440546.0657387,public.usertable,308654,52159,415080448,16782,public,usertable,1,0,774264,1870190,340368,25304,31714,11171,308654,52159,397386,340368,,,,,0,0,0,0
1650440547.0950937,public.usertable,309030,52184,415547392,16782,public,usertable,1,0,775316,1871343,340754,25322,31724,11182,309030,52184,397800,340754,,,,,0,0,0,0
1650440548.1258569,public.usertable,309368,52211,415997952,16782,public,usertable,1,0,776201,1873054,341108,25336,31740,11188,309368,52211,398184,341108,,,,,0,0,0,0
1650440549.15646,public.usertable,309733,52248,416464896,16782,public,usertable,1,0,777302,1874311,341495,25357,31762,11198,309733,52248,398614,341495,,,,,0,0,0,0
1650440550.1859558,public.usertable,310110,52288,416964608,16782,public,usertable,1,0,778398,1875025,341896,25377,31786,11210,310110,52288,399059,341896,,,,,0,0,0,0
1650440551.2197042,public.usertable,310517,52304,417464320,16782,public,usertable,1,0,779470,1877029,342319,25380,31802,11212,310517,52304,399501,342319,,,,,0,0,0,0
1650440552.2492335,public.usertable,310893,52332,417947648,16782,public,usertable,1,0,780394,1877785,342715,25389,31822,11216,310893,52332,399926,342715,,,,,0,0,0,0
1650440553.277598,public.usertable,311294,52364,418480128,16782,public,usertable,1,0,781477,1879774,343137,25406,31843,11226,311294,52364,400386,343137,,,,,0,0,0,0
1650440554.3057945,public.usertable,311717,52390,419012608,16782,public,usertable,1,0,782609,1880818,343578,25417,31861,11230,311717,52390,400856,343578,,,,,0,0,0,0
1650440555.3369968,public.usertable,312113,52415,419512320,16782,public,usertable,1,0,783789,1882640,343990,25432,31877,11240,312113,52415,401299,343990,,,,,0,0,0,0
1650440556.3655841,public.usertable,312497,52450,420003840,16782,public,usertable,1,0,784898,1882932,344393,25448,31896,11247,312497,52450,401737,344393,,,,,0,0,0,0
1650440557.39496,public.usertable,312869,52477,420487168,16782,public,usertable,1,0,786036,1883818,344787,25457,31918,11252,312869,52477,402162,344787,,,,,0,0,0,0
1650440558.4252863,public.usertable,313273,52496,420995072,16782,public,usertable,1,0,787113,1886070,345206,25468,31933,11259,313273,52496,402607,345206,,,,,0,0,0,0
1650440559.4557223,public.usertable,313886,52536,421543936,16782,public,usertable,1,0,788820,1888249,345853,25495,31967,11273,313886,52536,403315,345853,,,,,0,0,0,0
1650440560.4851105,public.usertable,314272,52579,422043648,16782,public,usertable,1,0,789855,1889409,346265,25513,31993,11283,314272,52579,403771,346265,,,,,0,0,0,0
1650440561.5147064,public.usertable,314661,52615,422551552,16782,public,usertable,1,0,790857,1890881,346677,25532,32016,11291,314661,52615,404225,346677,,,,,0,0,0,0
1650440562.5440323,public.usertable,315071,52634,423075840,16782,public,usertable,1,0,791856,1892452,347105,25541,32034,11295,315071,52634,404680,347105,,,,,0,0,0,0
1650440563.573299,public.usertable,315482,52649,423583744,16782,public,usertable,1,0,792897,1893523,347530,25551,32048,11300,315482,52649,405129,347530,,,,,0,0,0,0
1650440564.6027188,public.usertable,315858,52687,424067072,16782,public,usertable,1,0,793962,1894311,347933,25567,32075,11309,315858,52687,405575,347933,,,,,0,0,0,0
1650440565.63207,public.usertable,316228,52721,424558592,16782,public,usertable,1,0,794915,1895984,348322,25587,32094,11319,316228,52721,406003,348322,,,,,0,0,0,0
1650440566.6621873,public.usertable,316627,52754,425066496,16782,public,usertable,1,0,796034,1897556,348734,25609,32107,11327,316627,52754,406450,348734,,,,,0,0,0,0
1650440567.689836,public.usertable,317010,52784,425558016,16782,public,usertable,1,0,797149,1898221,349143,25621,32133,11335,317010,52784,406897,349143,,,,,0,0,0,0
1650440568.720313,public.usertable,317381,52817,426049536,16782,public,usertable,1,0,798155,1899696,349533,25638,32152,11348,317381,52817,407323,349533,,,,,0,0,0,0
1650440569.7491207,public.usertable,317787,52854,426524672,16782,public,usertable,1,0,799322,1901006,349958,25659,32171,11361,317787,52854,407788,349958,,,,,0,0,0,0
1650440570.780862,public.usertable,318141,52885,427016192,16782,public,usertable,1,0,800157,1902132,350333,25672,32192,11366,318141,52885,408197,350333,,,,,0,0,0,0
1650440571.8124933,public.usertable,318523,52922,427524096,16782,public,usertable,1,0,801281,1902613,350735,25689,32212,11377,318523,52922,408636,350735,,,,,0,0,0,0
1650440572.843468,public.usertable,318918,52956,428015616,16782,public,usertable,1,0,802414,1904013,351146,25710,32228,11390,318918,52956,409084,351146,,,,,0,0,0,0
1650440573.873907,public.usertable,319311,52981,428515328,16782,public,usertable,1,0,803496,1904910,351553,25727,32242,11398,319311,52981,409522,351553,,,,,0,0,0,0
1650440574.901781,public.usertable,319665,53017,428908544,16782,public,usertable,1,0,804511,1905538,351927,25744,32262,11409,319665,53017,409933,351927,,,,,0,0,0,0
1650440575.932625,public.usertable,319975,53033,429350912,16782,public,usertable,1,0,805363,1907736,352253,25756,32278,11415,319975,53033,410287,352253,,,,,0,0,0,0
1650440576.9631279,public.usertable,320338,53069,429817856,16782,public,usertable,1,0,806313,1908388,352634,25774,32296,11429,320338,53069,410704,352634,,,,,0,0,0,0
1650440577.9947147,public.usertable,320697,53105,430309376,16782,public,usertable,1,0,807352,1909348,353014,25793,32317,11437,320697,53105,411124,353014,,,,,0,0,0,0
1650440579.0233712,public.usertable,321225,53159,430743552,16782,public,usertable,1,0,808874,1910813,353577,25818,32352,11447,321225,53159,411747,353577,,,,,0,0,0,0
1650440580.052378,public.usertable,321572,53191,431202304,16782,public,usertable,1,0,810001,1911493,353946,25830,32374,11455,321572,53191,412150,353946,,,,,0,0,0,0
1650440581.0816734,public.usertable,321937,53219,431669248,16782,public,usertable,1,0,811003,1912474,354330,25842,32393,11460,321937,53219,412565,354330,,,,,0,0,0,0
1650440582.1113222,public.usertable,322265,53255,432103424,16782,public,usertable,1,0,811934,1913309,354677,25859,32412,11472,322265,53255,412948,354677,,,,,0,0,0,0
1650440583.143583,public.usertable,322649,53271,432570368,16782,public,usertable,1,0,812985,1914118,355068,25874,32419,11482,322649,53271,413361,355068,,,,,0,0,0,0
1650440584.174959,public.usertable,322996,53308,433020928,16782,public,usertable,1,0,814026,1915666,355440,25890,32444,11493,322996,53308,413774,355440,,,,,0,0,0,0
1650440585.2050903,public.usertable,323349,53332,433463296,16782,public,usertable,1,0,815044,1916330,355806,25907,32457,11503,323349,53332,414170,355806,,,,,0,0,0,0
1650440586.2365599,public.usertable,323724,53348,433963008,16782,public,usertable,1,0,816085,1917085,356190,25915,32466,11509,323724,53348,414571,356190,,,,,0,0,0,0
1650440587.2680624,public.usertable,324131,53373,434470912,16782,public,usertable,1,0,817192,1917853,356611,25929,32480,11515,324131,53373,415020,356611,,,,,0,0,0,0
1650440588.296713,public.usertable,324493,53401,434937856,16782,public,usertable,1,0,818208,1918754,356988,25949,32495,11525,324493,53401,415432,356988,,,,,0,0,0,0
1650440589.3245518,public.usertable,324852,53432,435380224,16782,public,usertable,1,0,819180,1919883,357364,25967,32512,11538,324852,53432,415843,357364,,,,,0,0,0,0
1650440590.355582,public.usertable,325188,53454,435830784,16782,public,usertable,1,0,820100,1920721,357713,25985,32525,11547,325188,53454,416223,357713,,,,,0,0,0,0
1650440591.3847542,public.usertable,325584,53492,436338688,16782,public,usertable,1,0,821143,1922123,358129,26003,32545,11557,325584,53492,416677,358129,,,,,0,0,0,0
1650440592.4146533,public.usertable,325949,53519,436789248,16782,public,usertable,1,0,822268,1923060,358515,26018,32566,11561,325949,53519,417099,358515,,,,,0,0,0,0
1650440593.4470153,public.usertable,326282,53540,437256192,16782,public,usertable,1,0,823266,1924343,358872,26030,32590,11565,326282,53540,417492,358872,,,,,0,0,0,0
1650440594.47559,public.usertable,326651,53576,437714944,16782,public,usertable,1,0,824216,1925069,359257,26051,32606,11574,326651,53576,417914,359257,,,,,0,0,0,0
1650440595.50533,public.usertable,327015,53607,438206464,16782,public,usertable,1,0,825209,1925307,359637,26066,32622,11581,327015,53607,418325,359637,,,,,0,0,0,0
1650440596.534375,public.usertable,327396,53633,438673408,16782,public,usertable,1,0,826286,1925796,360030,26081,32634,11586,327396,53633,418745,360030,,,,,0,0,0,0
1650440597.5646148,public.usertable,327919,53671,439115776,16782,public,usertable,1,0,827748,1927728,360576,26108,32657,11599,327919,53671,419341,360576,,,,,0,0,0,0
1650440598.5980322,public.usertable,328270,53687,439566336,16782,public,usertable,1,0,828776,1928269,360947,26115,32677,11603,328270,53687,419739,360947,,,,,0,0,0,0
1650440599.6281083,public.usertable,328652,53717,440066048,16782,public,usertable,1,0,829874,1929296,361345,26131,32693,11611,328652,53717,420169,361345,,,,,0,0,0,0
1650440600.6578786,public.usertable,328997,53742,440508416,16782,public,usertable,1,0,830874,1929752,361713,26143,32716,11616,328997,53742,420572,361713,,,,,0,0,0,0
1650440601.6879609,public.usertable,329365,53779,440991744,16782,public,usertable,1,0,831956,1930763,362106,26157,32741,11622,329365,53779,421004,362106,,,,,0,0,0,0
1650440602.7211635,public.usertable,329775,53800,441507840,16782,public,usertable,1,0,832994,1931148,362531,26167,32756,11626,329775,53800,421454,362531,,,,,0,0,0,0
1650440603.7506251,public.usertable,330169,53841,442023936,16782,public,usertable,1,0,834076,1931865,362947,26189,32778,11637,330169,53841,421914,362947,,,,,0,0,0,0
1650440604.780261,public.usertable,330557,53868,442531840,16782,public,usertable,1,0,835146,1933719,363357,26201,32800,11644,330557,53868,422358,363357,,,,,0,0,0,0
1650440605.8113644,public.usertable,330951,53894,443039744,16782,public,usertable,1,0,836186,1934973,363769,26215,32818,11650,330951,53894,422802,363769,,,,,0,0,0,0
1650440606.8406181,public.usertable,331357,53921,443547648,16782,public,usertable,1,0,837261,1935747,364185,26235,32828,11658,331357,53921,423248,364185,,,,,0,0,0,0
1650440607.8701003,public.usertable,331757,53948,444039168,16782,public,usertable,1,0,838375,1936672,364603,26248,32846,11668,331757,53948,423697,364603,,,,,0,0,0,0
1650440608.8989832,public.usertable,332130,53975,444522496,16782,public,usertable,1,0,839465,1939296,364996,26267,32866,11675,332130,53975,424129,364996,,,,,0,0,0,0
1650440609.9277823,public.usertable,332489,54010,445005824,16782,public,usertable,1,0,840564,1940101,365380,26281,32891,11684,332489,54010,424552,365380,,,,,0,0,0,0
1650440610.958712,public.usertable,332886,54030,445513728,16782,public,usertable,1,0,841531,1941761,365789,26299,32903,11693,332886,54030,424991,365789,,,,,0,0,0,0
1650440611.9874575,public.usertable,333276,54066,445972480,16782,public,usertable,1,0,842607,1942800,366199,26316,32923,11701,333276,54066,425438,366199,,,,,0,0,0,0
1650440613.0173588,public.usertable,333585,54089,446357504,16782,public,usertable,1,0,843359,1943119,366520,26328,32935,11706,333585,54089,425783,366520,,,,,0,0,0,0
1650440614.0495453,public.usertable,333899,54119,446799872,16782,public,usertable,1,0,844280,1943431,366850,26342,32951,11717,333899,54119,426143,366850,,,,,0,0,0,0
1650440615.0787294,public.usertable,334255,54139,447242240,16782,public,usertable,1,0,845233,1944198,367221,26353,32966,11720,334255,54139,426540,367221,,,,,0,0,0,0
1650440616.110004,public.usertable,334804,54171,447700992,16782,public,usertable,1,0,846673,1945473,367788,26367,32984,11729,334804,54171,427139,367788,,,,,0,0,0,0
1650440617.1427236,public.usertable,335128,54189,448110592,16782,public,usertable,1,0,847666,1946514,368130,26378,33002,11735,335128,54189,427510,368130,,,,,0,0,0,0
1650440618.1741068,public.usertable,335463,54218,448552960,16782,public,usertable,1,0,848625,1947754,368481,26397,33018,11746,335463,54218,427896,368481,,,,,0,0,0,0
1650440619.20267,public.usertable,335814,54246,449019904,16782,public,usertable,1,0,849579,1948276,368852,26407,33038,11754,335814,54246,428297,368852,,,,,0,0,0,0
1650440620.2320359,public.usertable,336203,54265,449495040,16782,public,usertable,1,0,850602,1948861,369253,26414,33050,11759,336203,54265,428717,369253,,,,,0,0,0,0
1650440621.2617185,public.usertable,336562,54293,449953792,16782,public,usertable,1,0,851619,1949682,369632,26425,33070,11765,336562,54293,429127,369632,,,,,0,0,0,0
1650440622.2911925,public.usertable,336923,54317,450404352,16782,public,usertable,1,0,852578,1951817,370010,26434,33087,11771,336923,54317,429531,370010,,,,,0,0,0,0
1650440623.3210373,public.usertable,337279,54349,450854912,16782,public,usertable,1,0,853541,1952848,370390,26444,33111,11777,337279,54349,429945,370390,,,,,0,0,0,0
1650440624.350913,public.usertable,337629,54374,451313664,16782,public,usertable,1,0,854539,1953698,370763,26454,33134,11781,337629,54374,430351,370763,,,,,0,0,0,0
1650440625.3810604,public.usertable,337970,54397,451764224,16782,public,usertable,1,0,855448,1955015,371119,26465,33149,11785,337970,54397,430733,371119,,,,,0,0,0,0
1650440626.4175804,public.usertable,338318,54424,452198400,16782,public,usertable,1,0,856384,1955868,371481,26481,33163,11798,338318,54424,431125,371481,,,,,0,0,0,0
1650440627.4465327,public.usertable,338620,54448,452558848,16782,public,usertable,1,0,857263,1956205,371794,26494,33174,11806,338620,54448,431462,371794,,,,,0,0,0,0
1650440628.47423,public.usertable,338926,54469,452976640,16782,public,usertable,1,0,858047,1956567,372110,26505,33184,11808,338926,54469,431799,372110,,,,,0,0,0,0
1650440629.5050464,public.usertable,339281,54490,453369856,16782,public,usertable,1,0,859063,1957913,372478,26520,33197,11816,339281,54490,432195,372478,,,,,0,0,0,0
1650440630.5357563,public.usertable,339532,54503,453705728,16782,public,usertable,1,0,859733,1959088,372738,26529,33206,11822,339532,54503,432473,372738,,,,,0,0,0,0
1650440631.5647273,public.usertable,339778,54527,454066176,16782,public,usertable,1,0,860411,1959867,373003,26536,33225,11826,339778,54527,432764,373003,,,,,0,0,0,0
1650440632.593558,public.usertable,340124,54548,454508544,16782,public,usertable,1,0,861279,1960753,373364,26547,33240,11832,340124,54548,433151,373364,,,,,0,0,0,0
1650440633.6225433,public.usertable,340472,54574,454942720,16782,public,usertable,1,0,862198,1961623,373725,26560,33253,11840,340472,54574,433538,373725,,,,,0,0,0,0
1650440634.6538274,public.usertable,340809,54599,455360512,16782,public,usertable,1,0,863345,1962891,374081,26571,33272,11845,340809,54599,433924,374081,,,,,0,0,0,0
1650440635.6831796,public.usertable,341330,54646,455827456,16782,public,usertable,1,0,864741,1963425,374630,26594,33300,11856,341330,54646,434524,374630,,,,,0,0,0,0
1650440636.713554,public.usertable,341668,54675,456269824,16782,public,usertable,1,0,865661,1963875,374986,26607,33318,11860,341668,54675,434911,374986,,,,,0,0,0,0
1650440637.7424784,public.usertable,341985,54709,456687616,16782,public,usertable,1,0,866681,1965589,375325,26622,33340,11868,341985,54709,435287,375325,,,,,0,0,0,0
1650440638.7714326,public.usertable,342337,54738,457146368,16782,public,usertable,1,0,867763,1966382,375695,26638,33358,11874,342337,54738,435691,375695,,,,,0,0,0,0
1650440639.801557,public.usertable,342631,54764,457506816,16782,public,usertable,1,0,868657,1967586,376012,26645,33381,11878,342631,54764,436038,376012,,,,,0,0,0,0
1650440640.8326602,public.usertable,342890,54781,457859072,16782,public,usertable,1,0,869417,1968699,376285,26652,33395,11880,342890,54781,436332,376285,,,,,0,0,0,0
1650440641.8635457,public.usertable,343226,54788,458293248,16782,public,usertable,1,0,870358,1969870,376630,26661,33404,11885,343226,54788,436695,376630,,,,,0,0,0,0
1650440642.8955932,public.usertable,343554,54808,458686464,16782,public,usertable,1,0,871311,1971342,376969,26674,33415,11892,343554,54808,437058,376969,,,,,0,0,0,0
1650440643.9264493,public.usertable,343849,54837,459071488,16782,public,usertable,1,0,872199,1972142,377279,26689,33430,11898,343849,54837,437398,377279,,,,,0,0,0,0
1650440644.956367,public.usertable,344175,54866,459481088,16782,public,usertable,1,0,873070,1972797,377620,26705,33445,11909,344175,54866,437770,377620,,,,,0,0,0,0
1650440645.9869912,public.usertable,344521,54884,459939840,16782,public,usertable,1,0,874092,1974036,377980,26714,33459,11916,344521,54884,438153,377980,,,,,0,0,0,0
1650440647.019325,public.usertable,344900,54899,460439552,16782,public,usertable,1,0,875099,1975045,378372,26724,33472,11918,344900,54899,438568,378372,,,,,0,0,0,0
1650440648.04884,public.usertable,345289,54921,460914688,16782,public,usertable,1,0,876067,1975664,378775,26736,33486,11922,345289,54921,438997,378775,,,,,0,0,0,0
1650440649.083571,public.usertable,345662,54950,461414400,16782,public,usertable,1,0,877184,1976080,379165,26749,33503,11925,345662,54950,439417,379165,,,,,0,0,0,0
1650440650.112789,public.usertable,346049,54979,461873152,16782,public,usertable,1,0,878214,1976954,379569,26768,33520,11939,346049,54979,439857,379569,,,,,0,0,0,0
1650440651.143919,public.usertable,346396,54999,462348288,16782,public,usertable,1,0,879283,1978109,379935,26777,33539,11945,346396,54999,440251,379935,,,,,0,0,0,0
1650440652.1749113,public.usertable,346752,55025,462798848,16782,public,usertable,1,0,880343,1978582,380316,26785,33564,11952,346752,55025,440665,380316,,,,,0,0,0,0
1650440653.2031145,public.usertable,347090,55056,463257600,16782,public,usertable,1,0,881341,1978982,380680,26795,33590,11955,347090,55056,441065,380680,,,,,0,0,0,0
1650440654.2320967,public.usertable,347628,55092,463699968,16782,public,usertable,1,0,882890,1981394,381244,26813,33616,11966,347628,55092,441673,381244,,,,,0,0,0,0
1650440655.2624304,public.usertable,347992,55115,464166912,16782,public,usertable,1,0,883931,1982509,381625,26823,33633,11969,347992,55115,442081,381625,,,,,0,0,0,0
1650440656.2927926,public.usertable,348362,55149,464650240,16782,public,usertable,1,0,885043,1983298,382014,26840,33652,11976,348362,55149,442506,382014,,,,,0,0,0,0
1650440657.32177,public.usertable,348744,55179,465133568,16782,public,usertable,1,0,886191,1983651,382408,26861,33664,11985,348744,55179,442933,382408,,,,,0,0,0,0
1650440658.3537226,public.usertable,349122,55203,465633280,16782,public,usertable,1,0,887180,1985372,382807,26872,33685,11989,349122,55203,443364,382807,,,,,0,0,0,0
1650440659.3827016,public.usertable,349522,55236,466132992,16782,public,usertable,1,0,888208,1986010,383230,26885,33708,11996,349522,55236,443823,383230,,,,,0,0,0,0
1650440660.4116902,public.usertable,349933,55260,466665472,16782,public,usertable,1,0,889318,1986621,383658,26895,33725,12002,349933,55260,444278,383658,,,,,0,0,0,0
1650440661.441764,public.usertable,350344,55285,467189760,16782,public,usertable,1,0,890416,1987537,384089,26909,33745,12011,350344,55285,444743,384089,,,,,0,0,0,0
1650440662.4740357,public.usertable,350734,55311,467673088,16782,public,usertable,1,0,891392,1988200,384497,26917,33763,12016,350734,55311,445177,384497,,,,,0,0,0,0
1650440663.5035167,public.usertable,351162,55337,468213760,16782,public,usertable,1,0,892592,1988700,384943,26927,33781,12020,351162,55337,445651,384943,,,,,0,0,0,0
1650440664.5338225,public.usertable,351555,55369,468688896,16782,public,usertable,1,0,893644,1989598,385354,26941,33799,12025,351555,55369,446094,385354,,,,,0,0,0,0
1650440665.5639,public.usertable,351879,55387,469098496,16782,public,usertable,1,0,894581,1990493,385698,26948,33819,12029,351879,55387,446465,385698,,,,,0,0,0,0
1650440666.595136,public.usertable,352224,55419,469540864,16782,public,usertable,1,0,895592,1990957,386058,26965,33834,12041,352224,55419,446857,386058,,,,,0,0,0,0
1650440667.6253483,public.usertable,352544,55433,469966848,16782,public,usertable,1,0,896531,1991710,386395,26973,33851,12047,352544,55433,447219,386395,,,,,0,0,0,0
1650440668.6559768,public.usertable,352872,55451,470392832,16782,public,usertable,1,0,897397,1992375,386736,26982,33864,12053,352872,55451,447582,386736,,,,,0,0,0,0
1650440669.6892102,public.usertable,353233,55470,470810624,16782,public,usertable,1,0,898372,1992757,387105,26994,33872,12061,353233,55470,447971,387105,,,,,0,0,0,0
1650440670.7183163,public.usertable,353535,55498,471244800,16782,public,usertable,1,0,899256,1993173,387426,27003,33891,12065,353535,55498,448320,387426,,,,,0,0,0,0
1650440671.7467823,public.usertable,353912,55527,471719936,16782,public,usertable,1,0,900262,1994413,387823,27017,33911,12073,353912,55527,448751,387823,,,,,0,0,0,0
1650440672.7791724,public.usertable,354282,55551,472211456,16782,public,usertable,1,0,901200,1994784,388209,27028,33927,12081,354282,55551,449164,388209,,,,,0,0,0,0
1650440673.8096275,public.usertable,354837,55593,472670208,16782,public,usertable,1,0,902799,1996895,388792,27053,33955,12095,354837,55593,449800,388792,,,,,0,0,0,0
1650440674.8397155,public.usertable,355246,55612,473186304,16782,public,usertable,1,0,903797,1997875,389213,27066,33967,12102,355246,55612,450246,389213,,,,,0,0,0,0
1650440675.8707788,public.usertable,355645,55640,473694208,16782,public,usertable,1,0,904900,1998126,389627,27081,33982,12111,355645,55640,450690,389627,,,,,0,0,0,0
1650440676.9011145,public.usertable,356015,55672,474169344,16782,public,usertable,1,0,906014,1999997,390017,27097,34002,12117,356015,55672,451116,390017,,,,,0,0,0,0
1650440677.9298348,public.usertable,356385,55705,474644480,16782,public,usertable,1,0,907171,2000397,390403,27114,34018,12129,356385,55705,451535,390403,,,,,0,0,0,0
1650440678.9619317,public.usertable,356770,55729,475127808,16782,public,usertable,1,0,908133,2000943,390802,27124,34032,12132,356770,55729,451958,390802,,,,,0,0,0,0
1650440679.991569,public.usertable,357173,55750,475643904,16782,public,usertable,1,0,909209,2001988,391222,27132,34049,12135,357173,55750,452403,391222,,,,,0,0,0,0
1650440681.0231254,public.usertable,357546,55782,476110848,16782,public,usertable,1,0,910265,2002848,391613,27147,34067,12142,357546,55782,452827,391613,,,,,0,0,0,0
1650440682.0538046,public.usertable,357916,55806,476594176,16782,public,usertable,1,0,911305,2003287,392000,27159,34084,12147,357916,55806,453243,392000,,,,,0,0,0,0
1650440683.0826006,public.usertable,358297,55836,477102080,16782,public,usertable,1,0,912502,2004909,392406,27174,34109,12157,358297,55836,453689,392406,,,,,0,0,0,0
1650440684.1116078,public.usertable,358707,55850,477618176,16782,public,usertable,1,0,913645,2005941,392825,27188,34118,12165,358707,55850,454131,392825,,,,,0,0,0,0
1650440685.1434925,public.usertable,359099,55887,478117888,16782,public,usertable,1,0,914751,2007619,393238,27206,34139,12174,359099,55887,454583,393238,,,,,0,0,0,0
1650440686.1731935,public.usertable,359474,55915,478593024,16782,public,usertable,1,0,915855,2008317,393636,27219,34162,12182,359474,55915,455017,393636,,,,,0,0,0,0
1650440687.202824,public.usertable,359851,55946,479084544,16782,public,usertable,1,0,917037,2009348,394029,27234,34178,12191,359851,55946,455441,394029,,,,,0,0,0,0
1650440688.233786,public.usertable,360230,55971,479567872,16782,public,usertable,1,0,918141,2010867,394425,27248,34195,12199,360230,55971,455868,394425,,,,,0,0,0,0
1650440689.264014,public.usertable,360616,56006,480075776,16782,public,usertable,1,0,919358,2012157,394831,27263,34215,12206,360616,56006,456309,394831,,,,,0,0,0,0
1650440690.2936296,public.usertable,361009,56030,480518144,16782,public,usertable,1,0,920496,2013589,395243,27279,34234,12216,361009,56030,456756,395243,,,,,0,0,0,0
1650440691.3259845,public.usertable,361468,56063,480903168,16782,public,usertable,1,0,921786,2014832,395726,27289,34258,12222,361468,56063,457273,395726,,,,,0,0,0,0
1650440692.3538113,public.usertable,361783,56078,481288192,16782,public,usertable,1,0,922611,2015079,396047,27300,34264,12230,361783,56078,457611,396047,,,,,0,0,0,0
1650440693.385365,public.usertable,362036,56104,481624064,16782,public,usertable,1,0,923262,2015272,396315,27311,34279,12237,362036,56104,457905,396315,,,,,0,0,0,0
1650440694.4162195,public.usertable,362339,56129,482017280,16782,public,usertable,1,0,924079,2015401,396636,27318,34297,12242,362339,56129,458251,396636,,,,,0,0,0,0
1650440695.4500637,public.usertable,362667,56150,482435072,16782,public,usertable,1,0,925022,2016029,396975,27328,34308,12248,362667,56150,458611,396975,,,,,0,0,0,0
1650440696.4818077,public.usertable,363021,56170,482893824,16782,public,usertable,1,0,926015,2016986,397344,27340,34323,12253,363021,56170,459007,397344,,,,,0,0,0,0
1650440697.5099497,public.usertable,363422,56199,483401728,16782,public,usertable,1,0,927059,2017135,397763,27355,34341,12260,363422,56199,459459,397763,,,,,0,0,0,0
1650440698.538502,public.usertable,363812,56221,483893248,16782,public,usertable,1,0,928220,2018431,398170,27368,34358,12265,363812,56221,459896,398170,,,,,0,0,0,0
1650440699.5693784,public.usertable,364212,56241,484401152,16782,public,usertable,1,0,929274,2019497,398583,27378,34371,12270,364212,56241,460332,398583,,,,,0,0,0,0
1650440700.5997376,public.usertable,364612,56267,484909056,16782,public,usertable,1,0,930447,2020583,398997,27397,34385,12283,364612,56267,460779,398997,,,,,0,0,0,0
1650440701.6288302,public.usertable,365001,56299,485416960,16782,public,usertable,1,0,931495,2021139,399408,27407,34407,12288,365001,56299,461222,399408,,,,,0,0,0,0
1650440702.65904,public.usertable,365375,56321,485859328,16782,public,usertable,1,0,932539,2021730,399796,27415,34421,12291,365375,56321,461632,399796,,,,,0,0,0,0
1650440703.6921005,public.usertable,365684,56343,486244352,16782,public,usertable,1,0,933349,2022238,400113,27433,34429,12302,365684,56343,461975,400113,,,,,0,0,0,0
1650440704.722238,public.usertable,366008,56372,486670336,16782,public,usertable,1,0,934322,2022486,400457,27443,34449,12310,366008,56372,462349,400457,,,,,0,0,0,0
1650440705.7512813,public.usertable,366357,56405,487137280,16782,public,usertable,1,0,935437,2022781,400827,27457,34470,12317,366357,56405,462754,400827,,,,,0,0,0,0
1650440706.7807364,public.usertable,366732,56421,487596032,16782,public,usertable,1,0,936408,2024499,401209,27470,34477,12320,366732,56421,463156,401209,,,,,0,0,0,0
1650440707.8097386,public.usertable,367099,56439,488079360,16782,public,usertable,1,0,937378,2024928,401594,27477,34495,12323,367099,56439,463566,401594,,,,,0,0,0,0
1650440708.839866,public.usertable,367466,56464,488538112,16782,public,usertable,1,0,938375,2025908,401976,27491,34510,12329,367466,56464,463977,401976,,,,,0,0,0,0
1650440709.871501,public.usertable,368021,56497,489021440,16782,public,usertable,1,0,940024,2027291,402561,27504,34540,12337,368021,56497,464605,402561,,,,,0,0,0,0
1650440710.901553,public.usertable,368430,56519,489545728,16782,public,usertable,1,0,941084,2028231,402986,27515,34556,12343,368430,56519,465057,402986,,,,,0,0,0,0
1650440711.9316127,public.usertable,368830,56541,490045440,16782,public,usertable,1,0,942028,2029434,403404,27521,34574,12345,368830,56541,465499,403404,,,,,0,0,0,0
1650440712.963833,public.usertable,369206,56573,490520576,16782,public,usertable,1,0,943119,2030046,403799,27534,34593,12352,369206,56573,465926,403799,,,,,0,0,0,0
1650440713.993536,public.usertable,369577,56588,490987520,16782,public,usertable,1,0,944171,2031289,404180,27548,34603,12360,369577,56588,466331,404180,,,,,0,0,0,0
1650440715.0231562,public.usertable,369936,56613,491454464,16782,public,usertable,1,0,945242,2031740,404559,27558,34623,12363,369936,56613,466740,404559,,,,,0,0,0,0
1650440716.054459,public.usertable,370300,56641,491929600,16782,public,usertable,1,0,946366,2032785,404938,27575,34638,12373,370300,56641,467151,404938,,,,,0,0,0,0
1650440717.0847502,public.usertable,370690,56670,492412928,16782,public,usertable,1,0,947514,2033565,405345,27587,34655,12379,370690,56670,467587,405345,,,,,0,0,0,0
1650440718.1131682,public.usertable,371071,56691,492904448,16782,public,usertable,1,0,948620,2034349,405738,27599,34667,12389,371071,56691,468004,405738,,,,,0,0,0,0
1650440719.1430912,public.usertable,371476,56715,493412352,16782,public,usertable,1,0,949770,2035529,406162,27609,34686,12397,371476,56715,468457,406162,,,,,0,0,0,0
1650440720.1717765,public.usertable,371882,56729,493928448,16782,public,usertable,1,0,950899,2036585,406581,27617,34699,12402,371882,56729,468897,406581,,,,,0,0,0,0
1650440721.2012596,public.usertable,372273,56738,494411776,16782,public,usertable,1,0,951980,2037962,406987,27630,34714,12411,372273,56738,469331,406987,,,,,0,0,0,0
1650440722.2329137,public.usertable,372663,56762,494903296,16782,public,usertable,1,0,953047,2038192,407393,27638,34730,12412,372663,56762,469761,407393,,,,,0,0,0,0
1650440723.2631974,public.usertable,373041,56800,495362048,16782,public,usertable,1,0,954067,2038722,407788,27659,34747,12425,373041,56800,470194,407788,,,,,0,0,0,0
1650440724.2981448,public.usertable,373407,56828,495878144,16782,public,usertable,1,0,955091,2039739,408169,27673,34762,12434,373407,56828,470604,408169,,,,,0,0,0,0
1650440725.3266368,public.usertable,373830,56855,496443392,16782,public,usertable,1,0,956229,2040388,408612,27686,34782,12438,373830,56855,471080,408612,,,,,0,0,0,0
1650440726.355343,public.usertable,374275,56887,496984064,16782,public,usertable,1,0,957440,2041016,409077,27700,34802,12445,374275,56887,471579,409077,,,,,0,0,0,0
1650440727.3857405,public.usertable,374692,56914,497508352,16782,public,usertable,1,0,958683,2041759,409511,27711,34819,12454,374692,56914,472041,409511,,,,,0,0,0,0
1650440728.414414,public.usertable,375283,56962,498008064,16782,public,usertable,1,0,960393,2043845,410134,27734,34851,12468,375283,56962,472719,410134,,,,,0,0,0,0
1650440729.4432566,public.usertable,375713,56978,498540544,16782,public,usertable,1,0,961389,2045034,410576,27747,34863,12480,375713,56978,473186,410576,,,,,0,0,0,0
1650440730.471855,public.usertable,376138,57008,499073024,16782,public,usertable,1,0,962559,2045544,411017,27761,34879,12487,376138,57008,473657,411017,,,,,0,0,0,0
1650440731.5010128,public.usertable,376576,57026,499621888,16782,public,usertable,1,0,963794,2046768,411467,27774,34891,12493,376576,57026,474132,411467,,,,,0,0,0,0
1650440732.5318136,public.usertable,377003,57058,500187136,16782,public,usertable,1,0,965088,2047627,411915,27786,34912,12498,377003,57058,474613,411915,,,,,0,0,0,0
1650440733.5628853,public.usertable,377403,57079,500686848,16782,public,usertable,1,0,966149,2047861,412324,27798,34921,12505,377403,57079,475043,412324,,,,,0,0,0,0
1650440734.5925932,public.usertable,377840,57095,501227520,16782,public,usertable,1,0,967272,2048352,412775,27807,34935,12508,377840,57095,475517,412775,,,,,0,0,0,0
1650440735.621941,public.usertable,378267,57119,501760000,16782,public,usertable,1,0,968399,2049065,413211,27825,34944,12514,378267,57119,475980,413211,,,,,0,0,0,0
1650440736.6511385,public.usertable,378672,57136,502276096,16782,public,usertable,1,0,969480,2049418,413633,27830,34961,12517,378672,57136,476424,413633,,,,,0,0,0,0
1650440737.680709,public.usertable,379055,57162,502775808,16782,public,usertable,1,0,970647,2049623,414034,27843,34979,12521,379055,57162,476856,414034,,,,,0,0,0,0
1650440738.7108,public.usertable,379450,57198,503283712,16782,public,usertable,1,0,971748,2050401,414447,27861,34997,12528,379450,57198,477305,414447,,,,,0,0,0,0
1650440739.740447,public.usertable,379844,57231,503791616,16782,public,usertable,1,0,972828,2050960,414860,27875,35016,12537,379844,57231,477751,414860,,,,,0,0,0,0
1650440740.7688375,public.usertable,380239,57263,504299520,16782,public,usertable,1,0,974147,2051645,415277,27887,35038,12544,380239,57263,478202,415277,,,,,0,0,0,0
1650440741.7993689,public.usertable,380644,57299,504832000,16782,public,usertable,1,0,975305,2052057,415706,27903,35062,12555,380644,57299,478671,415706,,,,,0,0,0,0
1650440742.8286078,public.usertable,381067,57326,505372672,16782,public,usertable,1,0,976394,2052799,416146,27913,35079,12558,381067,57326,479138,416146,,,,,0,0,0,0
1650440743.8609018,public.usertable,381484,57353,505888768,16782,public,usertable,1,0,977559,2054319,416577,27926,35093,12562,381484,57353,479596,416577,,,,,0,0,0,0
1650440744.8949075,public.usertable,381887,57374,506380288,16782,public,usertable,1,0,978733,2055780,416994,27937,35107,12567,381887,57374,480038,416994,,,,,0,0,0,0
1650440745.92479,public.usertable,382469,57403,506871808,16782,public,usertable,1,0,980302,2056598,417599,27949,35130,12575,382469,57403,480678,417599,,,,,0,0,0,0
1650440746.9525535,public.usertable,382890,57421,507404288,16782,public,usertable,1,0,981408,2058608,418031,27958,35141,12578,382890,57421,481130,418031,,,,,0,0,0,0
1650440747.9827092,public.usertable,383308,57447,507928576,16782,public,usertable,1,0,982471,2059130,418462,27973,35154,12582,383308,57447,481589,418462,,,,,0,0,0,0
1650440749.0147297,public.usertable,383701,57477,508436480,16782,public,usertable,1,0,983658,2060722,418868,27996,35167,12594,383701,57477,482031,418868,,,,,0,0,0,0
1650440750.0460262,public.usertable,384106,57492,508936192,16782,public,usertable,1,0,984775,2061608,419285,28005,35179,12596,384106,57492,482469,419285,,,,,0,0,0,0
1650440751.0753195,public.usertable,384494,57511,509419520,16782,public,usertable,1,0,985880,2063235,419687,28018,35193,12604,384494,57511,482898,419687,,,,,0,0,0,0
1650440752.1053429,public.usertable,384872,57527,509902848,16782,public,usertable,1,0,986950,2063553,420073,28026,35201,12610,384872,57527,483300,420073,,,,,0,0,0,0
1650440753.1344473,public.usertable,385229,57553,510345216,16782,public,usertable,1,0,987975,2064083,420445,28041,35216,12621,385229,57553,483702,420445,,,,,0,0,0,0
1650440754.16272,public.usertable,385572,57573,510795776,16782,public,usertable,1,0,988917,2064720,420801,28051,35229,12625,385572,57573,484081,420801,,,,,0,0,0,0
1650440755.1908462,public.usertable,385958,57588,511270912,16782,public,usertable,1,0,989945,2065578,421199,28062,35241,12632,385958,57588,484502,421199,,,,,0,0,0,0
1650440756.2200234,public.usertable,386344,57612,511754240,16782,public,usertable,1,0,990958,2066058,421606,28072,35262,12639,386344,57612,484940,421606,,,,,0,0,0,0
1650440757.2503295,public.usertable,386752,57631,512294912,16782,public,usertable,1,0,992101,2067677,422033,28081,35281,12646,386752,57631,485395,422033,,,,,0,0,0,0
1650440758.2806735,public.usertable,387172,57654,512827392,16782,public,usertable,1,0,993203,2068435,422467,28096,35295,12653,387172,57654,485858,422467,,,,,0,0,0,0
1650440759.310977,public.usertable,387568,57683,513318912,16782,public,usertable,1,0,994322,2068875,422881,28111,35313,12661,387568,57683,486305,422881,,,,,0,0,0,0
1650440760.344183,public.usertable,387982,57717,513843200,16782,public,usertable,1,0,995385,2069677,423314,28126,35332,12668,387982,57717,486772,423314,,,,,0,0,0,0
1650440761.3726141,public.usertable,388372,57748,514351104,16782,public,usertable,1,0,996541,2070573,423723,28139,35351,12674,388372,57748,487213,423723,,,,,0,0,0,0
1650440762.4004827,public.usertable,388745,57772,514809856,16782,public,usertable,1,0,997551,2071259,424111,28150,35366,12679,388745,57772,487627,424111,,,,,0,0,0,0
1650440763.4322398,public.usertable,389101,57795,515293184,16782,public,usertable,1,0,998605,2072387,424486,28157,35385,12681,389101,57795,488028,424486,,,,,0,0,0,0
1650440764.4621334,public.usertable,389724,57830,515817472,16782,public,usertable,1,0,1000380,2074306,425130,28177,35406,12696,389724,57830,488713,425130,,,,,0,0,0,0
1650440765.491532,public.usertable,390135,57856,516341760,16782,public,usertable,1,0,1001530,2075210,425563,28183,35428,12701,390135,57856,489174,425563,,,,,0,0,0,0
1650440766.520889,public.usertable,390570,57882,516890624,16782,public,usertable,1,0,1002791,2075727,426012,28195,35442,12707,390570,57882,489649,426012,,,,,0,0,0,0
1650440767.5518544,public.usertable,390985,57906,517406720,16782,public,usertable,1,0,1003965,2076267,426447,28203,35462,12709,390985,57906,490112,426447,,,,,0,0,0,0
1650440768.5802484,public.usertable,391390,57924,517922816,16782,public,usertable,1,0,1005008,2076552,426861,28213,35471,12714,391390,57924,490545,426861,,,,,0,0,0,0
1650440769.6212614,public.usertable,391821,57944,518463488,16782,public,usertable,1,0,1006274,2077612,427305,28221,35484,12718,391821,57944,491010,427305,,,,,0,0,0,0
1650440770.6508782,public.usertable,392232,57966,518979584,16782,public,usertable,1,0,1007374,2078844,427731,28235,35499,12725,392232,57966,491465,427731,,,,,0,0,0,0
1650440771.6810973,public.usertable,392664,57974,519520256,16782,public,usertable,1,0,1008493,2080175,428175,28245,35511,12729,392664,57974,491931,428175,,,,,0,0,0,0
1650440772.7124267,public.usertable,393068,57994,520052736,16782,public,usertable,1,0,1009580,2080743,428596,28254,35528,12730,393068,57994,492378,428596,,,,,0,0,0,0
1650440773.7424855,public.usertable,393489,58025,520568832,16782,public,usertable,1,0,1010758,2081758,429032,28270,35543,12741,393489,58025,492845,429032,,,,,0,0,0,0
1650440774.7728872,public.usertable,393891,58053,521093120,16782,public,usertable,1,0,1011938,2082044,429450,28286,35559,12749,393891,58053,493295,429450,,,,,0,0,0,0
1650440775.8046951,public.usertable,394294,58079,521601024,16782,public,usertable,1,0,1013033,2082489,429868,28297,35574,12753,394294,58079,493739,429868,,,,,0,0,0,0
1650440776.8339207,public.usertable,394701,58101,522108928,16782,public,usertable,1,0,1014109,2083230,430288,28306,35587,12756,394701,58101,494181,430288,,,,,0,0,0,0
1650440777.8645449,public.usertable,395104,58122,522608640,16782,public,usertable,1,0,1015106,2083929,430706,28317,35602,12759,395104,58122,494625,430706,,,,,0,0,0,0
1650440778.8949628,public.usertable,395486,58143,523116544,16782,public,usertable,1,0,1016273,2085345,431107,28337,35621,12771,395486,58143,495065,431107,,,,,0,0,0,0
1650440779.9266322,public.usertable,395900,58164,523632640,16782,public,usertable,1,0,1017461,2086323,431533,28351,35633,12776,395900,58164,495517,431533,,,,,0,0,0,0
1650440780.957801,public.usertable,396313,58185,524156928,16782,public,usertable,1,0,1018507,2087273,431960,28360,35647,12783,396313,58185,495967,431960,,,,,0,0,0,0
1650440781.9880087,public.usertable,396932,58208,524664832,16782,public,usertable,1,0,1020282,2088679,432599,28370,35667,12789,396932,58208,496636,432599,,,,,0,0,0,0
1650440783.017927,public.usertable,397309,58227,525139968,16782,public,usertable,1,0,1021366,2089342,432986,28384,35677,12798,397309,58227,497047,432986,,,,,0,0,0,0
1650440784.0471132,public.usertable,397682,58249,525606912,16782,public,usertable,1,0,1022396,2090126,433370,28397,35688,12808,397682,58249,497455,433370,,,,,0,0,0,0
1650440785.0793903,public.usertable,398028,58267,526041088,16782,public,usertable,1,0,1023316,2090340,433729,28408,35701,12814,398028,58267,497838,433729,,,,,0,0,0,0
1650440786.109021,public.usertable,398436,58288,526565376,16782,public,usertable,1,0,1024353,2091454,434147,28422,35711,12823,398436,58288,498280,434147,,,,,0,0,0,0
1650440787.1414988,public.usertable,398854,58311,527081472,16782,public,usertable,1,0,1025530,2091833,434579,28435,35725,12833,398854,58311,498739,434579,,,,,0,0,0,0
1650440788.1708102,public.usertable,399237,58335,527564800,16782,public,usertable,1,0,1026647,2092504,434979,28448,35742,12836,399237,58335,499169,434979,,,,,0,0,0,0
1650440789.202107,public.usertable,399605,58348,528031744,16782,public,usertable,1,0,1027653,2093200,435360,28455,35755,12840,399605,58348,499570,435360,,,,,0,0,0,0
1650440790.2310958,public.usertable,399988,58362,528523264,16782,public,usertable,1,0,1028755,2094458,435753,28464,35765,12844,399988,58362,499982,435753,,,,,0,0,0,0
1650440791.259642,public.usertable,400389,58383,529022976,16782,public,usertable,1,0,1029959,2095308,436164,28477,35775,12852,400389,58383,500416,436164,,,,,0,0,0,0
1650440792.2895672,public.usertable,400781,58394,529489920,16782,public,usertable,1,0,1030936,2095745,436568,28483,35787,12853,400781,58394,500838,436568,,,,,0,0,0,0
1650440793.3197458,public.usertable,401197,58410,530038784,16782,public,usertable,1,0,1032020,2095922,436994,28489,35797,12855,401197,58410,501280,436994,,,,,0,0,0,0
1650440794.3497345,public.usertable,401611,58436,530579456,16782,public,usertable,1,0,1033186,2097090,437424,28500,35813,12857,401611,58436,501737,437424,,,,,0,0,0,0
1650440795.378998,public.usertable,402045,58458,531095552,16782,public,usertable,1,0,1034313,2097718,437875,28508,35830,12861,402045,58458,502213,437875,,,,,0,0,0,0
1650440796.4070914,public.usertable,402442,58477,531611648,16782,public,usertable,1,0,1035426,2098456,438285,28516,35843,12865,402442,58477,502644,438285,,,,,0,0,0,0
1650440797.440453,public.usertable,402855,58497,532103168,16782,public,usertable,1,0,1036399,2098878,438709,28526,35854,12870,402855,58497,503089,438709,,,,,0,0,0,0
1650440798.4689338,public.usertable,403247,58512,532594688,16782,public,usertable,1,0,1037495,2099208,439114,28533,35867,12875,403247,58512,503514,439114,,,,,0,0,0,0
1650440799.499138,public.usertable,403653,58531,533127168,16782,public,usertable,1,0,1038582,2100046,439530,28545,35877,12879,403653,58531,503952,439530,,,,,0,0,0,0
1650440800.5320892,public.usertable,404264,58557,533635072,16782,public,usertable,1,0,1040299,2101065,440160,28554,35896,12883,404264,58557,504610,440160,,,,,0,0,0,0
1650440801.5610414,public.usertable,404653,58580,534134784,16782,public,usertable,1,0,1041429,2101645,440568,28562,35915,12886,404653,58580,505045,440568,,,,,0,0,0,0
1650440802.5896175,public.usertable,405059,58605,534659072,16782,public,usertable,1,0,1042511,2102748,440991,28573,35932,12888,405059,58605,505496,440991,,,,,0,0,0,0
1650440803.6183252,public.usertable,405478,58630,535191552,16782,public,usertable,1,0,1043595,2103119,441428,28583,35950,12894,405478,58630,505961,441428,,,,,0,0,0,0
1650440804.6476753,public.usertable,405912,58657,535732224,16782,public,usertable,1,0,1044609,2104162,441877,28596,35965,12901,405912,58657,506438,441877,,,,,0,0,0,0
1650440805.6786282,public.usertable,406299,58686,536215552,16782,public,usertable,1,0,1045694,2105074,442278,28611,35979,12911,406299,58686,506868,442278,,,,,0,0,0,0
1650440806.7080202,public.usertable,406686,58719,536723456,16782,public,usertable,1,0,1046834,2105571,442680,28629,35994,12919,406686,58719,507303,442680,,,,,0,0,0,0
1650440807.7382,public.usertable,407093,58731,537214976,16782,public,usertable,1,0,1047972,2106621,443098,28639,36005,12925,407093,58731,507742,443098,,,,,0,0,0,0
1650440808.767322,public.usertable,407505,58753,537747456,16782,public,usertable,1,0,1049192,2107668,443522,28652,36017,12931,407505,58753,508191,443522,,,,,0,0,0,0
1650440809.795627,public.usertable,407886,58782,538222592,16782,public,usertable,1,0,1050327,2108531,443923,28668,36037,12938,407886,58782,508628,443923,,,,,0,0,0,0
1650440810.8240747,public.usertable,408292,58808,538755072,16782,public,usertable,1,0,1051337,2109110,444346,28677,36054,12944,408292,58808,509077,444346,,,,,0,0,0,0
1650440811.8527935,public.usertable,408697,58838,539254784,16782,public,usertable,1,0,1052374,2109614,444773,28687,36076,12952,408697,58838,509536,444773,,,,,0,0,0,0
1650440812.880456,public.usertable,409089,58861,539729920,16782,public,usertable,1,0,1053420,2110212,445175,28702,36086,12963,409089,58861,509963,445175,,,,,0,0,0,0
1650440813.9103549,public.usertable,409456,58889,540196864,16782,public,usertable,1,0,1054450,2110733,445553,28719,36097,12972,409456,58889,510369,445553,,,,,0,0,0,0
1650440814.9413335,public.usertable,409860,58908,540704768,16782,public,usertable,1,0,1055519,2111188,445969,28728,36109,12974,409860,58908,510806,445969,,,,,0,0,0,0
1650440815.9701955,public.usertable,410210,58925,541171712,16782,public,usertable,1,0,1056536,2111677,446335,28735,36125,12979,410210,58925,511195,446335,,,,,0,0,0,0
1650440816.9994555,public.usertable,410600,58948,541646848,16782,public,usertable,1,0,1057674,2112159,446739,28748,36139,12986,410600,58948,511626,446739,,,,,0,0,0,0
1650440818.0299535,public.usertable,410977,58970,542121984,16782,public,usertable,1,0,1058718,2112908,447131,28760,36154,12993,410977,58970,512045,447131,,,,,0,0,0,0
1650440819.06134,public.usertable,411559,59000,542613504,16782,public,usertable,1,0,1060327,2114700,447732,28778,36173,13006,411559,59000,512683,447732,,,,,0,0,0,0
1650440820.0913138,public.usertable,411974,59019,543129600,16782,public,usertable,1,0,1061557,2115318,448160,28788,36186,13010,411974,59019,513134,448160,,,,,0,0,0,0
1650440821.1213121,public.usertable,412353,59042,543612928,16782,public,usertable,1,0,1062581,2115670,448552,28800,36199,13016,412353,59042,513551,448552,,,,,0,0,0,0
1650440822.1502159,public.usertable,412736,59063,544096256,16782,public,usertable,1,0,1063666,2116239,448949,28807,36213,13019,412736,59063,513969,448949,,,,,0,0,0,0
1650440823.1788907,public.usertable,413106,59081,544571392,16782,public,usertable,1,0,1064694,2116856,449332,28822,36226,13026,413106,59081,514380,449332,,,,,0,0,0,0
1650440824.2086806,public.usertable,413486,59105,545046528,16782,public,usertable,1,0,1065630,2117816,449727,28834,36241,13034,413486,59105,514802,449727,,,,,0,0,0,0
1650440825.2394483,public.usertable,413857,59128,545521664,16782,public,usertable,1,0,1066631,2118811,450113,28845,36256,13041,413857,59128,515214,450113,,,,,0,0,0,0
1650440826.2707841,public.usertable,414277,59150,546054144,16782,public,usertable,1,0,1067765,2119947,450545,28855,36268,13046,414277,59150,515668,450545,,,,,0,0,0,0
1650440827.3011653,public.usertable,414688,59174,546553856,16782,public,usertable,1,0,1068813,2120805,450966,28869,36278,13053,414688,59174,516113,450966,,,,,0,0,0,0
1650440828.3313727,public.usertable,415075,59191,547020800,16782,public,usertable,1,0,1069901,2121650,451366,28875,36291,13057,415075,59191,516532,451366,,,,,0,0,0,0
1650440829.3610392,public.usertable,415434,59210,547504128,16782,public,usertable,1,0,1070930,2122420,451736,28885,36302,13063,415434,59210,516923,451736,,,,,0,0,0,0
1650440830.3903692,public.usertable,415852,59233,548028416,16782,public,usertable,1,0,1072103,2123457,452169,28896,36317,13070,415852,59233,517382,452169,,,,,0,0,0,0
1650440831.4217036,public.usertable,416271,59255,548560896,16782,public,usertable,1,0,1073178,2124723,452601,28907,36330,13075,416271,59255,517838,452601,,,,,0,0,0,0
1650440832.4516168,public.usertable,416678,59280,549060608,16782,public,usertable,1,0,1074316,2125247,453025,28916,36347,13081,416678,59280,518288,453025,,,,,0,0,0,0
1650440833.4817443,public.usertable,417081,59299,549560320,16782,public,usertable,1,0,1075349,2126392,453445,28921,36364,13084,417081,59299,518730,453445,,,,,0,0,0,0
1650440834.5115805,public.usertable,417476,59320,550068224,16782,public,usertable,1,0,1076318,2126857,453853,28934,36377,13088,417476,59320,519164,453853,,,,,0,0,0,0
1650440835.5415294,public.usertable,417878,59337,550584320,16782,public,usertable,1,0,1077342,2127740,454268,28945,36390,13095,417878,59337,519603,454268,,,,,0,0,0,0
1650440836.5719008,public.usertable,418306,59358,551100416,16782,public,usertable,1,0,1078478,2128003,454704,28959,36398,13101,418306,59358,520061,454704,,,,,0,0,0,0
1650440837.6008804,public.usertable,418931,59383,551632896,16782,public,usertable,1,0,1080151,2129080,455345,28973,36414,13111,418931,59383,520732,455345,,,,,0,0,0,0
1650440838.633113,public.usertable,419329,59406,552140800,16782,public,usertable,1,0,1081214,2129722,455753,28987,36424,13116,419329,59406,521164,455753,,,,,0,0,0,0
1650440839.664229,public.usertable,419733,59421,552632320,16782,public,usertable,1,0,1082374,2130257,456168,28996,36435,13119,419733,59421,521599,456168,,,,,0,0,0,0
1650440840.6928072,public.usertable,420136,59441,553132032,16782,public,usertable,1,0,1083479,2131057,456580,29007,36444,13123,420136,59441,522031,456580,,,,,0,0,0,0
1650440841.7224312,public.usertable,420508,59464,553607168,16782,public,usertable,1,0,1084506,2131423,456965,29017,36457,13128,420508,59464,522439,456965,,,,,0,0,0,0
1650440842.7539167,public.usertable,420886,59483,554074112,16782,public,usertable,1,0,1085486,2132585,457351,29030,36465,13138,420886,59483,522846,457351,,,,,0,0,0,0
1650440843.7842479,public.usertable,421246,59504,554532864,16782,public,usertable,1,0,1086479,2133341,457723,29040,36477,13142,421246,59504,523240,457723,,,,,0,0,0,0
1650440844.8136954,public.usertable,421557,59522,554901504,16782,public,usertable,1,0,1087387,2133816,458050,29043,36493,13143,421557,59522,523586,458050,,,,,0,0,0,0
1650440845.8430896,public.usertable,421905,59544,555352064,16782,public,usertable,1,0,1088378,2134412,458409,29057,36504,13151,421905,59544,523970,458409,,,,,0,0,0,0
1650440846.871792,public.usertable,422304,59565,555851776,16782,public,usertable,1,0,1089637,2135266,458820,29069,36516,13157,422304,59565,524405,458820,,,,,0,0,0,0
1650440847.900587,public.usertable,422654,59588,556294144,16782,public,usertable,1,0,1090693,2136252,459185,29078,36531,13160,422654,59588,524794,459185,,,,,0,0,0,0
1650440848.9302533,public.usertable,423006,59612,556761088,16782,public,usertable,1,0,1091662,2137780,459554,29088,36548,13166,423006,59612,525190,459554,,,,,0,0,0,0
1650440849.96121,public.usertable,423396,59629,557244416,16782,public,usertable,1,0,1092734,2138263,459956,29097,36560,13169,423396,59629,525613,459956,,,,,0,0,0,0
1650440850.9908478,public.usertable,423762,59652,557703168,16782,public,usertable,1,0,1093839,2139113,460334,29111,36572,13176,423762,59652,526017,460334,,,,,0,0,0,0
1650440852.023819,public.usertable,424156,59675,558194688,16782,public,usertable,1,0,1094867,2140011,460741,29121,36585,13182,424156,59675,526447,460741,,,,,0,0,0,0
1650440853.0542483,public.usertable,424510,59699,558645248,16782,public,usertable,1,0,1095828,2140524,461113,29133,36603,13187,424510,59699,526849,461113,,,,,0,0,0,0
1650440854.0870194,public.usertable,424888,59724,559120384,16782,public,usertable,1,0,1096895,2141773,461506,29144,36618,13195,424888,59724,527268,461506,,,,,0,0,0,0
1650440855.117703,public.usertable,425262,59734,559603712,16782,public,usertable,1,0,1097977,2142982,461889,29157,36627,13201,425262,59734,527673,461889,,,,,0,0,0,0
1650440856.1510139,public.usertable,425641,59760,560078848,16782,public,usertable,1,0,1098974,2143886,462284,29170,36643,13209,425641,59760,528097,462284,,,,,0,0,0,0
1650440857.1854699,public.usertable,426181,59791,560529408,16782,public,usertable,1,0,1100449,2145193,462840,29189,36659,13216,426181,59791,528688,462840,,,,,0,0,0,0
1650440858.2146842,public.usertable,426543,59812,560988160,16782,public,usertable,1,0,1101569,2145681,463211,29204,36668,13226,426543,59812,529083,463211,,,,,0,0,0,0
1650440859.2449791,public.usertable,426972,59825,561520640,16782,public,usertable,1,0,1102717,2146527,463648,29210,36676,13228,426972,59825,529534,463648,,,,,0,0,0,0
1650440860.2745512,public.usertable,427379,59843,562020352,16782,public,usertable,1,0,1103824,2147275,464068,29216,36689,13231,427379,59843,529973,464068,,,,,0,0,0,0
1650440861.3052452,public.usertable,427749,59865,562495488,16782,public,usertable,1,0,1104827,2147637,464458,29225,36709,13235,427749,59865,530392,464458,,,,,0,0,0,0
1650440862.3347013,public.usertable,428114,59885,562954240,16782,public,usertable,1,0,1105859,2148237,464837,29234,36723,13237,428114,59885,530794,464837,,,,,0,0,0,0
1650440863.3636081,public.usertable,428491,59910,563437568,16782,public,usertable,1,0,1106902,2148797,465226,29250,36735,13248,428491,59910,531211,465226,,,,,0,0,0,0
1650440864.3987658,public.usertable,428857,59933,563912704,16782,public,usertable,1,0,1107849,2149055,465605,29260,36748,13250,428857,59933,531613,465605,,,,,0,0,0,0
1650440865.429188,public.usertable,429261,59953,564428800,16782,public,usertable,1,0,1108893,2149484,466019,29273,36758,13257,429261,59953,532050,466019,,,,,0,0,0,0
1650440866.460511,public.usertable,429666,59979,564928512,16782,public,usertable,1,0,1109997,2150903,466438,29290,36772,13264,429666,59979,532500,466438,,,,,0,0,0,0
1650440867.4895022,public.usertable,430063,60008,565436416,16782,public,usertable,1,0,1111130,2151779,466852,29302,36789,13269,430063,60008,532943,466852,,,,,0,0,0,0
1650440868.5191915,public.usertable,430465,60031,565936128,16782,public,usertable,1,0,1112351,2151972,467263,29316,36798,13279,430465,60031,533377,467263,,,,,0,0,0,0
1650440869.5487025,public.usertable,430856,60051,566444032,16782,public,usertable,1,0,1113494,2152817,467665,29328,36809,13286,430856,60051,533802,467665,,,,,0,0,0,0
1650440870.5777242,public.usertable,431267,60069,566951936,16782,public,usertable,1,0,1114596,2153683,468090,29338,36823,13292,431267,60069,534251,468090,,,,,0,0,0,0
1650440871.6072621,public.usertable,431662,60093,567459840,16782,public,usertable,1,0,1115665,2154103,468499,29354,36837,13300,431662,60093,534690,468499,,,,,0,0,0,0
1650440872.6357334,public.usertable,432061,60109,567934976,16782,public,usertable,1,0,1116718,2155092,468909,29363,36848,13307,432061,60109,535120,468909,,,,,0,0,0,0
1650440873.6651442,public.usertable,432436,60126,568410112,16782,public,usertable,1,0,1117689,2156670,469293,29375,36857,13315,432436,60126,535525,469293,,,,,0,0,0,0
1650440874.695679,public.usertable,432828,60142,568877056,16782,public,usertable,1,0,1118630,2157205,469695,29382,36867,13318,432828,60142,535944,469695,,,,,0,0,0,0
1650440875.727962,public.usertable,433382,60166,569352192,16782,public,usertable,1,0,1120160,2157641,470264,29397,36882,13322,433382,60166,536543,470264,,,,,0,0,0,0
1650440876.7585802,public.usertable,433571,60175,569761792,16782,public,usertable,1,0,1120730,2157749,470457,29402,36886,13324,433571,60175,536745,470457,,,,,0,0,0,0
1650440877.7893338,public.usertable,434038,60187,570155008,16782,public,usertable,1,0,1122100,2159287,470941,29412,36903,13331,434038,60187,537256,470941,,,,,0,0,0,0
1650440878.8175097,public.usertable,434377,60210,570597376,16782,public,usertable,1,0,1123031,2160451,471294,29425,36917,13337,434377,60210,537636,471294,,,,,0,0,0,0
1650440879.8496459,public.usertable,434751,60238,571080704,16782,public,usertable,1,0,1124108,2160887,471682,29441,36931,13342,434751,60238,538054,471682,,,,,0,0,0,0
1650440880.8797505,public.usertable,435101,60261,571523072,16782,public,usertable,1,0,1125001,2161283,472047,29452,36946,13350,435101,60261,538445,472047,,,,,0,0,0,0
1650440881.9129145,public.usertable,435461,60284,571973632,16782,public,usertable,1,0,1126101,2161833,472422,29461,36961,13355,435461,60284,538844,472422,,,,,0,0,0,0
1650440882.9444823,public.usertable,435825,60297,572424192,16782,public,usertable,1,0,1127169,2162089,472798,29466,36973,13358,435825,60297,539237,472798,,,,,0,0,0,0
1650440883.9751298,public.usertable,436175,60317,572866560,16782,public,usertable,1,0,1128118,2162745,473162,29476,36987,13364,436175,60317,539625,473162,,,,,0,0,0,0
1650440885.0041661,public.usertable,436555,60334,573358080,16782,public,usertable,1,0,1129143,2164337,473549,29493,36994,13372,436555,60334,540036,473549,,,,,0,0,0,0
1650440886.0338225,public.usertable,436959,60346,573849600,16782,public,usertable,1,0,1130201,2164649,473958,29502,36999,13378,436959,60346,540459,473958,,,,,0,0,0,0
1650440887.061791,public.usertable,437346,60366,574341120,16782,public,usertable,1,0,1131317,2165727,474353,29516,37007,13380,437346,60366,540876,474353,,,,,0,0,0,0
1650440888.0919182,public.usertable,437727,60384,574791680,16782,public,usertable,1,0,1132346,2166507,474743,29527,37016,13386,437727,60384,541286,474743,,,,,0,0,0,0
1650440889.1209445,public.usertable,438078,60398,575250432,16782,public,usertable,1,0,1133304,2166674,475100,29535,37022,13390,438078,60398,541657,475100,,,,,0,0,0,0
1650440890.1507626,public.usertable,438481,60413,575750144,16782,public,usertable,1,0,1134394,2167702,475512,29543,37031,13395,438481,60413,542086,475512,,,,,0,0,0,0
1650440891.1814742,public.usertable,438872,60435,576241664,16782,public,usertable,1,0,1135492,2168674,475913,29560,37041,13408,438872,60435,542514,475913,,,,,0,0,0,0
1650440892.21106,public.usertable,439266,60453,576733184,16782,public,usertable,1,0,1136458,2169370,476318,29568,37052,13413,439266,60453,542938,476318,,,,,0,0,0,0
1650440893.240334,public.usertable,439671,60473,577224704,16782,public,usertable,1,0,1137510,2169852,476735,29579,37064,13417,439671,60473,543378,476735,,,,,0,0,0,0
1650440894.2687552,public.usertable,440027,60493,577658880,16782,public,usertable,1,0,1138557,2170744,477104,29589,37077,13423,440027,60493,543770,477104,,,,,0,0,0,0
1650440895.2973819,public.usertable,440602,60515,578150400,16782,public,usertable,1,0,1140162,2171248,477692,29603,37090,13433,440602,60515,544385,477692,,,,,0,0,0,0
1650440896.3266683,public.usertable,440957,60540,578600960,16782,public,usertable,1,0,1141100,2171462,478064,29611,37107,13438,440957,60540,544782,478064,,,,,0,0,0,0
1650440897.3559456,public.usertable,441342,60556,579084288,16782,public,usertable,1,0,1142114,2172505,478460,29620,37118,13444,441342,60556,545198,478460,,,,,0,0,0,0
1650440898.3851955,public.usertable,441724,60573,579567616,16782,public,usertable,1,0,1143090,2173243,478856,29631,37132,13450,441724,60573,545619,478856,,,,,0,0,0,0
1650440899.4197237,public.usertable,442124,60592,580067328,16782,public,usertable,1,0,1144216,2174338,479271,29635,37147,13453,442124,60592,546053,479271,,,,,0,0,0,0
1650440900.453035,public.usertable,442499,60617,580542464,16782,public,usertable,1,0,1145330,2175274,479660,29646,37161,13458,442499,60617,546467,479660,,,,,0,0,0,0
1650440901.4839015,public.usertable,442853,60642,580984832,16782,public,usertable,1,0,1146351,2176018,480035,29651,37182,13462,442853,60642,546868,480035,,,,,0,0,0,0
1650440902.5158513,public.usertable,443227,60665,581451776,16782,public,usertable,1,0,1147398,2176526,480424,29660,37197,13468,443227,60665,547281,480424,,,,,0,0,0,0
1650440903.544947,public.usertable,443595,60679,581926912,16782,public,usertable,1,0,1148463,2177078,480803,29665,37208,13471,443595,60679,547676,480803,,,,,0,0,0,0
1650440904.5754602,public.usertable,444000,60698,582443008,16782,public,usertable,1,0,1149564,2177757,481218,29674,37218,13478,444000,60698,548110,481218,,,,,0,0,0,0
1650440905.6073177,public.usertable,444394,60717,582934528,16782,public,usertable,1,0,1150713,2178883,481622,29686,37228,13483,444394,60717,548536,481622,,,,,0,0,0,0
1650440906.6362917,public.usertable,444803,60737,583450624,16782,public,usertable,1,0,1151883,2179920,482047,29694,37244,13490,444803,60737,548985,482047,,,,,0,0,0,0
1650440907.666738,public.usertable,445196,60760,583876608,16782,public,usertable,1,0,1152970,2180688,482456,29705,37260,13496,445196,60760,549421,482456,,,,,0,0,0,0
1650440908.6968088,public.usertable,445526,60774,584376320,16782,public,usertable,1,0,1153823,2181197,482798,29707,37272,13497,445526,60774,549777,482798,,,,,0,0,0,0
1650440909.7263253,public.usertable,445918,60793,584835072,16782,public,usertable,1,0,1154909,2181831,483202,29721,37284,13503,445918,60793,550207,483202,,,,,0,0,0,0
1650440910.7549741,public.usertable,446315,60821,585367552,16782,public,usertable,1,0,1156002,2182390,483613,29735,37298,13509,446315,60821,550646,483613,,,,,0,0,0,0
1650440911.7852535,public.usertable,446711,60853,585859072,16782,public,usertable,1,0,1157186,2182824,484027,29751,37316,13513,446711,60853,551094,484027,,,,,0,0,0,0
1650440912.8168817,public.usertable,447290,60878,586350592,16782,public,usertable,1,0,1158700,2183771,484627,29762,37337,13516,447290,60878,551726,484627,,,,,0,0,0,0
1650440913.8457303,public.usertable,447709,60903,586874880,16782,public,usertable,1,0,1159884,2184256,485060,29773,37351,13520,447709,60903,552184,485060,,,,,0,0,0,0
1650440914.875366,public.usertable,448104,60919,587366400,16782,public,usertable,1,0,1161002,2184928,485466,29781,37362,13525,448104,60919,552609,485466,,,,,0,0,0,0
1650440915.904467,public.usertable,448499,60938,587857920,16782,public,usertable,1,0,1162150,2186107,485873,29792,37374,13534,448499,60938,553039,485873,,,,,0,0,0,0
1650440916.9334881,public.usertable,448901,60963,588365824,16782,public,usertable,1,0,1163208,2187707,486286,29807,37385,13542,448901,60963,553478,486286,,,,,0,0,0,0
1650440917.9631853,public.usertable,449288,60981,588849152,16782,public,usertable,1,0,1164334,2187877,486682,29820,37394,13551,449288,60981,553896,486682,,,,,0,0,0,0
1650440918.993232,public.usertable,449650,61004,589291520,16782,public,usertable,1,0,1165343,2188396,487059,29828,37409,13555,449650,61004,554296,487059,,,,,0,0,0,0
1650440920.0252204,public.usertable,450016,61019,589750272,16782,public,usertable,1,0,1166329,2188864,487438,29834,37422,13558,450016,61019,554694,487438,,,,,0,0,0,0
1650440921.055656,public.usertable,450380,61045,590225408,16782,public,usertable,1,0,1167352,2189355,487816,29846,37436,13563,450380,61045,555098,487816,,,,,0,0,0,0
1650440922.0867531,public.usertable,450770,61067,590708736,16782,public,usertable,1,0,1168347,2189898,488215,29859,37445,13570,450770,61067,555519,488215,,,,,0,0,0,0
1650440923.1154675,public.usertable,451110,61090,591134720,16782,public,usertable,1,0,1169323,2190141,488563,29874,37453,13577,451110,61090,555890,488563,,,,,0,0,0,0
1650440924.1468856,public.usertable,451484,61098,591601664,16782,public,usertable,1,0,1170278,2190767,488947,29884,37463,13584,451484,61098,556294,488947,,,,,0,0,0,0
1650440925.1773005,public.usertable,451863,61114,592068608,16782,public,usertable,1,0,1171398,2191049,489332,29897,37469,13589,451863,61114,556698,489332,,,,,0,0,0,0
1650440926.206991,public.usertable,452223,61137,592510976,16782,public,usertable,1,0,1172422,2191267,489709,29904,37486,13594,452223,61137,557099,489709,,,,,0,0,0,0
1650440927.2359147,public.usertable,452593,61146,592994304,16782,public,usertable,1,0,1173484,2192532,490091,29914,37498,13597,452593,61146,557503,490091,,,,,0,0,0,0
1650440928.2657316,public.usertable,452978,61165,593461248,16782,public,usertable,1,0,1174543,2193709,490484,29925,37506,13601,452978,61165,557915,490484,,,,,0,0,0,0
1650440929.2963831,public.usertable,453321,61183,593903616,16782,public,usertable,1,0,1175389,2193969,490837,29939,37516,13607,453321,61183,558292,490837,,,,,0,0,0,0
1650440930.3257225,public.usertable,453704,61200,594362368,16782,public,usertable,1,0,1176341,2194453,491225,29952,37521,13612,453704,61200,558698,491225,,,,,0,0,0,0
1650440931.3580976,public.usertable,454077,61218,594845696,16782,public,usertable,1,0,1177386,2194818,491606,29963,37529,13619,454077,61218,559098,491606,,,,,0,0,0,0
1650440932.3859725,public.usertable,454449,61237,595296256,16782,public,usertable,1,0,1178385,2194987,491993,29967,37544,13621,454449,61237,559504,491993,,,,,0,0,0,0
1650440933.4156373,public.usertable,454989,61262,595730432,16782,public,usertable,1,0,1179819,2195453,492548,29978,37559,13629,454989,61262,560085,492548,,,,,0,0,0,0
1650440934.4444106,public.usertable,455340,61274,596180992,16782,public,usertable,1,0,1180827,2195885,492905,29984,37565,13632,455340,61274,560454,492905,,,,,0,0,0,0
1650440935.4744096,public.usertable,455709,61288,596639744,16782,public,usertable,1,0,1181840,2196863,493285,29995,37576,13639,455709,61288,560856,493285,,,,,0,0,0,0
1650440936.5043325,public.usertable,456096,61313,597131264,16782,public,usertable,1,0,1182880,2197927,493688,30005,37592,13646,456096,61313,561285,493688,,,,,0,0,0,0
1650440937.5349488,public.usertable,456490,61321,597614592,16782,public,usertable,1,0,1184010,2198220,494087,30015,37597,13652,456490,61321,561699,494087,,,,,0,0,0,0
1650440938.5654488,public.usertable,456828,61336,598024192,16782,public,usertable,1,0,1184930,2198806,494436,30021,37608,13653,456828,61336,562065,494436,,,,,0,0,0,0
1650440939.5938847,public.usertable,457174,61346,598450176,16782,public,usertable,1,0,1185801,2199091,494788,30027,37614,13656,457174,61346,562429,494788,,,,,0,0,0,0
1650440940.6234033,public.usertable,457499,61359,598859776,16782,public,usertable,1,0,1186550,2199658,495124,30031,37625,13657,457499,61359,562780,495124,,,,,0,0,0,0
1650440941.6538088,public.usertable,457813,61379,599252992,16782,public,usertable,1,0,1187384,2200252,495450,30039,37637,13662,457813,61379,563126,495450,,,,,0,0,0,0
1650440942.685035,public.usertable,458091,61395,599597056,16782,public,usertable,1,0,1188205,2200879,495741,30042,37650,13663,458091,61395,563433,495741,,,,,0,0,0,0
1650440943.7158575,public.usertable,458378,61410,599965696,16782,public,usertable,1,0,1188936,2201040,496038,30047,37660,13663,458378,61410,563745,496038,,,,,0,0,0,0
1650440944.7467966,public.usertable,458646,61428,600285184,16782,public,usertable,1,0,1189774,2201252,496319,30052,37673,13664,458646,61428,564044,496319,,,,,0,0,0,0
1650440945.7760723,public.usertable,458904,61432,600621056,16782,public,usertable,1,0,1190475,2201944,496579,30058,37675,13668,458904,61432,564312,496579,,,,,0,0,0,0
1650440946.809199,public.usertable,459211,61448,600981504,16782,public,usertable,1,0,1191251,2202110,496898,30062,37687,13669,459211,61448,564647,496898,,,,,0,0,0,0
1650440947.8387916,public.usertable,459509,61462,601382912,16782,public,usertable,1,0,1191969,2202335,497206,30069,37697,13673,459509,61462,564972,497206,,,,,0,0,0,0
1650440948.8682275,public.usertable,459875,61489,601890816,16782,public,usertable,1,0,1193003,2202817,497587,30082,37712,13681,459875,61489,565381,497587,,,,,0,0,0,0
1650440949.9009662,public.usertable,460266,61505,602390528,16782,public,usertable,1,0,1194056,2203712,497992,30092,37726,13687,460266,61505,565810,497992,,,,,0,0,0,0
1650440950.929175,public.usertable,460688,61518,602906624,16782,public,usertable,1,0,1195222,2204702,498427,30098,37739,13690,460688,61518,566264,498427,,,,,0,0,0,0
1650440951.9594634,public.usertable,461086,61540,603414528,16782,public,usertable,1,0,1196423,2205092,498847,30104,37761,13694,461086,61540,566712,498847,,,,,0,0,0,0
1650440952.9905455,public.usertable,461486,61558,603922432,16782,public,usertable,1,0,1197556,2205896,499259,30117,37773,13701,461486,61558,567149,499259,,,,,0,0,0,0
1650440954.021912,public.usertable,462091,61593,604438528,16782,public,usertable,1,0,1199312,2207086,499885,30136,37794,13706,462091,61593,567815,499885,,,,,0,0,0,0
1650440955.0523157,public.usertable,462487,61616,604938240,16782,public,usertable,1,0,1200410,2207571,500295,30147,37808,13710,462487,61616,568250,500295,,,,,0,0,0,0
1650440956.0823696,public.usertable,462898,61642,605446144,16782,public,usertable,1,0,1201560,2208270,500720,30162,37822,13718,462898,61642,568704,500720,,,,,0,0,0,0
1650440957.1135957,public.usertable,463299,61663,605962240,16782,public,usertable,1,0,1202674,2208953,501135,30173,37836,13725,463299,61663,569144,501135,,,,,0,0,0,0
1650440958.1459138,public.usertable,463711,61680,606478336,16782,public,usertable,1,0,1203817,2209582,501560,30182,37849,13727,463711,61680,569591,501560,,,,,0,0,0,0
1650440959.1765435,public.usertable,464129,61680,607002624,16782,public,usertable,1,0,1204925,2210323,501982,30190,37853,13730,464129,61680,570025,501982,,,,,0,0,0,0
1650440960.2069175,public.usertable,464533,61704,607502336,16782,public,usertable,1,0,1205889,2210442,502401,30199,37868,13735,464533,61704,570468,502401,,,,,0,0,0,0
1650440961.2353365,public.usertable,464940,61728,608010240,16782,public,usertable,1,0,1207013,2210775,502823,30213,37883,13741,464940,61728,570919,502823,,,,,0,0,0,0
1650440962.2655644,public.usertable,465353,61753,608542720,16782,public,usertable,1,0,1208155,2211223,503252,30222,37899,13744,465353,61753,571373,503252,,,,,0,0,0,0
1650440963.295116,public.usertable,465743,61767,609034240,16782,public,usertable,1,0,1209233,2212367,503653,30233,37910,13750,465743,61767,571796,503653,,,,,0,0,0,0
1650440964.3245835,public.usertable,466122,61787,609501184,16782,public,usertable,1,0,1210200,2212805,504043,30243,37921,13756,466122,61787,572207,504043,,,,,0,0,0,0
1650440965.3541734,public.usertable,466512,61807,610000896,16782,public,usertable,1,0,1211271,2213555,504445,30253,37933,13760,466512,61807,572631,504445,,,,,0,0,0,0
1650440966.3858747,public.usertable,466919,61825,610533376,16782,public,usertable,1,0,1212365,2213888,504862,30261,37943,13765,466919,61825,573066,504862,,,,,0,0,0,0
1650440967.4219775,public.usertable,467338,61834,611033088,16782,public,usertable,1,0,1213526,2214898,505295,30273,37957,13770,467338,61834,573525,505295,,,,,0,0,0,0
1650440968.4504476,public.usertable,467731,61843,611516416,16782,public,usertable,1,0,1214627,2215611,505698,30277,37967,13770,467731,61843,573942,505698,,,,,0,0,0,0
1650440969.482089,public.usertable,468089,61852,611966976,16782,public,usertable,1,0,1215562,2216186,506061,30283,37972,13773,468089,61852,574316,506061,,,,,0,0,0,0
1650440970.5106905,public.usertable,468491,61869,612450304,16782,public,usertable,1,0,1216575,2216478,506473,30291,37982,13778,468491,61869,574746,506473,,,,,0,0,0,0
1650440971.541826,public.usertable,469057,61893,612925440,16782,public,usertable,1,0,1218101,2217390,507055,30301,37998,13784,469057,61893,575354,507055,,,,,0,0,0,0
1650440972.570772,public.usertable,469424,61910,613384192,16782,public,usertable,1,0,1219110,2217880,507430,30310,38006,13791,469424,61910,575746,507430,,,,,0,0,0,0
1650440973.6013033,public.usertable,469809,61927,613842944,16782,public,usertable,1,0,1220192,2218351,507823,30324,38014,13803,469809,61927,576161,507823,,,,,0,0,0,0
1650440974.6327307,public.usertable,470190,61952,614342656,16782,public,usertable,1,0,1221180,2218689,508219,30335,38029,13809,470190,61952,576583,508219,,,,,0,0,0,0
1650440975.6615505,public.usertable,470576,61965,614817792,16782,public,usertable,1,0,1222253,2219952,508616,30341,38040,13812,470576,61965,576997,508616,,,,,0,0,0,0
1650440976.691447,public.usertable,470953,61980,615292928,16782,public,usertable,1,0,1223269,2220298,509006,30349,38053,13816,470953,61980,577408,509006,,,,,0,0,0,0
1650440977.7201076,public.usertable,471366,61983,615800832,16782,public,usertable,1,0,1224294,2220706,509422,30358,38056,13819,471366,61983,577836,509422,,,,,0,0,0,0
1650440978.750532,public.usertable,471740,61988,616267776,16782,public,usertable,1,0,1225340,2221995,509806,30364,38066,13822,471740,61988,578236,509806,,,,,0,0,0,0
1650440979.7804968,public.usertable,472154,62000,616792064,16782,public,usertable,1,0,1226329,2222857,510232,30371,38078,13826,472154,62000,578681,510232,,,,,0,0,0,0
1650440980.809967,public.usertable,472550,62027,617291776,16782,public,usertable,1,0,1227494,2223369,510646,30380,38096,13831,472550,62027,579122,510646,,,,,0,0,0,0
1650440981.8421764,public.usertable,472956,62049,617791488,16782,public,usertable,1,0,1228587,2223728,511063,30391,38107,13838,472956,62049,579561,511063,,,,,0,0,0,0
1650440982.8715494,public.usertable,473353,62062,618291200,16782,public,usertable,1,0,1229688,2225084,511469,30400,38116,13845,473353,62062,579985,511469,,,,,0,0,0,0
1650440983.9005198,public.usertable,473748,62088,618790912,16782,public,usertable,1,0,1230961,2225655,511880,30410,38132,13852,473748,62088,580422,511880,,,,,0,0,0,0
1650440984.9315822,public.usertable,474159,62104,619282432,16782,public,usertable,1,0,1232058,2225977,512301,30418,38142,13856,474159,62104,580861,512301,,,,,0,0,0,0
1650440985.962768,public.usertable,474543,62115,619790336,16782,public,usertable,1,0,1233110,2226790,512696,30425,38153,13862,474543,62115,581274,512696,,,,,0,0,0,0
1650440986.9937863,public.usertable,474954,62136,620290048,16782,public,usertable,1,0,1234253,2227683,513119,30435,38165,13868,474954,62136,581719,513119,,,,,0,0,0,0
1650440988.0250616,public.usertable,475362,62155,620806144,16782,public,usertable,1,0,1235431,2228498,513539,30442,38177,13871,475362,62155,582158,513539,,,,,0,0,0,0
1650440989.0543227,public.usertable,475792,62172,621330432,16782,public,usertable,1,0,1236510,2229080,513977,30451,38185,13875,475792,62172,582613,513977,,,,,0,0,0,0
1650440990.0835807,public.usertable,476412,62200,621854720,16782,public,usertable,1,0,1238213,2230297,514617,30466,38205,13884,476412,62200,583288,514617,,,,,0,0,0,0
1650440991.1135106,public.usertable,476756,62215,622280704,16782,public,usertable,1,0,1239112,2230446,514968,30477,38212,13890,476756,62215,583657,514968,,,,,0,0,0,0
1650440992.1425679,public.usertable,477024,62234,622608384,16782,public,usertable,1,0,1239878,2230547,515251,30481,38227,13892,477024,62234,583959,515251,,,,,0,0,0,0
1650440993.1713073,public.usertable,477287,62244,622944256,16782,public,usertable,1,0,1240594,2231192,515520,30485,38233,13894,477287,62244,584238,515520,,,,,0,0,0,0
1650440994.2002864,public.usertable,477558,62247,623271936,16782,public,usertable,1,0,1241276,2232142,515798,30491,38240,13896,477558,62247,584529,515798,,,,,0,0,0,0
1650440995.2324495,public.usertable,477806,62259,623591424,16782,public,usertable,1,0,1241896,2232488,516053,30497,38247,13900,477806,62259,584797,516053,,,,,0,0,0,0
1650440996.2636917,public.usertable,478085,62273,623919104,16782,public,usertable,1,0,1242704,2232953,516337,30510,38252,13907,478085,62273,585099,516337,,,,,0,0,0,0
1650440997.291576,public.usertable,478337,62275,624230400,16782,public,usertable,1,0,1243362,2233233,516593,30513,38256,13907,478337,62275,585362,516593,,,,,0,0,0,0
1650440998.3231075,public.usertable,478606,62290,624574464,16782,public,usertable,1,0,1244118,2234482,516869,30523,38263,13911,478606,62290,585655,516869,,,,,0,0,0,0
1650440999.3568108,public.usertable,478919,62306,625008640,16782,public,usertable,1,0,1244995,2234786,517196,30528,38277,13912,478919,62306,586001,517196,,,,,0,0,0,0
1650441000.3876636,public.usertable,479267,62313,625426432,16782,public,usertable,1,0,1245892,2235937,517555,30532,38288,13913,479267,62313,586375,517555,,,,,0,0,0,0
1650441001.4168713,public.usertable,479617,62331,625876992,16782,public,usertable,1,0,1246951,2236536,517916,30545,38299,13920,479617,62331,586760,517916,,,,,0,0,0,0
1650441002.4459863,public.usertable,479975,62353,626311168,16782,public,usertable,1,0,1247973,2236935,518283,30559,38308,13926,479975,62353,587150,518283,,,,,0,0,0,0
1650441003.4769073,public.usertable,480343,62365,626769920,16782,public,usertable,1,0,1248935,2237920,518661,30567,38318,13931,480343,62365,587546,518661,,,,,0,0,0,0
1650441004.5061772,public.usertable,480709,62379,627236864,16782,public,usertable,1,0,1250009,2238389,519036,30574,38327,13937,480709,62379,587937,519036,,,,,0,0,0,0
1650441005.5344877,public.usertable,481082,62395,627728384,16782,public,usertable,1,0,1250981,2238471,519421,30579,38339,13939,481082,62395,588339,519421,,,,,0,0,0,0
1650441006.5649195,public.usertable,481514,62421,628285440,16782,public,usertable,1,0,1252138,2238694,519868,30590,38354,13944,481514,62421,588812,519868,,,,,0,0,0,0
1650441007.5957847,public.usertable,481955,62434,628809728,16782,public,usertable,1,0,1253311,2239151,520321,30597,38366,13949,481955,62434,589284,520321,,,,,0,0,0,0
1650441008.6253815,public.usertable,482342,62449,629276672,16782,public,usertable,1,0,1254454,2239969,520719,30603,38377,13953,482342,62449,589699,520719,,,,,0,0,0,0
1650441009.6548283,public.usertable,482714,62466,629710848,16782,public,usertable,1,0,1255426,2240660,521102,30610,38388,13955,482714,62466,590100,521102,,,,,0,0,0,0
1650441010.683939,public.usertable,483171,62487,630087680,16782,public,usertable,1,0,1256743,2241530,521575,30619,38404,13959,483171,62487,590598,521575,,,,,0,0,0,0
1650441011.7133439,public.usertable,483502,62509,630513664,16782,public,usertable,1,0,1257666,2241916,521920,30627,38418,13962,483502,62509,590965,521920,,,,,0,0,0,0
1650441012.7445135,public.usertable,483806,62531,630890496,16782,public,usertable,1,0,1258563,2242339,522238,30637,38432,13967,483806,62531,591307,522238,,,,,0,0,0,0
1650441013.7734144,public.usertable,484113,62544,631283712,16782,public,usertable,1,0,1259401,2242498,522551,30645,38438,13973,484113,62544,591634,522551,,,,,0,0,0,0
1650441014.8037684,public.usertable,484521,62561,631791616,16782,public,usertable,1,0,1260390,2243009,522968,30654,38447,13979,484521,62561,592069,522968,,,,,0,0,0,0
1650441015.8337295,public.usertable,484942,62574,632307712,16782,public,usertable,1,0,1261507,2243719,523398,30660,38456,13982,484942,62574,592514,523398,,,,,0,0,0,0
1650441016.8636959,public.usertable,485346,62592,632815616,16782,public,usertable,1,0,1262697,2244046,523811,30671,38465,13986,485346,62592,592947,523811,,,,,0,0,0,0
1650441017.8945534,public.usertable,485761,62600,633323520,16782,public,usertable,1,0,1263779,2245279,524235,30675,38474,13987,485761,62600,593384,524235,,,,,0,0,0,0
1650441018.9238803,public.usertable,486187,62610,633856000,16782,public,usertable,1,0,1264855,2245680,524666,30681,38479,13989,486187,62610,593826,524666,,,,,0,0,0,0
1650441019.9548752,public.usertable,486584,62624,634347520,16782,public,usertable,1,0,1265966,2246497,525074,30686,38490,13990,486584,62624,594250,525074,,,,,0,0,0,0
1650441020.9837995,public.usertable,486965,62640,634830848,16782,public,usertable,1,0,1267064,2247189,525468,30696,38503,13995,486965,62640,594667,525468,,,,,0,0,0,0
1650441022.0160525,public.usertable,487343,62656,635297792,16782,public,usertable,1,0,1268068,2247877,525854,30706,38511,13999,487343,62656,595071,525854,,,,,0,0,0,0
1650441023.048353,public.usertable,487721,62680,635772928,16782,public,usertable,1,0,1269124,2248380,526245,30717,38524,14004,487721,62680,595486,526245,,,,,0,0,0,0
1650441024.0838156,public.usertable,488078,62701,636215296,16782,public,usertable,1,0,1270208,2248921,526614,30726,38536,14011,488078,62701,595876,526614,,,,,0,0,0,0
1650441025.112253,public.usertable,488447,62714,636698624,16782,public,usertable,1,0,1271141,2249335,526990,30732,38543,14012,488447,62714,596265,526990,,,,,0,0,0,0
1650441026.1421247,public.usertable,488861,62735,637239296,16782,public,usertable,1,0,1272108,2249768,527415,30745,38554,14017,488861,62735,596714,527415,,,,,0,0,0,0
1650441027.173748,public.usertable,489279,62750,637673472,16782,public,usertable,1,0,1273105,2250003,527844,30752,38565,14019,489279,62750,597161,527844,,,,,0,0,0,0
1650441028.2037995,public.usertable,489787,62765,638124032,16782,public,usertable,1,0,1274591,2251980,528365,30764,38578,14027,489787,62765,597707,528365,,,,,0,0,0,0
1650441029.2352884,public.usertable,490137,62792,638574592,16782,public,usertable,1,0,1275546,2252341,528728,30778,38591,14033,490137,62792,598097,528728,,,,,0,0,0,0
1650441030.2642763,public.usertable,490547,62800,639074304,16782,public,usertable,1,0,1276648,2253322,529145,30785,38598,14037,490547,62800,598528,529145,,,,,0,0,0,0
1650441031.2937584,public.usertable,490890,62816,639508480,16782,public,usertable,1,0,1277506,2253610,529498,30791,38608,14039,490890,62816,598897,529498,,,,,0,0,0,0
1650441032.3231654,public.usertable,491287,62836,640008192,16782,public,usertable,1,0,1278569,2254104,529909,30803,38622,14046,491287,62836,599334,529909,,,,,0,0,0,0
1650441033.3520536,public.usertable,491677,62849,640491520,16782,public,usertable,1,0,1279700,2255361,530306,30811,38629,14050,491677,62849,599746,530306,,,,,0,0,0,0
1650441034.3821154,public.usertable,492066,62870,640974848,16782,public,usertable,1,0,1280846,2255806,530705,30823,38639,14057,492066,62870,600167,530705,,,,,0,0,0,0
1650441035.4111333,public.usertable,492467,62891,641482752,16782,public,usertable,1,0,1282000,2256036,531121,30833,38654,14064,492467,62891,600608,531121,,,,,0,0,0,0
1650441036.4421535,public.usertable,492847,62911,641957888,16782,public,usertable,1,0,1283065,2256467,531515,30839,38668,14067,492847,62911,601022,531515,,,,,0,0,0,0
1650441037.4737825,public.usertable,493173,62922,642334720,16782,public,usertable,1,0,1283881,2257202,531848,30847,38675,14072,493173,62922,601370,531848,,,,,0,0,0,0
1650441038.5033693,public.usertable,493443,62936,642646016,16782,public,usertable,1,0,1284610,2257765,532129,30854,38686,14074,493443,62936,601669,532129,,,,,0,0,0,0
1650441039.5328562,public.usertable,493707,62945,642998272,16782,public,usertable,1,0,1285427,2258597,532401,30856,38694,14075,493707,62945,601951,532401,,,,,0,0,0,0
1650441040.562508,public.usertable,494009,62956,643383296,16782,public,usertable,1,0,1286308,2258932,532708,30862,38699,14081,494009,62956,602269,532708,,,,,0,0,0,0
1650441041.5929186,public.usertable,494298,62973,643719168,16782,public,usertable,1,0,1287153,2259717,533009,30869,38711,14084,494298,62973,602589,533009,,,,,0,0,0,0
1650441042.6213038,public.usertable,494574,62987,644079616,16782,public,usertable,1,0,1287920,2260110,533297,30871,38723,14084,494574,62987,602891,533297,,,,,0,0,0,0
1650441043.6496146,public.usertable,494822,63001,644358144,16782,public,usertable,1,0,1288636,2260794,533552,30883,38730,14092,494822,63001,603165,533552,,,,,0,0,0,0
1650441044.6782684,public.usertable,495059,63011,644661248,16782,public,usertable,1,0,1289240,2261121,533797,30885,38738,14092,495059,63011,603420,533797,,,,,0,0,0,0
1650441045.7088366,public.usertable,495318,63025,644964352,16782,public,usertable,1,0,1289907,2261158,534063,30892,38745,14095,495318,63025,603700,534063,,,,,0,0,0,0
1650441046.7396886,public.usertable,495572,63033,645349376,16782,public,usertable,1,0,1290635,2261962,534326,30896,38754,14095,495572,63033,603976,534326,,,,,0,0,0,0
1650441047.7695367,public.usertable,495928,63043,645849088,16782,public,usertable,1,0,1291662,2262579,534688,30901,38760,14097,495928,63043,604349,534688,,,,,0,0,0,0
1650441048.8025777,public.usertable,496513,63077,646324224,16782,public,usertable,1,0,1293324,2263940,535294,30920,38781,14106,496513,63077,604995,535294,,,,,0,0,0,0
1650441049.8318613,public.usertable,496931,63097,646848512,16782,public,usertable,1,0,1294386,2264409,535722,30931,38791,14110,496931,63097,605444,535722,,,,,0,0,0,0
1650441050.862754,public.usertable,497316,63115,647331840,16782,public,usertable,1,0,1295520,2264664,536120,30938,38804,14114,497316,63115,605862,536120,,,,,0,0,0,0
1650441051.891281,public.usertable,497735,63131,647839744,16782,public,usertable,1,0,1296541,2265130,536547,30946,38812,14121,497735,63131,606305,536547,,,,,0,0,0,0
1650441052.9216814,public.usertable,498131,63147,648339456,16782,public,usertable,1,0,1297589,2266672,536958,30955,38827,14129,498131,63147,606740,536958,,,,,0,0,0,0
1650441053.9529831,public.usertable,498496,63174,648798208,16782,public,usertable,1,0,1298763,2267623,537336,30969,38840,14138,498496,63174,607145,537336,,,,,0,0,0,0
1650441054.9848707,public.usertable,498877,63188,649289728,16782,public,usertable,1,0,1299924,2268182,537728,30977,38851,14142,498877,63188,607556,537728,,,,,0,0,0,0
1650441056.014148,public.usertable,499291,63197,649789440,16782,public,usertable,1,0,1301013,2268927,538148,30982,38857,14143,499291,63197,607987,538148,,,,,0,0,0,0
1650441057.0444114,public.usertable,499661,63208,650248192,16782,public,usertable,1,0,1301995,2269671,538525,30992,38864,14148,499661,63208,608381,538525,,,,,0,0,0,0
1650441058.075045,public.usertable,500018,63222,650698752,16782,public,usertable,1,0,1302994,2270205,538894,31001,38876,14152,500018,63222,608771,538894,,,,,0,0,0,0
1650441059.106926,public.usertable,500398,63237,651190272,16782,public,usertable,1,0,1304078,2270980,539284,31009,38886,14157,500398,63237,609179,539284,,,,,0,0,0,0
1650441060.138201,public.usertable,500810,63252,651681792,16782,public,usertable,1,0,1305261,2271505,539710,31016,38900,14161,500810,63252,609626,539710,,,,,0,0,0,0
1650441061.1676521,public.usertable,501191,63276,652124160,16782,public,usertable,1,0,1306436,2272225,540102,31032,38911,14172,501191,63276,610045,540102,,,,,0,0,0,0
1650441062.1988409,public.usertable,501544,63287,652623872,16782,public,usertable,1,0,1307496,2273239,540463,31044,38919,14181,501544,63287,610426,540463,,,,,0,0,0,0
1650441063.2290263,public.usertable,501943,63298,653090816,16782,public,usertable,1,0,1308503,2273317,540871,31046,38928,14182,501943,63298,610845,540871,,,,,0,0,0,0
1650441064.2578518,public.usertable,502330,63314,653565952,16782,public,usertable,1,0,1309655,2273680,541265,31055,38935,14185,502330,63314,611255,541265,,,,,0,0,0,0
1650441065.2886949,public.usertable,502708,63330,654057472,16782,public,usertable,1,0,1310632,2274168,541654,31064,38946,14189,502708,63330,611664,541654,,,,,0,0,0,0
1650441066.317996,public.usertable,503120,63345,654589952,16782,public,usertable,1,0,1311756,2274539,542077,31068,38957,14190,503120,63345,612102,542077,,,,,0,0,0,0
1650441067.3471594,public.usertable,503735,63369,655089664,16782,public,usertable,1,0,1313537,2275640,542709,31082,38974,14197,503735,63369,612765,542709,,,,,0,0,0,0
1650441068.3789575,public.usertable,504094,63380,655540224,16782,public,usertable,1,0,1314593,2276188,543076,31086,38982,14199,504094,63380,613144,543076,,,,,0,0,0,0
1650441069.4113312,public.usertable,504477,63389,656007168,16782,public,usertable,1,0,1315611,2276723,543463,31091,38986,14204,504477,63389,613540,543463,,,,,0,0,0,0
1650441070.4428246,public.usertable,504883,63414,656515072,16782,public,usertable,1,0,1316829,2277742,543882,31103,38999,14212,504883,63414,613984,543882,,,,,0,0,0,0
1650441071.4753344,public.usertable,505308,63431,657039360,16782,public,usertable,1,0,1317824,2277960,544316,31112,39008,14219,505308,63431,614436,544316,,,,,0,0,0,0
1650441072.5035741,public.usertable,505711,63451,657547264,16782,public,usertable,1,0,1318918,2279030,544735,31119,39024,14222,505711,63451,614878,544735,,,,,0,0,0,0
1650441073.5328481,public.usertable,506133,63462,658079744,16782,public,usertable,1,0,1319993,2279376,545166,31125,39033,14226,506133,63462,615324,545166,,,,,0,0,0,0
1650441074.5633917,public.usertable,506555,63476,658604032,16782,public,usertable,1,0,1321149,2279917,545598,31133,39043,14228,506555,63476,615774,545598,,,,,0,0,0,0
1650441075.593455,public.usertable,506987,63489,659128320,16782,public,usertable,1,0,1322323,2280636,546037,31142,39050,14234,506987,63489,616229,546037,,,,,0,0,0,0
1650441076.6255436,public.usertable,507404,63514,659644416,16782,public,usertable,1,0,1323505,2281271,546467,31154,39063,14240,507404,63514,616684,546467,,,,,0,0,0,0
1650441077.6554406,public.usertable,507788,63527,660127744,16782,public,usertable,1,0,1324574,2281900,546860,31161,39072,14245,507788,63527,617093,546860,,,,,0,0,0,0
1650441078.6843424,public.usertable,508218,63548,660668416,16782,public,usertable,1,0,1325755,2282261,547301,31171,39083,14251,508218,63548,617555,547301,,,,,0,0,0,0
1650441079.7152479,public.usertable,508629,63567,661192704,16782,public,usertable,1,0,1326976,2282940,547728,31176,39099,14253,508629,63567,618003,547728,,,,,0,0,0,0
1650441080.7457807,public.usertable,509043,63587,661692416,16782,public,usertable,1,0,1328045,2283661,548153,31185,39110,14259,509043,63587,618448,548153,,,,,0,0,0,0
1650441081.7751641,public.usertable,509464,63598,662224896,16782,public,usertable,1,0,1329121,2283977,548583,31190,39119,14262,509464,63598,618892,548583,,,,,0,0,0,0
1650441082.804414,public.usertable,509885,63614,662749184,16782,public,usertable,1,0,1330246,2284217,549015,31195,39130,14264,509885,63614,619340,549015,,,,,0,0,0,0
1650441083.8391867,public.usertable,510298,63626,663232512,16782,public,usertable,1,0,1331363,2284355,549433,31202,39135,14269,510298,63626,619770,549433,,,,,0,0,0,0
1650441084.8679366,public.usertable,510901,63642,663740416,16782,public,usertable,1,0,1332787,2285278,550050,31214,39149,14273,510901,63642,620413,550050,,,,,0,0,0,0
1650441085.897808,public.usertable,511291,63662,664231936,16782,public,usertable,1,0,1333811,2285622,550450,31225,39159,14280,511291,63662,620834,550450,,,,,0,0,0,0
1650441086.9268134,public.usertable,511709,63688,664764416,16782,public,usertable,1,0,1335060,2286135,550884,31238,39175,14286,511709,63688,621297,550884,,,,,0,0,0,0
1650441087.9557085,public.usertable,512085,63703,665231360,16782,public,usertable,1,0,1336162,2286731,551270,31247,39185,14291,512085,63703,621702,551270,,,,,0,0,0,0
1650441088.9860137,public.usertable,512452,63717,665690112,16782,public,usertable,1,0,1337116,2287621,551648,31253,39196,14293,512452,63717,622097,551648,,,,,0,0,0,0
1650441090.0169358,public.usertable,512852,63731,666181632,16782,public,usertable,1,0,1338259,2288068,552056,31259,39204,14296,512852,63731,622519,552056,,,,,0,0,0,0
1650441091.0487437,public.usertable,513233,63751,666664960,16782,public,usertable,1,0,1339307,2288845,552449,31267,39216,14299,513233,63751,622932,552449,,,,,0,0,0,0
1650441092.0811026,public.usertable,513580,63765,667115520,16782,public,usertable,1,0,1340361,2289902,552809,31272,39229,14303,513580,63765,623310,552809,,,,,0,0,0,0
1650441093.1094093,public.usertable,513978,63784,667598848,16782,public,usertable,1,0,1341404,2290560,553221,31277,39243,14305,513978,63784,623741,553221,,,,,0,0,0,0
1650441094.1378157,public.usertable,514357,63794,668090368,16782,public,usertable,1,0,1342426,2290824,553606,31283,39249,14308,514357,63794,624138,553606,,,,,0,0,0,0
1650441095.1683743,public.usertable,514776,63810,668614656,16782,public,usertable,1,0,1343499,2291263,554034,31293,39258,14314,514776,63810,624585,554034,,,,,0,0,0,0
1650441096.1974673,public.usertable,515170,63834,669089792,16782,public,usertable,1,0,1344583,2291483,554438,31307,39268,14323,515170,63834,625013,554438,,,,,0,0,0,0
1650441097.2278636,public.usertable,515568,63842,669573120,16782,public,usertable,1,0,1345765,2292106,554844,31316,39276,14329,515568,63842,625436,554844,,,,,0,0,0,0
1650441098.2582357,public.usertable,515916,63861,669999104,16782,public,usertable,1,0,1346797,2293880,555204,31327,39288,14336,515916,63861,625819,555204,,,,,0,0,0,0
1650441099.289698,public.usertable,516243,63866,670400512,16782,public,usertable,1,0,1347678,2294878,555539,31331,39296,14338,516243,63866,626166,555539,,,,,0,0,0,0
1650441100.3210516,public.usertable,516589,63886,670867456,16782,public,usertable,1,0,1348654,2295888,555896,31342,39307,14344,516589,63886,626545,555896,,,,,0,0,0,0
1650441101.3495665,public.usertable,516985,63899,671367168,16782,public,usertable,1,0,1349735,2296351,556297,31350,39312,14346,516985,63899,626959,556297,,,,,0,0,0,0
1650441102.3790598,public.usertable,517392,63917,671858688,16782,public,usertable,1,0,1350773,2296943,556717,31357,39325,14348,517392,63917,627399,556717,,,,,0,0,0,0
1650441103.4079797,public.usertable,517981,63945,672350208,16782,public,usertable,1,0,1352299,2297454,557325,31367,39344,14355,517981,63945,628036,557325,,,,,0,0,0,0
1650441104.436419,public.usertable,518384,63967,672858112,16782,public,usertable,1,0,1353476,2298700,557743,31374,39359,14358,518384,63967,628476,557743,,,,,0,0,0,0
1650441105.4661276,public.usertable,518798,63989,673374208,16782,public,usertable,1,0,1354660,2299023,558171,31383,39373,14362,518798,63989,628927,558171,,,,,0,0,0,0
1650441106.4976988,public.usertable,519201,64004,673890304,16782,public,usertable,1,0,1355805,2299523,558585,31390,39384,14366,519201,64004,629359,558585,,,,,0,0,0,0
1650441107.5320137,public.usertable,519594,64022,674381824,16782,public,usertable,1,0,1356831,2300088,558993,31396,39399,14368,519594,64022,629788,558993,,,,,0,0,0,0
1650441108.5628524,public.usertable,520008,64039,674881536,16782,public,usertable,1,0,1357901,2300446,559416,31404,39408,14374,520008,64039,630228,559416,,,,,0,0,0,0
1650441109.5919654,public.usertable,520386,64061,675364864,16782,public,usertable,1,0,1359011,2300612,559805,31415,39419,14381,520386,64061,630639,559805,,,,,0,0,0,0
1650441110.621388,public.usertable,520779,64079,675848192,16782,public,usertable,1,0,1360190,2301069,560212,31422,39433,14385,520779,64079,631067,560212,,,,,0,0,0,0
1650441111.6516705,public.usertable,521161,64093,676339712,16782,public,usertable,1,0,1361218,2301560,560606,31427,39445,14386,521161,64093,631478,560606,,,,,0,0,0,0
1650441112.6830847,public.usertable,521577,64109,676864000,16782,public,usertable,1,0,1362365,2302311,561035,31431,39458,14389,521577,64109,631924,561035,,,,,0,0,0,0
1650441113.7134254,public.usertable,521956,64135,677330944,16782,public,usertable,1,0,1363517,2302811,561427,31444,39471,14394,521956,64135,632342,561427,,,,,0,0,0,0
1650441114.7473643,public.usertable,522330,64157,677806080,16782,public,usertable,1,0,1364743,2304097,561812,31456,39482,14401,522330,64157,632750,561812,,,,,0,0,0,0
1650441115.7757428,public.usertable,522729,64176,678297600,16782,public,usertable,1,0,1365821,2304325,562218,31468,39489,14406,522729,64176,633175,562218,,,,,0,0,0,0
1650441116.804737,public.usertable,523115,64190,678789120,16782,public,usertable,1,0,1366829,2305247,562614,31475,39499,14409,523115,64190,633588,562614,,,,,0,0,0,0
1650441117.8337142,public.usertable,523506,64213,679247872,16782,public,usertable,1,0,1367882,2305486,563019,31487,39513,14413,523506,64213,634019,563019,,,,,0,0,0,0
1650441118.8618197,public.usertable,523868,64225,679731200,16782,public,usertable,1,0,1368817,2306693,563391,31494,39523,14415,523868,64225,634408,563391,,,,,0,0,0,0
1650441119.890084,public.usertable,524261,64228,680247296,16782,public,usertable,1,0,1369904,2307848,563793,31500,39532,14419,524261,64228,634825,563793,,,,,0,0,0,0
1650441120.919306,public.usertable,524698,64244,680763392,16782,public,usertable,1,0,1371075,2308394,564242,31509,39544,14423,524698,64244,635295,564242,,,,,0,0,0,0
1650441121.9498036,public.usertable,525297,64268,681263104,16782,public,usertable,1,0,1372589,2308941,564854,31520,39557,14430,525297,64268,635931,564854,,,,,0,0,0,0
1650441122.9788017,public.usertable,525655,64280,681697280,16782,public,usertable,1,0,1373545,2309245,565218,31527,39563,14435,525655,64280,636308,565218,,,,,0,0,0,0
1650441124.0073016,public.usertable,526045,64296,682180608,16782,public,usertable,1,0,1374629,2309679,565617,31534,39572,14440,526045,64296,636723,565617,,,,,0,0,0,0
1650441125.0362287,public.usertable,526452,64315,682696704,16782,public,usertable,1,0,1375617,2310484,566039,31542,39587,14443,526452,64315,637168,566039,,,,,0,0,0,0
1650441126.0654926,public.usertable,526887,64325,683229184,16782,public,usertable,1,0,1376816,2310898,566479,31547,39592,14447,526887,64325,637618,566479,,,,,0,0,0,0
1650441127.0958474,public.usertable,527317,64348,683769856,16782,public,usertable,1,0,1378047,2311573,566922,31558,39605,14449,527317,64348,638085,566922,,,,,0,0,0,0
1650441128.124621,public.usertable,527710,64366,684253184,16782,public,usertable,1,0,1379118,2311758,567324,31567,39614,14454,527710,64366,638505,567324,,,,,0,0,0,0
1650441129.155084,public.usertable,528086,64378,684728320,16782,public,usertable,1,0,1380208,2312257,567713,31572,39627,14457,528086,64378,638912,567713,,,,,0,0,0,0
1650441130.1842997,public.usertable,528470,64373,685154304,16782,public,usertable,1,0,1381210,2313573,568103,31576,39633,14458,528470,64373,639312,568103,,,,,0,0,0,0
1650441131.214341,public.usertable,528729,64388,685481984,16782,public,usertable,1,0,1381905,2313980,568370,31583,39641,14464,528729,64388,639594,568370,,,,,0,0,0,0
1650441132.243681,public.usertable,529044,64407,685883392,16782,public,usertable,1,0,1382862,2314451,568695,31592,39651,14469,529044,64407,639938,568695,,,,,0,0,0,0
1650441133.2731178,public.usertable,529321,64416,686211072,16782,public,usertable,1,0,1383631,2314943,568977,31596,39656,14471,529321,64416,640229,568977,,,,,0,0,0,0
1650441134.3026237,public.usertable,529569,64428,686546944,16782,public,usertable,1,0,1384297,2315316,569236,31601,39667,14473,529569,64428,640504,569236,,,,,0,0,0,0
1650441135.3333302,public.usertable,529845,64439,686891008,16782,public,usertable,1,0,1384980,2315468,569517,31607,39672,14477,529845,64439,640796,569517,,,,,0,0,0,0
1650441136.3624647,public.usertable,530116,64449,687218688,16782,public,usertable,1,0,1385658,2315674,569795,31614,39679,14479,530116,64449,641088,569795,,,,,0,0,0,0
1650441137.393274,public.usertable,530401,64462,687570944,16782,public,usertable,1,0,1386439,2315904,570085,31622,39684,14483,530401,64462,641391,570085,,,,,0,0,0,0
1650441138.4227324,public.usertable,530701,64472,687931392,16782,public,usertable,1,0,1387240,2316609,570392,31625,39691,14485,530701,64472,641708,570392,,,,,0,0,0,0
1650441139.4558177,public.usertable,531029,64482,688398336,16782,public,usertable,1,0,1388106,2316804,570724,31631,39695,14490,531029,64482,642050,570724,,,,,0,0,0,0
1650441140.4837313,public.usertable,531425,64500,688889856,16782,public,usertable,1,0,1389291,2317359,571137,31635,39712,14491,531425,64500,642484,571137,,,,,0,0,0,0
1650441141.513364,public.usertable,532010,64522,689373184,16782,public,usertable,1,0,1390996,2318096,571736,31645,39726,14498,532010,64522,643107,571736,,,,,0,0,0,0
1650441142.542186,public.usertable,532412,64545,689881088,16782,public,usertable,1,0,1392140,2318442,572154,31656,39742,14503,532412,64545,643552,572154,,,,,0,0,0,0
1650441143.575376,public.usertable,532814,64567,690380800,16782,public,usertable,1,0,1393349,2318595,572569,31665,39755,14508,532814,64567,643989,572569,,,,,0,0,0,0
1650441144.6048145,public.usertable,533175,64586,690823168,16782,public,usertable,1,0,1394398,2318998,572942,31674,39767,14514,533175,64586,644383,572942,,,,,0,0,0,0
1650441145.635323,public.usertable,533566,64607,691322880,16782,public,usertable,1,0,1395505,2319607,573343,31689,39777,14523,533566,64607,644809,573343,,,,,0,0,0,0
1650441146.66454,public.usertable,534004,64620,691863552,16782,public,usertable,1,0,1396703,2320101,573790,31694,39786,14525,534004,64620,645270,573790,,,,,0,0,0,0
1650441147.694103,public.usertable,534387,64633,692330496,16782,public,usertable,1,0,1397841,2320418,574183,31702,39796,14529,534387,64633,645681,574183,,,,,0,0,0,0
1650441148.7263658,public.usertable,534764,64648,692797440,16782,public,usertable,1,0,1398796,2320676,574571,31708,39807,14534,534764,64648,646086,574571,,,,,0,0,0,0
1650441149.7565653,public.usertable,535134,64663,693272576,16782,public,usertable,1,0,1400000,2321442,574955,31715,39821,14537,535134,64663,646491,574955,,,,,0,0,0,0
1650441150.7855103,public.usertable,535517,64675,693723136,16782,public,usertable,1,0,1401101,2322669,575345,31721,39828,14540,535517,64675,646894,575345,,,,,0,0,0,0
1650441151.817724,public.usertable,535871,64692,694173696,16782,public,usertable,1,0,1402171,2323353,575708,31730,39837,14545,535871,64692,647275,575708,,,,,0,0,0,0
1650441152.8489816,public.usertable,536244,64703,694648832,16782,public,usertable,1,0,1403168,2323931,576089,31733,39845,14547,536244,64703,647667,576089,,,,,0,0,0,0
1650441153.8778791,public.usertable,536604,64715,695083008,16782,public,usertable,1,0,1404224,2324463,576458,31740,39854,14549,536604,64715,648052,576458,,,,,0,0,0,0
1650441154.9071844,public.usertable,536975,64726,695541760,16782,public,usertable,1,0,1405248,2325159,576836,31750,39861,14553,536975,64726,648447,576836,,,,,0,0,0,0
1650441155.939969,public.usertable,537374,64744,696049664,16782,public,usertable,1,0,1406300,2325543,577244,31759,39870,14559,537374,64744,648873,577244,,,,,0,0,0,0
1650441156.9691377,public.usertable,537762,64761,696524800,16782,public,usertable,1,0,1407349,2326309,577643,31765,39881,14561,537762,64761,649289,577643,,,,,0,0,0,0
1650441158.000666,public.usertable,538142,64776,696999936,16782,public,usertable,1,0,1408297,2326885,578032,31773,39890,14566,538142,64776,649695,578032,,,,,0,0,0,0
1650441159.03103,public.usertable,538526,64788,697475072,16782,public,usertable,1,0,1409202,2327510,578423,31782,39897,14567,538526,64788,650102,578423,,,,,0,0,0,0
1650441160.0605295,public.usertable,538914,64801,697982976,16782,public,usertable,1,0,1410175,2328125,578818,31794,39904,14576,538914,64801,650516,578818,,,,,0,0,0,0
1650441161.0903986,public.usertable,539525,64821,698482688,16782,public,usertable,1,0,1411921,2328235,579445,31798,39920,14577,539525,64821,651163,579445,,,,,0,0,0,0
1650441162.1199687,public.usertable,539918,64834,698974208,16782,public,usertable,1,0,1412947,2329199,579845,31804,39927,14580,539918,64834,651576,579845,,,,,0,0,0,0
1650441163.149888,public.usertable,540336,64858,699490304,16782,public,usertable,1,0,1413988,2329806,580276,31816,39940,14585,540336,64858,652032,580276,,,,,0,0,0,0
1650441164.180482,public.usertable,540737,64871,699998208,16782,public,usertable,1,0,1415109,2330363,580686,31825,39949,14586,540737,64871,652460,580686,,,,,0,0,0,0
1650441165.208879,public.usertable,541138,64883,700514304,16782,public,usertable,1,0,1416197,2331124,581098,31834,39960,14591,541138,64883,652892,581098,,,,,0,0,0,0
1650441166.2404294,public.usertable,541565,64898,701038592,16782,public,usertable,1,0,1417314,2331779,581538,31839,39973,14593,541565,64898,653350,581538,,,,,0,0,0,0
1650441167.2696047,public.usertable,541949,64915,701513728,16782,public,usertable,1,0,1418428,2332259,581931,31848,39982,14598,541949,64915,653761,581931,,,,,0,0,0,0
1650441168.3029501,public.usertable,542326,64936,701980672,16782,public,usertable,1,0,1419515,2332604,582321,31857,39995,14605,542326,64936,654173,582321,,,,,0,0,0,0
1650441169.332539,public.usertable,542738,64947,702496768,16782,public,usertable,1,0,1420648,2333135,582741,31863,40003,14609,542738,64947,654607,582741,,,,,0,0,0,0
1650441170.3625743,public.usertable,543131,64967,702988288,16782,public,usertable,1,0,1421954,2333429,583152,31869,40021,14611,543131,64967,655042,583152,,,,,0,0,0,0
1650441171.3928468,public.usertable,543543,64984,703520768,16782,public,usertable,1,0,1422960,2333585,583572,31878,40029,14613,543543,64984,655479,583572,,,,,0,0,0,0
1650441172.4241872,public.usertable,543973,64998,704045056,16782,public,usertable,1,0,1424070,2333884,584012,31883,40039,14616,543973,64998,655934,584012,,,,,0,0,0,0
1650441173.4532542,public.usertable,544424,65008,704585728,16782,public,usertable,1,0,1425158,2334459,584471,31887,40047,14619,544424,65008,656405,584471,,,,,0,0,0,0
1650441174.4834604,public.usertable,544813,65022,705044480,16782,public,usertable,1,0,1426224,2335383,584867,31894,40054,14624,544813,65022,656815,584867,,,,,0,0,0,0
1650441175.512945,public.usertable,545182,65036,705511424,16782,public,usertable,1,0,1427249,2335525,585245,31899,40063,14626,545182,65036,657207,585245,,,,,0,0,0,0
1650441176.5442681,public.usertable,545565,65049,705986560,16782,public,usertable,1,0,1428279,2336152,585637,31904,40072,14629,545565,65049,657613,585637,,,,,0,0,0,0
1650441177.573263,public.usertable,545947,65064,706453504,16782,public,usertable,1,0,1429264,2336504,586026,31912,40079,14633,545947,65064,658017,586026,,,,,0,0,0,0
1650441178.6044157,public.usertable,546311,65077,706887680,16782,public,usertable,1,0,1430224,2337041,586400,31918,40089,14637,546311,65077,658407,586400,,,,,0,0,0,0
1650441179.6352732,public.usertable,546841,65103,707346432,16782,public,usertable,1,0,1431744,2337660,586946,31928,40105,14642,546841,65103,658979,586946,,,,,0,0,0,0
1650441180.6636183,public.usertable,547224,65118,707829760,16782,public,usertable,1,0,1432806,2337983,587343,31932,40119,14643,547224,65118,659394,587343,,,,,0,0,0,0
1650441181.6940773,public.usertable,547600,65132,708304896,16782,public,usertable,1,0,1433735,2338442,587727,31940,40127,14644,547600,65132,659794,587727,,,,,0,0,0,0
1650441182.7254739,public.usertable,547981,65148,708763648,16782,public,usertable,1,0,1434789,2338886,588115,31949,40134,14646,547981,65148,660198,588115,,,,,0,0,0,0
1650441183.755789,public.usertable,548330,65164,709222400,16782,public,usertable,1,0,1435819,2339359,588474,31961,40144,14652,548330,65164,660579,588474,,,,,0,0,0,0
1650441184.7856174,public.usertable,548675,65174,709623808,16782,public,usertable,1,0,1436688,2339417,588825,31965,40150,14653,548675,65174,660940,588825,,,,,0,0,0,0
1650441185.816472,public.usertable,549034,65182,710107136,16782,public,usertable,1,0,1437846,2339881,589194,31972,40160,14657,549034,65182,661326,589194,,,,,0,0,0,0
1650441186.846734,public.usertable,549426,65203,710590464,16782,public,usertable,1,0,1438965,2340320,589601,31982,40175,14663,549426,65203,661758,589601,,,,,0,0,0,0
1650441187.8762703,public.usertable,549779,65214,710983680,16782,public,usertable,1,0,1439950,2341079,589958,31991,40179,14670,549779,65214,662128,589958,,,,,0,0,0,0
1650441188.905455,public.usertable,550074,65223,711352320,16782,public,usertable,1,0,1440720,2341564,590262,31994,40188,14672,550074,65223,662444,590262,,,,,0,0,0,0
1650441189.939108,public.usertable,550399,65230,711802880,16782,public,usertable,1,0,1441578,2342141,590590,31999,40191,14674,550399,65230,662780,590590,,,,,0,0,0,0
1650441190.972004,public.usertable,550826,65244,712318976,16782,public,usertable,1,0,1442791,2342323,591025,32005,40199,14677,550826,65244,663229,591025,,,,,0,0,0,0
1650441192.0047097,public.usertable,551237,65263,712835072,16782,public,usertable,1,0,1443831,2342575,591447,32014,40210,14682,551237,65263,663671,591447,,,,,0,0,0,0
1650441193.0361664,public.usertable,551631,65281,713326592,16782,public,usertable,1,0,1444917,2343126,591851,32024,40220,14686,551631,65281,664095,591851,,,,,0,0,0,0
1650441194.066213,public.usertable,552036,65298,713842688,16782,public,usertable,1,0,1445978,2343522,592268,32030,40232,14690,552036,65298,664530,592268,,,,,0,0,0,0
1650441195.0976005,public.usertable,552441,65309,714334208,16782,public,usertable,1,0,1447037,2344128,592678,32036,40237,14692,552441,65309,664951,592678,,,,,0,0,0,0
1650441196.1273227,public.usertable,552856,65327,714817536,16782,public,usertable,1,0,1448173,2344679,593102,32046,40246,14700,552856,65327,665394,593102,,,,,0,0,0,0
1650441197.1560988,public.usertable,553200,65340,715202560,16782,public,usertable,1,0,1449094,2345199,593454,32051,40254,14702,553200,65340,665759,593454,,,,,0,0,0,0
1650441198.185111,public.usertable,553672,65352,715595776,16782,public,usertable,1,0,1450385,2346011,593934,32057,40262,14706,553672,65352,666253,593934,,,,,0,0,0,0
1650441199.2155612,public.usertable,554004,65355,715997184,16782,public,usertable,1,0,1451191,2346611,594269,32060,40265,14708,554004,65355,666594,594269,,,,,0,0,0,0
1650441200.2450802,public.usertable,554268,65370,716349440,16782,public,usertable,1,0,1451996,2346707,594539,32069,40271,14713,554268,65370,666879,594539,,,,,0,0,0,0
1650441201.2731178,public.usertable,554592,65382,716734464,16782,public,usertable,1,0,1452793,2347110,594868,32076,40276,14717,554592,65382,667220,594868,,,,,0,0,0,0
1650441202.305376,public.usertable,554866,65391,717053952,16782,public,usertable,1,0,1453514,2347386,595147,32080,40281,14717,554866,65391,667508,595147,,,,,0,0,0,0
1650441203.3352149,public.usertable,555106,65397,717348864,16782,public,usertable,1,0,1454141,2347554,595393,32082,40287,14718,555106,65397,667762,595393,,,,,0,0,0,0
1650441204.3640478,public.usertable,555347,65406,717660160,16782,public,usertable,1,0,1454854,2348273,595639,32089,40292,14724,555347,65406,668020,595639,,,,,0,0,0,0
1650441205.3950462,public.usertable,555672,65417,718086144,16782,public,usertable,1,0,1455769,2349042,595971,32096,40299,14728,555672,65417,668366,595971,,,,,0,0,0,0
1650441206.4258378,public.usertable,556065,65432,718577664,16782,public,usertable,1,0,1456847,2349490,596374,32101,40309,14732,556065,65432,668784,596374,,,,,0,0,0,0
1650441207.4543128,public.usertable,556416,65439,718987264,16782,public,usertable,1,0,1457721,2349992,596732,32106,40316,14732,556416,65439,669154,596732,,,,,0,0,0,0
1650441208.4830856,public.usertable,556750,65456,719388672,16782,public,usertable,1,0,1458648,2350196,597077,32112,40327,14737,556750,65456,669516,597077,,,,,0,0,0,0
1650441209.51216,public.usertable,557069,65466,719798272,16782,public,usertable,1,0,1459491,2350223,597403,32115,40334,14740,557069,65466,669852,597403,,,,,0,0,0,0
1650441210.5415719,public.usertable,557391,65474,720175104,16782,public,usertable,1,0,1460381,2350931,597730,32120,40339,14743,557391,65474,670189,597730,,,,,0,0,0,0
1650441211.5710287,public.usertable,557650,65487,720486400,16782,public,usertable,1,0,1461113,2351143,597997,32125,40347,14744,557650,65487,670469,597997,,,,,0,0,0,0
1650441212.599677,public.usertable,557924,65495,720838656,16782,public,usertable,1,0,1461876,2351348,598277,32131,40353,14747,557924,65495,670761,598277,,,,,0,0,0,0
1650441213.6311588,public.usertable,558213,65507,721207296,16782,public,usertable,1,0,1462649,2351572,598574,32135,40361,14749,558213,65507,671070,598574,,,,,0,0,0,0
1650441214.6601584,public.usertable,558537,65523,721592320,16782,public,usertable,1,0,1463532,2352527,598906,32143,40369,14752,558537,65523,671418,598906,,,,,0,0,0,0
1650441215.6922703,public.usertable,558835,65530,722042880,16782,public,usertable,1,0,1464398,2352940,599212,32147,40377,14755,558835,65530,671736,599212,,,,,0,0,0,0
1650441216.7247238,public.usertable,559220,65546,722485248,16782,public,usertable,1,0,1465461,2353368,599605,32155,40385,14756,559220,65546,672145,599605,,,,,0,0,0,0
1650441217.7560434,public.usertable,559565,65563,722911232,16782,public,usertable,1,0,1466494,2353822,599961,32164,40396,14762,559565,65563,672521,599961,,,,,0,0,0,0
1650441218.784286,public.usertable,560091,65580,723353600,16782,public,usertable,1,0,1467931,2354347,600497,32175,40406,14769,560091,65580,673078,600497,,,,,0,0,0,0
1650441219.816379,public.usertable,560458,65590,723804160,16782,public,usertable,1,0,1468809,2354825,600873,32183,40415,14774,560458,65590,673471,600873,,,,,0,0,0,0
1650441220.8487263,public.usertable,560828,65607,724262912,16782,public,usertable,1,0,1469762,2355087,601252,32191,40424,14776,560828,65607,673867,601252,,,,,0,0,0,0
1650441221.8780215,public.usertable,561172,65625,724705280,16782,public,usertable,1,0,1470704,2355319,601603,32202,40431,14782,561172,65625,674236,601603,,,,,0,0,0,0
1650441222.9085712,public.usertable,561559,65643,725188608,16782,public,usertable,1,0,1471702,2355681,601998,32212,40439,14788,561559,65643,674649,601998,,,,,0,0,0,0
1650441223.9415388,public.usertable,561927,65659,725622784,16782,public,usertable,1,0,1472738,2356351,602377,32217,40450,14790,561927,65659,675044,602377,,,,,0,0,0,0
1650441224.9698482,public.usertable,562290,65667,726089728,16782,public,usertable,1,0,1473694,2357253,602744,32222,40454,14793,562290,65667,675420,602744,,,,,0,0,0,0
1650441226.0014648,public.usertable,562687,65685,726589440,16782,public,usertable,1,0,1474834,2358069,603159,32228,40472,14796,562687,65685,675859,603159,,,,,0,0,0,0
1650441227.0316672,public.usertable,563104,65686,727113728,16782,public,usertable,1,0,1475886,2358306,603581,32235,40477,14798,563104,65686,676293,603581,,,,,0,0,0,0
1650441228.0607352,public.usertable,563540,65697,727654400,16782,public,usertable,1,0,1477074,2358760,604026,32237,40486,14800,563540,65697,676749,604026,,,,,0,0,0,0
1650441229.0920763,public.usertable,563970,65708,728178688,16782,public,usertable,1,0,1478275,2359213,604469,32241,40499,14803,563970,65708,677209,604469,,,,,0,0,0,0
1650441230.1217315,public.usertable,564395,65724,728711168,16782,public,usertable,1,0,1479439,2359901,604907,32247,40512,14805,564395,65724,677666,604907,,,,,0,0,0,0
1650441231.1548634,public.usertable,564832,65742,729260032,16782,public,usertable,1,0,1480579,2360398,605352,32257,40520,14806,564832,65742,678129,605352,,,,,0,0,0,0
1650441232.1834621,public.usertable,565261,65763,729817088,16782,public,usertable,1,0,1481790,2361431,605796,32273,40535,14814,565261,65763,678604,605796,,,,,0,0,0,0
1650441233.2118487,public.usertable,565693,65776,730324992,16782,public,usertable,1,0,1482865,2361868,606236,32278,40543,14816,565693,65776,679057,606236,,,,,0,0,0,0
1650441234.2436419,public.usertable,566113,65789,730857472,16782,public,usertable,1,0,1484071,2362197,606664,32285,40551,14819,566113,65789,679500,606664,,,,,0,0,0,0
1650441235.2725537,public.usertable,566562,65806,731414528,16782,public,usertable,1,0,1485262,2362621,607120,32295,40558,14823,566562,65806,679973,607120,,,,,0,0,0,0
1650441236.3037732,public.usertable,566991,65825,731955200,16782,public,usertable,1,0,1486452,2362781,607560,32306,40569,14830,566991,65825,680435,607560,,,,,0,0,0,0
1650441237.3361871,public.usertable,567640,65844,732479488,16782,public,usertable,1,0,1488148,2363224,608223,32316,40583,14833,567640,65844,681122,608223,,,,,0,0,0,0
1650441238.3648405,public.usertable,568059,65855,732995584,16782,public,usertable,1,0,1489241,2363633,608647,32322,40588,14835,568059,65855,681557,608647,,,,,0,0,0,0
1650441239.395941,public.usertable,568469,65864,733503488,16782,public,usertable,1,0,1490343,2363980,609064,32326,40595,14838,568469,65864,681985,609064,,,,,0,0,0,0
1650441240.425402,public.usertable,568897,65878,734035968,16782,public,usertable,1,0,1491585,2364204,609502,32333,40605,14842,568897,65878,682440,609502,,,,,0,0,0,0
1650441241.454306,public.usertable,569318,65890,734560256,16782,public,usertable,1,0,1492714,2364775,609932,32337,40614,14843,569318,65890,682883,609932,,,,,0,0,0,0
1650441242.4891937,public.usertable,569739,65905,735068160,16782,public,usertable,1,0,1493779,2364967,610362,32343,40623,14846,569739,65905,683328,610362,,,,,0,0,0,0
1650441243.518178,public.usertable,570123,65917,735551488,16782,public,usertable,1,0,1494763,2365669,610752,32349,40629,14849,570123,65917,683730,610752,,,,,0,0,0,0
1650441244.5475342,public.usertable,570524,65932,736051200,16782,public,usertable,1,0,1495763,2366250,611161,32358,40637,14855,570524,65932,684156,611161,,,,,0,0,0,0
1650441245.5793831,public.usertable,570909,65951,736509952,16782,public,usertable,1,0,1496771,2366567,611561,32366,40652,14859,570909,65951,684579,611561,,,,,0,0,0,0
1650441246.609535,public.usertable,571301,65966,737034240,16782,public,usertable,1,0,1497948,2367265,611959,32376,40658,14863,571301,65966,684993,611959,,,,,0,0,0,0
1650441247.6386151,public.usertable,571718,65981,737550336,16782,public,usertable,1,0,1499100,2367819,612387,32385,40669,14867,571718,65981,685441,612387,,,,,0,0,0,0
1650441248.66747,public.usertable,572122,65998,738033664,16782,public,usertable,1,0,1500235,2368455,612802,32394,40680,14873,572122,65998,685876,612802,,,,,0,0,0,0
1650441249.6968243,public.usertable,572507,66014,738533376,16782,public,usertable,1,0,1501384,2368676,613199,32403,40692,14882,572507,66014,686294,613199,,,,,0,0,0,0
1650441250.7267745,public.usertable,572934,66033,739074048,16782,public,usertable,1,0,1502471,2369007,613637,32411,40703,14886,572934,66033,686751,613637,,,,,0,0,0,0
1650441251.756497,public.usertable,573369,66046,739590144,16782,public,usertable,1,0,1503664,2369310,614080,32422,40711,14892,573369,66046,687213,614080,,,,,0,0,0,0
1650441252.7860422,public.usertable,573765,66060,740081664,16782,public,usertable,1,0,1504773,2370175,614484,32430,40719,14896,573765,66060,687633,614484,,,,,0,0,0,0
1650441253.8153222,public.usertable,574181,66071,740597760,16782,public,usertable,1,0,1505885,2370275,614910,32433,40729,14898,574181,66071,688072,614910,,,,,0,0,0,0
1650441254.8471243,public.usertable,574809,66100,741122048,16782,public,usertable,1,0,1507669,2371285,615549,32453,40740,14911,574809,66100,688742,615549,,,,,0,0,0,0
1650441255.8764462,public.usertable,575237,66112,741646336,16782,public,usertable,1,0,1508896,2371480,615983,32459,40746,14915,575237,66112,689188,615983,,,,,0,0,0,0
1650441256.906369,public.usertable,575657,66132,742170624,16782,public,usertable,1,0,1510014,2372178,616417,32468,40760,14919,575657,66132,689645,616417,,,,,0,0,0,0
1650441257.9350688,public.usertable,576078,66150,742694912,16782,public,usertable,1,0,1511101,2372971,616852,32474,40774,14923,576078,66150,690100,616852,,,,,0,0,0,0
1650441258.9637327,public.usertable,576494,66173,743227392,16782,public,usertable,1,0,1512347,2373141,617277,32488,40783,14928,576494,66173,690548,617277,,,,,0,0,0,0
1650441259.994357,public.usertable,576957,66179,743792640,16782,public,usertable,1,0,1513533,2373724,617743,32493,40786,14930,576957,66179,691022,617743,,,,,0,0,0,0
1650441261.0249434,public.usertable,577409,66191,744341504,16782,public,usertable,1,0,1514666,2373790,618202,32498,40793,14932,577409,66191,691493,618202,,,,,0,0,0,0
1650441262.055411,public.usertable,577866,66206,744890368,16782,public,usertable,1,0,1515799,2374021,618664,32508,40798,14938,577866,66206,691970,618664,,,,,0,0,0,0
1650441263.0852118,public.usertable,578288,66217,745422848,16782,public,usertable,1,0,1516993,2374599,619093,32515,40805,14942,578288,66217,692413,619093,,,,,0,0,0,0
1650441264.1157053,public.usertable,578715,66226,745947136,16782,public,usertable,1,0,1518079,2375176,619529,32516,40814,14943,578715,66226,692859,619529,,,,,0,0,0,0
1650441265.1449718,public.usertable,579144,66242,746487808,16782,public,usertable,1,0,1519266,2375502,619967,32523,40823,14947,579144,66242,693313,619967,,,,,0,0,0,0
1650441266.174401,public.usertable,579612,66255,747053056,16782,public,usertable,1,0,1520397,2376317,620442,32531,40830,14949,579612,66255,693803,620442,,,,,0,0,0,0
1650441267.2055588,public.usertable,580062,66269,747601920,16782,public,usertable,1,0,1521644,2376929,620901,32540,40839,14953,580062,66269,694280,620901,,,,,0,0,0,0
1650441268.2347202,public.usertable,580480,66286,748134400,16782,public,usertable,1,0,1522782,2377465,621329,32548,40849,14958,580480,66286,694726,621329,,,,,0,0,0,0
1650441269.2651544,public.usertable,580894,66309,748650496,16782,public,usertable,1,0,1523953,2378511,621757,32557,40863,14964,580894,66309,695177,621757,,,,,0,0,0,0
1650441270.298906,public.usertable,581313,66319,749166592,16782,public,usertable,1,0,1525207,2378816,622184,32567,40871,14968,581313,66319,695622,622184,,,,,0,0,0,0
1650441271.327285,public.usertable,581728,66328,749666304,16782,public,usertable,1,0,1526293,2379429,622607,32571,40879,14972,581728,66328,696057,622607,,,,,0,0,0,0
1650441272.3559344,public.usertable,582148,66340,750182400,16782,public,usertable,1,0,1527424,2379685,623032,32578,40884,14975,582148,66340,696494,623032,,,,,0,0,0,0
1650441273.3855393,public.usertable,582755,66361,750690304,16782,public,usertable,1,0,1529080,2380848,623655,32585,40900,14980,582755,66361,697140,623655,,,,,0,0,0,0
1650441274.415459,public.usertable,583197,66378,751239168,16782,public,usertable,1,0,1530269,2381215,624108,32595,40911,14983,583197,66378,697614,624108,,,,,0,0,0,0
1650441275.446982,public.usertable,583644,66392,751788032,16782,public,usertable,1,0,1531503,2381848,624563,32605,40919,14989,583644,66392,698087,624563,,,,,0,0,0,0
1650441276.4760692,public.usertable,584036,66403,752279552,16782,public,usertable,1,0,1532655,2382769,624963,32612,40927,14993,584036,66403,698502,624963,,,,,0,0,0,0
1650441277.507817,public.usertable,584474,66419,752812032,16782,public,usertable,1,0,1533688,2382918,625410,32619,40936,14998,584474,66419,698965,625410,,,,,0,0,0,0
1650441278.5361452,public.usertable,584893,66428,753328128,16782,public,usertable,1,0,1534855,2383329,625835,32623,40942,15000,584893,66428,699400,625835,,,,,0,0,0,0
1650441279.565934,public.usertable,585311,66438,753852416,16782,public,usertable,1,0,1536063,2383753,626259,32631,40948,15002,585311,66438,699838,626259,,,,,0,0,0,0
1650441280.596611,public.usertable,585740,66453,754393088,16782,public,usertable,1,0,1537216,2383872,626694,32640,40954,15006,585740,66453,700288,626694,,,,,0,0,0,0
1650441281.6260138,public.usertable,586136,66466,754876416,16782,public,usertable,1,0,1538277,2384801,627101,32646,40965,15008,586136,66466,700712,627101,,,,,0,0,0,0
1650441282.6568,public.usertable,586574,66476,755408896,16782,public,usertable,1,0,1539432,2385578,627546,32650,40972,15010,586574,66476,701168,627546,,,,,0,0,0,0
1650441283.6849594,public.usertable,587004,66488,755924992,16782,public,usertable,1,0,1540635,2386085,627982,32656,40978,15013,587004,66488,701616,627982,,,,,0,0,0,0
1650441284.715469,public.usertable,587411,66500,756449280,16782,public,usertable,1,0,1541779,2386922,628397,32662,40986,15015,587411,66500,702045,628397,,,,,0,0,0,0
1650441285.7471726,public.usertable,587831,66506,756948992,16782,public,usertable,1,0,1542992,2387560,628821,32668,40990,15019,587831,66506,702479,628821,,,,,0,0,0,0
1650441286.777927,public.usertable,588252,66514,757497856,16782,public,usertable,1,0,1544135,2387891,629249,32675,40997,15024,588252,66514,702921,629249,,,,,0,0,0,0
1650441287.8081937,public.usertable,588661,66527,757964800,16782,public,usertable,1,0,1545310,2388075,629666,32680,41005,15027,588661,66527,703351,629666,,,,,0,0,0,0
1650441288.8384378,public.usertable,589020,66548,758382592,16782,public,usertable,1,0,1546395,2388633,630039,32690,41019,15031,589020,66548,703748,630039,,,,,0,0,0,0
1650441289.8671637,public.usertable,589359,66548,758833152,16782,public,usertable,1,0,1547293,2388905,630381,32693,41022,15033,589359,66548,704096,630381,,,,,0,0,0,0
1650441290.898528,public.usertable,589743,66558,759283712,16782,public,usertable,1,0,1548402,2389302,630774,32697,41031,15033,589743,66558,704502,630774,,,,,0,0,0,0
1650441291.9274638,public.usertable,590304,66573,759750656,16782,public,usertable,1,0,1549861,2390999,631342,32706,41038,15038,590304,66573,705086,631342,,,,,0,0,0,0
1650441292.958691,public.usertable,590669,66583,760201216,16782,public,usertable,1,0,1550890,2391830,631712,32714,41043,15043,590669,66583,705469,631712,,,,,0,0,0,0
1650441293.9876254,public.usertable,591017,66598,760643584,16782,public,usertable,1,0,1551826,2392082,632073,32718,41056,15045,591017,66598,705847,632073,,,,,0,0,0,0
1650441295.0170727,public.usertable,591326,66609,761020416,16782,public,usertable,1,0,1552620,2392424,632387,32724,41061,15050,591326,66609,706172,632387,,,,,0,0,0,0
1650441296.048042,public.usertable,591733,66619,761511936,16782,public,usertable,1,0,1553747,2392679,632800,32728,41067,15053,591733,66619,706595,632800,,,,,0,0,0,0
1650441297.0791783,public.usertable,592122,66638,762003456,16782,public,usertable,1,0,1554877,2393537,633200,32745,41078,15062,592122,66638,707023,633200,,,,,0,0,0,0
1650441298.1101284,public.usertable,592538,66658,762544128,16782,public,usertable,1,0,1555994,2393808,633628,32754,41090,15064,592538,66658,707472,633628,,,,,0,0,0,0
1650441299.1397414,public.usertable,592974,66671,763084800,16782,public,usertable,1,0,1557076,2394201,634073,32758,41099,15067,592974,66671,707930,634073,,,,,0,0,0,0
1650441300.1730301,public.usertable,593418,66677,763617280,16782,public,usertable,1,0,1558169,2394675,634526,32762,41108,15070,593418,66677,708396,634526,,,,,0,0,0,0
1650441301.2063038,public.usertable,593833,66687,764125184,16782,public,usertable,1,0,1559371,2395208,634948,32767,41115,15071,593833,66687,708830,634948,,,,,0,0,0,0
1650441302.238235,public.usertable,594239,66704,764649472,16782,public,usertable,1,0,1560482,2395471,635365,32773,41126,15074,594239,66704,709264,635365,,,,,0,0,0,0
1650441303.2695475,public.usertable,594669,66718,765173760,16782,public,usertable,1,0,1561670,2396139,635805,32777,41136,15076,594669,66718,709718,635805,,,,,0,0,0,0
1650441304.299752,public.usertable,595068,66734,765673472,16782,public,usertable,1,0,1562717,2396821,636216,32782,41148,15079,595068,66734,710146,636216,,,,,0,0,0,0
1650441305.3309927,public.usertable,595492,66747,766181376,16782,public,usertable,1,0,1563811,2397060,636650,32787,41158,15082,595492,66747,710595,636650,,,,,0,0,0,0
1650441306.3602881,public.usertable,595893,66760,766681088,16782,public,usertable,1,0,1565051,2397759,637059,32792,41166,15084,595893,66760,711017,637059,,,,,0,0,0,0
1650441307.3891618,public.usertable,596261,66779,767172608,16782,public,usertable,1,0,1566149,2398017,637438,32800,41177,15086,596261,66779,711415,637438,,,,,0,0,0,0
1650441308.418068,public.usertable,596679,66789,767672320,16782,public,usertable,1,0,1567334,2398754,637863,32806,41184,15089,596679,66789,711853,637863,,,,,0,0,0,0
1650441309.4468126,public.usertable,597098,66807,768221184,16782,public,usertable,1,0,1568520,2399274,638294,32812,41196,15092,597098,66807,712302,638294,,,,,0,0,0,0
1650441310.4769826,public.usertable,597768,66830,768761856,16782,public,usertable,1,0,1570176,2400055,638974,32825,41206,15104,597768,66830,713005,638974,,,,,0,0,0,0
1650441311.5056806,public.usertable,598176,66842,769269760,16782,public,usertable,1,0,1571289,2400406,639391,32832,41215,15107,598176,66842,713438,639391,,,,,0,0,0,0
1650441312.5347807,public.usertable,598600,66860,769785856,16782,public,usertable,1,0,1572364,2400888,639819,32846,41219,15111,598600,66860,713884,639819,,,,,0,0,0,0
1650441313.5643876,public.usertable,599015,66871,770293760,16782,public,usertable,1,0,1573472,2401161,640242,32849,41227,15113,599015,66871,714318,640242,,,,,0,0,0,0
1650441314.5927808,public.usertable,599432,66882,770818048,16782,public,usertable,1,0,1574525,2401818,640665,32856,41233,15116,599432,66882,714754,640665,,,,,0,0,0,0
1650441315.621737,public.usertable,599867,66901,771350528,16782,public,usertable,1,0,1575623,2402013,641107,32868,41240,15121,599867,66901,715215,641107,,,,,0,0,0,0
1650441316.6516404,public.usertable,600290,66910,771874816,16782,public,usertable,1,0,1576805,2402736,641537,32870,41247,15122,600290,66910,715654,641537,,,,,0,0,0,0
1650441317.6817229,public.usertable,600718,66920,772399104,16782,public,usertable,1,0,1577957,2403205,641973,32874,41255,15125,600718,66920,716102,641973,,,,,0,0,0,0
1650441318.7110202,public.usertable,601141,66932,772923392,16782,public,usertable,1,0,1579131,2403802,642400,32882,41259,15128,601141,66932,716541,642400,,,,,0,0,0,0
1650441319.740893,public.usertable,601565,66941,773439488,16782,public,usertable,1,0,1580340,2404228,642834,32892,41269,15136,601565,66941,716995,642834,,,,,0,0,0,0
1650441320.7713566,public.usertable,601986,66956,773947392,16782,public,usertable,1,0,1581466,2404433,643265,32900,41279,15141,601986,66956,717444,643265,,,,,0,0,0,0
1650441321.8009896,public.usertable,602386,66970,774463488,16782,public,usertable,1,0,1582660,2404776,643673,32909,41287,15145,602386,66970,717869,643673,,,,,0,0,0,0
1650441322.8294878,public.usertable,602808,66982,774971392,16782,public,usertable,1,0,1583804,2405044,644100,32916,41292,15148,602808,66982,718308,644100,,,,,0,0,0,0
1650441323.8605125,public.usertable,603215,67005,775471104,16782,public,usertable,1,0,1585008,2405679,644522,32929,41307,15153,603215,67005,718758,644522,,,,,0,0,0,0
1650441324.8900971,public.usertable,603587,67014,775921664,16782,public,usertable,1,0,1585986,2405941,644902,32934,41315,15156,603587,67014,719151,644902,,,,,0,0,0,0
1650441325.9196725,public.usertable,603950,67016,776372224,16782,public,usertable,1,0,1586960,2406424,645269,32935,41319,15157,603950,67016,719523,645269,,,,,0,0,0,0
1650441326.9489622,public.usertable,604350,67023,776871936,16782,public,usertable,1,0,1588062,2406712,645677,32939,41327,15157,604350,67023,719943,645677,,,,,0,0,0,0
1650441327.9803376,public.usertable,604704,67033,777289728,16782,public,usertable,1,0,1589023,2407114,646037,32945,41333,15159,604704,67033,720315,646037,,,,,0,0,0,0
1650441329.0096989,public.usertable,605177,67051,777666560,16782,public,usertable,1,0,1590342,2407352,646520,32953,41343,15164,605177,67051,720816,646520,,,,,0,0,0,0
1650441330.0394294,public.usertable,605515,67056,778076160,16782,public,usertable,1,0,1591145,2407606,646865,32953,41350,15164,605515,67056,721168,646865,,,,,0,0,0,0
1650441331.0678964,public.usertable,605823,67061,778469376,16782,public,usertable,1,0,1592063,2408139,647182,32956,41359,15166,605823,67061,721497,647182,,,,,0,0,0,0
1650441332.0960104,public.usertable,606202,67071,778936320,16782,public,usertable,1,0,1593120,2408422,647568,32959,41366,15166,606202,67071,721893,647568,,,,,0,0,0,0
1650441333.1257331,public.usertable,606651,67084,779493376,16782,public,usertable,1,0,1594313,2409085,648022,32967,41371,15168,606651,67084,722360,648022,,,,,0,0,0,0
1650441334.1546972,public.usertable,607086,67093,780025856,16782,public,usertable,1,0,1595446,2409660,648465,32970,41379,15170,607086,67093,722814,648465,,,,,0,0,0,0
1650441335.1866167,public.usertable,607509,67107,780541952,16782,public,usertable,1,0,1596530,2409962,648895,32977,41386,15173,607509,67107,723258,648895,,,,,0,0,0,0
1650441336.2160702,public.usertable,607910,67123,781041664,16782,public,usertable,1,0,1597568,2410463,649310,32984,41400,15179,607910,67123,723694,649310,,,,,0,0,0,0
1650441337.2456956,public.usertable,608319,67134,781549568,16782,public,usertable,1,0,1598759,2410924,649727,32990,41408,15180,608319,67134,724125,649727,,,,,0,0,0,0
1650441338.2752683,public.usertable,608694,67144,781975552,16782,public,usertable,1,0,1599743,2411444,650107,32995,41413,15182,608694,67144,724515,650107,,,,,0,0,0,0
1650441339.304026,public.usertable,609087,67151,782467072,16782,public,usertable,1,0,1600806,2411729,650502,33000,41415,15184,609087,67151,724917,650502,,,,,0,0,0,0
1650441340.3324373,public.usertable,609492,67168,782974976,16782,public,usertable,1,0,1602056,2412396,650920,33009,41428,15189,609492,67168,725357,650920,,,,,0,0,0,0
1650441341.3611324,public.usertable,609923,67177,783523840,16782,public,usertable,1,0,1603210,2413235,651363,33012,41440,15190,609923,67177,725815,651363,,,,,0,0,0,0
1650441342.3919513,public.usertable,610351,67192,784039936,16782,public,usertable,1,0,1604413,2413462,651798,33020,41447,15195,610351,67192,726265,651798,,,,,0,0,0,0
1650441343.4237633,public.usertable,610786,67202,784580608,16782,public,usertable,1,0,1605601,2413990,652242,33026,41456,15197,610786,67202,726724,652242,,,,,0,0,0,0
1650441344.4542682,public.usertable,611183,67210,785055744,16782,public,usertable,1,0,1606703,2414519,652647,33034,41464,15203,611183,67210,727145,652647,,,,,0,0,0,0
1650441345.4863806,public.usertable,611592,67222,785580032,16782,public,usertable,1,0,1607858,2414824,653061,33043,41469,15210,611592,67222,727573,653061,,,,,0,0,0,0
1650441346.5167782,public.usertable,611987,67241,786087936,16782,public,usertable,1,0,1608990,2415086,653466,33053,41479,15216,611987,67241,727998,653466,,,,,0,0,0,0
1650441347.5473416,public.usertable,612442,67248,786636800,16782,public,usertable,1,0,1610138,2415366,653924,33058,41482,15220,612442,67248,728464,653924,,,,,0,0,0,0
1650441348.5778155,public.usertable,613087,67269,787161088,16782,public,usertable,1,0,1612009,2416528,654579,33071,41492,15227,613087,67269,729142,654579,,,,,0,0,0,0
1650441349.6087139,public.usertable,613518,67277,787693568,16782,public,usertable,1,0,1613184,2417021,655015,33080,41497,15231,613518,67277,729592,655015,,,,,0,0,0,0
1650441350.6374924,public.usertable,613947,67299,788226048,16782,public,usertable,1,0,1614366,2417376,655456,33090,41509,15238,613947,67299,730055,655456,,,,,0,0,0,0
1650441351.6689913,public.usertable,614387,67303,788766720,16782,public,usertable,1,0,1615504,2418024,655903,33095,41516,15240,614387,67303,730514,655903,,,,,0,0,0,0
1650441352.697817,public.usertable,614796,67320,789282816,16782,public,usertable,1,0,1616861,2418810,656324,33105,41528,15247,614796,67320,730957,656324,,,,,0,0,0,0
1650441353.7273319,public.usertable,615218,67335,789790720,16782,public,usertable,1,0,1618049,2419017,656757,33109,41539,15248,615218,67335,731405,656757,,,,,0,0,0,0
1650441354.7562187,public.usertable,615651,67346,790323200,16782,public,usertable,1,0,1619276,2419674,657195,33117,41544,15251,615651,67346,731856,657195,,,,,0,0,0,0
1650441355.788387,public.usertable,616056,67364,790831104,16782,public,usertable,1,0,1620393,2420310,657614,33123,41558,15254,616056,67364,732295,657614,,,,,0,0,0,0
1650441356.8202522,public.usertable,616490,67369,791371776,16782,public,usertable,1,0,1621389,2420556,658057,33126,41567,15257,616490,67369,732750,658057,,,,,0,0,0,0
1650441357.8510833,public.usertable,616909,67383,791896064,16782,public,usertable,1,0,1622525,2420958,658482,33134,41573,15260,616909,67383,733189,658482,,,,,0,0,0,0
1650441358.8814795,public.usertable,617322,67393,792354816,16782,public,usertable,1,0,1623680,2421355,658902,33141,41580,15264,617322,67393,733623,658902,,,,,0,0,0,0
1650441359.9111462,public.usertable,617690,67402,792821760,16782,public,usertable,1,0,1624793,2421703,659276,33147,41586,15267,617690,67402,734009,659276,,,,,0,0,0,0
1650441360.9394596,public.usertable,618015,67415,793239552,16782,public,usertable,1,0,1625710,2422171,659609,33152,41594,15267,618015,67415,734355,659609,,,,,0,0,0,0
1650441361.968521,public.usertable,618395,67429,793657344,16782,public,usertable,1,0,1626769,2422333,659996,33159,41601,15270,618395,67429,734756,659996,,,,,0,0,0,0
1650441362.9991834,public.usertable,618690,67437,794025984,16782,public,usertable,1,0,1627601,2422546,660295,33163,41605,15273,618690,67437,735063,660295,,,,,0,0,0,0
1650441364.0306263,public.usertable,618950,67448,794353664,16782,public,usertable,1,0,1628354,2422743,660560,33169,41610,15274,618950,67448,735339,660560,,,,,0,0,0,0
1650441365.0619824,public.usertable,619234,67462,794714112,16782,public,usertable,1,0,1629165,2423736,660851,33176,41617,15279,619234,67462,735644,660851,,,,,0,0,0,0
1650441366.0911808,public.usertable,619549,67476,795189248,16782,public,usertable,1,0,1630027,2423940,661178,33179,41629,15280,619549,67476,735986,661178,,,,,0,0,0,0
1650441367.121639,public.usertable,619989,67491,795721728,16782,public,usertable,1,0,1631251,2424360,661627,33186,41638,15285,619989,67491,736451,661627,,,,,0,0,0,0
1650441368.1513674,public.usertable,620620,67500,796237824,16782,public,usertable,1,0,1633074,2424933,662265,33192,41645,15290,620620,67500,737102,662265,,,,,0,0,0,0
1650441369.1823924,public.usertable,621016,67513,796729344,16782,public,usertable,1,0,1634077,2425489,662673,33195,41657,15292,621016,67513,737525,662673,,,,,0,0,0,0
1650441370.2168322,public.usertable,621460,67522,797286400,16782,public,usertable,1,0,1635326,2425871,663126,33202,41666,15296,621460,67522,737994,663126,,,,,0,0,0,0
1650441371.2457469,public.usertable,621898,67542,797827072,16782,public,usertable,1,0,1636369,2426222,663574,33212,41676,15299,621898,67542,738462,663574,,,,,0,0,0,0
1650441372.278042,public.usertable,622319,67555,798351360,16782,public,usertable,1,0,1637574,2426448,664007,33216,41688,15302,622319,67555,738911,664007,,,,,0,0,0,0
1650441373.3079634,public.usertable,622750,67566,798883840,16782,public,usertable,1,0,1638768,2426621,664444,33224,41694,15306,622750,67566,739362,664444,,,,,0,0,0,0
1650441374.336624,public.usertable,623187,67583,799424512,16782,public,usertable,1,0,1639855,2426910,664890,33234,41703,15312,623187,67583,739827,664890,,,,,0,0,0,0
1650441375.3669498,public.usertable,623608,67593,799932416,16782,public,usertable,1,0,1640909,2427101,665315,33240,41707,15317,623608,67593,740262,665315,,,,,0,0,0,0
1650441376.3960285,public.usertable,624034,67606,800464896,16782,public,usertable,1,0,1642059,2428358,665748,33250,41714,15322,624034,67606,740712,665748,,,,,0,0,0,0
1650441377.4272814,public.usertable,624451,67617,800989184,16782,public,usertable,1,0,1643316,2428626,666174,33252,41723,15323,624451,67617,741149,666174,,,,,0,0,0,0
1650441378.4577963,public.usertable,624879,67625,801513472,16782,public,usertable,1,0,1644450,2429357,666611,33260,41732,15330,624879,67625,741603,666611,,,,,0,0,0,0
1650441379.487397,public.usertable,625316,67628,802045952,16782,public,usertable,1,0,1645706,2430134,667058,33263,41742,15333,625316,67628,742063,667058,,,,,0,0,0,0
1650441380.5171793,public.usertable,625754,67634,802578432,16782,public,usertable,1,0,1646886,2430752,667501,33267,41747,15335,625754,67634,742515,667501,,,,,0,0,0,0
1650441381.5465357,public.usertable,626175,67645,803102720,16782,public,usertable,1,0,1648005,2431346,667930,33270,41755,15338,626175,67645,742955,667930,,,,,0,0,0,0
1650441382.5773194,public.usertable,626609,67659,803643392,16782,public,usertable,1,0,1649085,2431688,668372,33276,41763,15340,626609,67659,743411,668372,,,,,0,0,0,0
1650441383.6082926,public.usertable,627040,67669,804175872,16782,public,usertable,1,0,1650343,2432692,668814,33282,41774,15344,627040,67669,743870,668814,,,,,0,0,0,0
1650441384.6412811,public.usertable,627473,67681,804716544,16782,public,usertable,1,0,1651421,2433093,669254,33287,41781,15346,627473,67681,744322,669254,,,,,0,0,0,0
1650441385.6709468,public.usertable,628121,67710,805249024,16782,public,usertable,1,0,1653289,2433753,669919,33301,41798,15355,628121,67710,745018,669919,,,,,0,0,0,0
1650441386.7018936,public.usertable,628601,67720,805838848,16782,public,usertable,1,0,1654583,2434006,670406,33307,41805,15358,628601,67720,745518,670406,,,,,0,0,0,0
1650441387.732757,public.usertable,629058,67730,806395904,16782,public,usertable,1,0,1655706,2434183,670867,33313,41809,15361,629058,67730,745989,670867,,,,,0,0,0,0
1650441388.764643,public.usertable,629484,67747,806928384,16782,public,usertable,1,0,1656795,2434335,671304,33322,41820,15367,629484,67747,746446,671304,,,,,0,0,0,0
1650441389.7928267,public.usertable,629913,67764,807469056,16782,public,usertable,1,0,1658002,2434701,671744,33328,41831,15371,629913,67764,746903,671744,,,,,0,0,0,0
1650441390.8245792,public.usertable,630346,67775,807985152,16782,public,usertable,1,0,1659245,2434896,672186,33330,41840,15372,630346,67775,747356,672186,,,,,0,0,0,0
1650441391.8541605,public.usertable,630795,67786,808534016,16782,public,usertable,1,0,1660445,2435352,672643,33337,41848,15378,630795,67786,747828,672643,,,,,0,0,0,0
1650441392.8826282,public.usertable,631229,67790,809066496,16782,public,usertable,1,0,1661622,2436004,673083,33339,41854,15379,631229,67790,748276,673083,,,,,0,0,0,0
1650441393.9117417,public.usertable,631664,67802,809598976,16782,public,usertable,1,0,1662850,2436577,673526,33343,41862,15380,631664,67802,748731,673526,,,,,0,0,0,0
1650441394.9410746,public.usertable,632087,67815,810123264,16782,public,usertable,1,0,1664115,2436834,673956,33349,41869,15384,632087,67815,749174,673956,,,,,0,0,0,0
1650441395.971687,public.usertable,632541,67822,810663936,16782,public,usertable,1,0,1665265,2437444,674415,33351,41874,15385,632541,67822,749640,674415,,,,,0,0,0,0
1650441397.0018084,public.usertable,632952,67833,811180032,16782,public,usertable,1,0,1666537,2438105,674836,33355,41884,15386,632952,67833,750075,674836,,,,,0,0,0,0
1650441398.0312269,public.usertable,633367,67852,811704320,16782,public,usertable,1,0,1667720,2438954,675266,33361,41899,15389,633367,67852,750526,675266,,,,,0,0,0,0
1650441399.0608304,public.usertable,633785,67868,812171264,16782,public,usertable,1,0,1668757,2439433,675689,33372,41904,15393,633785,67868,750965,675689,,,,,0,0,0,0
1650441400.0916204,public.usertable,634168,67876,812662784,16782,public,usertable,1,0,1669770,2440295,676077,33375,41909,15395,634168,67876,751361,676077,,,,,0,0,0,0
1650441401.1211903,public.usertable,634557,67892,813170688,16782,public,usertable,1,0,1670838,2440824,676476,33383,41919,15398,634557,67892,751778,676476,,,,,0,0,0,0
1650441402.1517043,public.usertable,634966,67892,813604864,16782,public,usertable,1,0,1671738,2441735,676889,33388,41923,15401,634966,67892,752200,676889,,,,,0,0,0,0
1650441403.1819215,public.usertable,635334,67899,814080000,16782,public,usertable,1,0,1672722,2441907,677261,33393,41927,15405,635334,67899,752581,677261,,,,,0,0,0,0
1650441404.2103336,public.usertable,635803,67921,814456832,16782,public,usertable,1,0,1674016,2442510,677741,33404,41938,15412,635803,67921,753083,677741,,,,,0,0,0,0
1650441405.239601,public.usertable,636179,67936,814923776,16782,public,usertable,1,0,1675076,2443241,678130,33406,41951,15412,636179,67936,753487,678130,,,,,0,0,0,0
1650441406.2681322,public.usertable,636600,67948,815439872,16782,public,usertable,1,0,1676201,2443464,678558,33413,41958,15418,636600,67948,753929,678558,,,,,0,0,0,0
1650441407.2983747,public.usertable,637026,67963,815980544,16782,public,usertable,1,0,1677369,2443996,678996,33416,41970,15420,637026,67963,754382,678996,,,,,0,0,0,0
1650441408.3298757,public.usertable,637466,67974,816513024,16782,public,usertable,1,0,1678453,2444291,679440,33424,41974,15424,637466,67974,754838,679440,,,,,0,0,0,0
1650441409.3591802,public.usertable,637908,67987,817061888,16782,public,usertable,1,0,1679707,2444695,679889,33432,41981,15429,637908,67987,755302,679889,,,,,0,0,0,0
1650441410.3901973,public.usertable,638366,68001,817610752,16782,public,usertable,1,0,1681054,2445319,680357,33439,41991,15431,638366,68001,755787,680357,,,,,0,0,0,0
1650441411.4217114,public.usertable,638786,68017,818151424,16782,public,usertable,1,0,1682307,2446085,680785,33447,41999,15436,638786,68017,756231,680785,,,,,0,0,0,0
1650441412.4513602,public.usertable,639230,68032,818675712,16782,public,usertable,1,0,1683440,2446439,681242,33454,42012,15442,639230,68032,756708,681242,,,,,0,0,0,0
1650441413.4801407,public.usertable,639662,68047,819232768,16782,public,usertable,1,0,1684672,2446890,681682,33461,42020,15445,639662,68047,757163,681682,,,,,0,0,0,0
1650441414.511292,public.usertable,640106,68063,819765248,16782,public,usertable,1,0,1685785,2447164,682137,33466,42031,15448,640106,68063,757634,682137,,,,,0,0,0,0
1650441415.5410416,public.usertable,640530,68073,820289536,16782,public,usertable,1,0,1686996,2447631,682567,33475,42037,15451,640530,68073,758079,682567,,,,,0,0,0,0
1650441416.5700974,public.usertable,640946,68079,820805632,16782,public,usertable,1,0,1688108,2448113,682990,33476,42044,15452,640946,68079,758510,682990,,,,,0,0,0,0
1650441417.6018226,public.usertable,641407,68087,821362688,16782,public,usertable,1,0,1689309,2448529,683457,33480,42050,15453,641407,68087,758987,683457,,,,,0,0,0,0
1650441418.6329782,public.usertable,641836,68096,821903360,16782,public,usertable,1,0,1690478,2448760,683893,33484,42057,15456,641836,68096,759434,683893,,,,,0,0,0,0
1650441419.664105,public.usertable,642266,68110,822419456,16782,public,usertable,1,0,1691659,2449366,684330,33492,42064,15461,642266,68110,759886,684330,,,,,0,0,0,0
1650441420.6942086,public.usertable,642691,68122,822951936,16782,public,usertable,1,0,1692806,2449737,684761,33498,42070,15463,642691,68122,760329,684761,,,,,0,0,0,0
1650441421.725203,public.usertable,643128,68128,823484416,16782,public,usertable,1,0,1693799,2450123,685201,33504,42073,15467,643128,68128,760778,685201,,,,,0,0,0,0
1650441422.7550435,public.usertable,643761,68143,823992320,16782,public,usertable,1,0,1695424,2450566,685842,33512,42081,15471,643761,68143,761435,685842,,,,,0,0,0,0
1650441423.7844677,public.usertable,644209,68162,824557568,16782,public,usertable,1,0,1696554,2451017,686302,33519,42093,15474,644209,68162,761914,686302,,,,,0,0,0,0
1650441424.8137357,public.usertable,644663,68169,825106432,16782,public,usertable,1,0,1697765,2451466,686762,33521,42099,15474,644663,68169,762382,686762,,,,,0,0,0,0
1650441425.843204,public.usertable,645109,68180,825663488,16782,public,usertable,1,0,1699014,2451816,687217,33523,42108,15475,645109,68180,762848,687217,,,,,0,0,0,0
1650441426.8734574,public.usertable,645537,68200,826187776,16782,public,usertable,1,0,1700165,2452014,687656,33532,42119,15479,645537,68200,763307,687656,,,,,0,0,0,0
1650441427.9017415,public.usertable,645985,68211,826736640,16782,public,usertable,1,0,1701401,2452199,688110,33539,42125,15481,645985,68211,763774,688110,,,,,0,0,0,0
1650441428.9328294,public.usertable,646406,68226,827277312,16782,public,usertable,1,0,1702525,2452662,688541,33544,42135,15483,646406,68226,764220,688541,,,,,0,0,0,0
1650441429.9620948,public.usertable,646816,68229,827768832,16782,public,usertable,1,0,1703611,2453280,688956,33548,42140,15483,646816,68229,764644,688956,,,,,0,0,0,0
1650441430.9926167,public.usertable,647240,68236,828252160,16782,public,usertable,1,0,1704820,2453779,689386,33551,42146,15484,647240,68236,765083,689386,,,,,0,0,0,0
1650441432.0217667,public.usertable,647539,68244,828596224,16782,public,usertable,1,0,1705629,2454119,689690,33555,42151,15487,647539,68244,765396,689690,,,,,0,0,0,0
1650441433.0505822,public.usertable,647824,68251,828923904,16782,public,usertable,1,0,1706353,2454324,689980,33557,42156,15487,647824,68251,765693,689980,,,,,0,0,0,0
1650441434.0822291,public.usertable,648072,68262,829284352,16782,public,usertable,1,0,1707076,2454409,690232,33564,42160,15489,648072,68262,765956,690232,,,,,0,0,0,0
1650441435.1109524,public.usertable,648446,68264,829751296,16782,public,usertable,1,0,1708074,2455180,690611,33566,42165,15490,648446,68264,766342,690611,,,,,0,0,0,0
1650441436.1403656,public.usertable,648814,68271,830210048,16782,public,usertable,1,0,1709141,2455531,690984,33570,42170,15492,648814,68271,766724,690984,,,,,0,0,0,0
1650441437.1697237,public.usertable,649213,68278,830668800,16782,public,usertable,1,0,1710200,2456103,691385,33575,42172,15494,649213,68278,767132,691385,,,,,0,0,0,0
1650441438.2012815,public.usertable,649503,68283,831045632,16782,public,usertable,1,0,1710923,2456260,691678,33580,42175,15497,649503,68283,767433,691678,,,,,0,0,0,0
1650441439.2301378,public.usertable,649841,68292,831422464,16782,public,usertable,1,0,1711846,2456385,692022,33583,42181,15499,649841,68292,767786,692022,,,,,0,0,0,0
1650441440.260686,public.usertable,650136,68302,831815680,16782,public,usertable,1,0,1712683,2456837,692324,33588,42188,15503,650136,68302,768100,692324,,,,,0,0,0,0
1650441441.290391,public.usertable,650468,68308,832167936,16782,public,usertable,1,0,1713542,2457121,692661,33589,42193,15504,650468,68308,768443,692661,,,,,0,0,0,0
1650441442.3225007,public.usertable,650820,68320,832454656,16782,public,usertable,1,0,1714434,2457504,693019,33595,42199,15508,650820,68320,768813,693019,,,,,0,0,0,0
1650441443.35277,public.usertable,651051,68325,832716800,16782,public,usertable,1,0,1715043,2457646,693253,33597,42202,15510,651051,68325,769052,693253,,,,,0,0,0,0
1650441444.38208,public.usertable,651298,68336,833011712,16782,public,usertable,1,0,1715756,2457781,693505,33603,42207,15514,651298,68336,769315,693505,,,,,0,0,0,0
1650441445.4113164,public.usertable,651580,68349,833396736,16782,public,usertable,1,0,1716535,2458000,693796,33607,42216,15515,651580,68349,769619,693796,,,,,0,0,0,0
1650441446.4444067,public.usertable,651897,68354,833781760,16782,public,usertable,1,0,1717405,2458369,694114,33611,42217,15516,651897,68354,769942,694114,,,,,0,0,0,0
1650441447.4747279,public.usertable,652267,68363,834248704,16782,public,usertable,1,0,1718439,2458564,694495,33613,42228,15516,652267,68363,770336,694495,,,,,0,0,0,0
1650441448.5039957,public.usertable,652644,68372,834707456,16782,public,usertable,1,0,1719484,2458775,694878,33619,42234,15519,652644,68372,770731,694878,,,,,0,0,0,0
1650441449.533533,public.usertable,653005,68378,835117056,16782,public,usertable,1,0,1720404,2458968,695244,33622,42239,15521,653005,68378,771105,695244,,,,,0,0,0,0
1650441450.565917,public.usertable,653355,68388,835592192,16782,public,usertable,1,0,1721298,2459214,695597,33629,42242,15526,653355,68388,771468,695597,,,,,0,0,0,0
1650441451.595722,public.usertable,653753,68408,836100096,16782,public,usertable,1,0,1722349,2459553,696007,33637,42254,15530,653753,68408,771898,696007,,,,,0,0,0,0
1650441452.6242902,public.usertable,654190,68416,836632576,16782,public,usertable,1,0,1723438,2460135,696451,33638,42261,15531,654190,68416,772350,696451,,,,,0,0,0,0
1650441453.6574318,public.usertable,654625,68423,837156864,16782,public,usertable,1,0,1724604,2460529,696890,33641,42265,15533,654625,68423,772796,696890,,,,,0,0,0,0
1650441454.6879675,public.usertable,655054,68432,837689344,16782,public,usertable,1,0,1725842,2460885,697328,33646,42274,15534,655054,68432,773248,697328,,,,,0,0,0,0
1650441455.716685,public.usertable,655423,68446,838098944,16782,public,usertable,1,0,1726755,2461055,697704,33653,42281,15536,655423,68446,773638,697704,,,,,0,0,0,0
1650441456.746395,public.usertable,655724,68452,838459392,16782,public,usertable,1,0,1727565,2461104,698010,33654,42286,15537,655724,68452,773950,698010,,,,,0,0,0,0
1650441457.7772667,public.usertable,656038,68462,838836224,16782,public,usertable,1,0,1728496,2461552,698329,33659,42291,15540,656038,68462,774279,698329,,,,,0,0,0,0
1650441458.8085294,public.usertable,656370,68475,839254016,16782,public,usertable,1,0,1729361,2461736,698666,33667,42296,15543,656370,68475,774629,698666,,,,,0,0,0,0
1650441459.8400881,public.usertable,656661,68484,839598080,16782,public,usertable,1,0,1730231,2461937,698963,33671,42302,15545,656661,68484,774936,698963,,,,,0,0,0,0
1650441460.8682618,public.usertable,656932,68491,839933952,16782,public,usertable,1,0,1730993,2462189,699238,33676,42306,15547,656932,68491,775220,699238,,,,,0,0,0,0
1650441461.8982763,public.usertable,657216,68497,840278016,16782,public,usertable,1,0,1731803,2462435,699529,33679,42313,15547,657216,68497,775521,699529,,,,,0,0,0,0
1650441462.9301405,public.usertable,657518,68503,840622080,16782,public,usertable,1,0,1732612,2463040,699834,33683,42316,15550,657518,68503,775833,699834,,,,,0,0,0,0
1650441463.9587533,public.usertable,657945,68513,840990720,16782,public,usertable,1,0,1733721,2463208,700266,33690,42321,15554,657945,68513,776277,700266,,,,,0,0,0,0
1650441464.9893625,public.usertable,658260,68525,841383936,16782,public,usertable,1,0,1734500,2463459,700587,33697,42327,15558,658260,68525,776611,700587,,,,,0,0,0,0
1650441466.017756,public.usertable,658663,68541,841891840,16782,public,usertable,1,0,1735603,2463656,701001,33702,42338,15561,658663,68541,777041,701001,,,,,0,0,0,0
1650441467.047133,public.usertable,659072,68558,842391552,16782,public,usertable,1,0,1736837,2463699,701421,33708,42349,15564,659072,68558,777478,701421,,,,,0,0,0,0
1650441468.075525,public.usertable,659515,68566,842940416,16782,public,usertable,1,0,1737955,2464182,701866,33716,42351,15566,659515,68566,777933,701866,,,,,0,0,0,0
1650441469.106004,public.usertable,659950,68575,843472896,16782,public,usertable,1,0,1739093,2464383,702309,33721,42359,15568,659950,68575,778389,702309,,,,,0,0,0,0
1650441470.1370819,public.usertable,660373,68580,843997184,16782,public,usertable,1,0,1740391,2464567,702739,33724,42366,15569,660373,68580,778829,702739,,,,,0,0,0,0
1650441471.1665828,public.usertable,660810,68585,844513280,16782,public,usertable,1,0,1741551,2465044,703178,33729,42368,15571,660810,68585,779275,703178,,,,,0,0,0,0
1650441472.194833,public.usertable,661206,68603,845012992,16782,public,usertable,1,0,1742703,2465294,703582,33741,42376,15576,661206,68603,779699,703582,,,,,0,0,0,0
1650441473.2251298,public.usertable,661601,68608,845488128,16782,public,usertable,1,0,1743870,2465811,703986,33745,42385,15579,661601,68608,780116,703986,,,,,0,0,0,0
1650441474.252722,public.usertable,661985,68619,845946880,16782,public,usertable,1,0,1744984,2465940,704377,33749,42392,15581,661985,68619,780518,704377,,,,,0,0,0,0
1650441475.282568,public.usertable,662274,68628,846274560,16782,public,usertable,1,0,1745802,2466159,704672,33752,42398,15584,662274,68628,780822,704672,,,,,0,0,0,0
1650441476.313534,public.usertable,662542,68638,846626816,16782,public,usertable,1,0,1746581,2466355,704948,33757,42406,15587,662542,68638,781111,704948,,,,,0,0,0,0
1650441477.3479254,public.usertable,662860,68642,847020032,16782,public,usertable,1,0,1747592,2466616,705270,33762,42410,15588,662860,68642,781442,705270,,,,,0,0,0,0
1650441478.3798347,public.usertable,663159,68656,847429632,16782,public,usertable,1,0,1748369,2466922,705576,33771,42417,15591,663159,68656,781764,705576,,,,,0,0,0,0
1650441479.4088345,public.usertable,663518,68657,847847424,16782,public,usertable,1,0,1749305,2467531,705939,33777,42421,15594,663518,68657,782137,705939,,,,,0,0,0,0
1650441480.4425142,public.usertable,663855,68673,848297984,16782,public,usertable,1,0,1750278,2467637,706280,33789,42425,15597,663855,68673,782494,706280,,,,,0,0,0,0
1650441481.4725358,public.usertable,664224,68680,848781312,16782,public,usertable,1,0,1751307,2468071,706658,33797,42434,15601,664224,68680,782889,706658,,,,,0,0,0,0
1650441482.5027618,public.usertable,664630,68696,849256448,16782,public,usertable,1,0,1752412,2468407,707073,33805,42443,15606,664630,68696,783321,707073,,,,,0,0,0,0
1650441483.5331683,public.usertable,665248,68711,849772544,16782,public,usertable,1,0,1754066,2468801,707702,33819,42454,15618,665248,68711,783975,707702,,,,,0,0,0,0
1650441484.5658884,public.usertable,665654,68718,850272256,16782,public,usertable,1,0,1755096,2468908,708114,33820,42460,15619,665654,68718,784394,708114,,,,,0,0,0,0
1650441485.5979567,public.usertable,666075,68729,850780160,16782,public,usertable,1,0,1756181,2469402,708543,33827,42468,15620,666075,68729,784838,708543,,,,,0,0,0,0
1650441486.6271021,public.usertable,666396,68735,851156992,16782,public,usertable,1,0,1757129,2469622,708868,33831,42472,15620,666396,68735,785171,708868,,,,,0,0,0,0
1650441487.6565309,public.usertable,666688,68743,851525632,16782,public,usertable,1,0,1757942,2470277,709162,33839,42474,15626,666688,68743,785475,709162,,,,,0,0,0,0
1650441488.685725,public.usertable,667002,68747,851910656,16782,public,usertable,1,0,1758822,2470407,709480,33839,42478,15626,667002,68747,785797,709480,,,,,0,0,0,0
1650441489.714223,public.usertable,667312,68753,852279296,16782,public,usertable,1,0,1759695,2470748,709796,33841,42484,15628,667312,68753,786121,709796,,,,,0,0,0,0
1650441490.743415,public.usertable,667622,68760,852672512,16782,public,usertable,1,0,1760569,2471047,710112,33845,42490,15630,667622,68760,786447,710112,,,,,0,0,0,0
1650441491.7738943,public.usertable,667956,68765,853090304,16782,public,usertable,1,0,1761425,2471161,710448,33850,42492,15634,667956,68765,786790,710448,,,,,0,0,0,0
1650441492.8070037,public.usertable,668329,68780,853549056,16782,public,usertable,1,0,1762308,2471359,710830,33856,42501,15636,668329,68780,787187,710830,,,,,0,0,0,0
1650441493.8367455,public.usertable,668697,68787,853999616,16782,public,usertable,1,0,1763319,2471562,711203,33858,42506,15638,668697,68787,787567,711203,,,,,0,0,0,0
1650441494.864401,public.usertable,669058,68803,854450176,16782,public,usertable,1,0,1764332,2471736,711571,33867,42513,15643,669058,68803,787951,711571,,,,,0,0,0,0
1650441495.8930445,public.usertable,669465,68814,854941696,16782,public,usertable,1,0,1765408,2472233,711982,33874,42517,15648,669465,68814,788373,711982,,,,,0,0,0,0
1650441496.92331,public.usertable,669870,68816,855465984,16782,public,usertable,1,0,1766471,2472877,712390,33876,42520,15650,669870,68816,788786,712390,,,,,0,0,0,0
1650441497.9523342,public.usertable,670298,68822,855965696,16782,public,usertable,1,0,1767553,2473102,712822,33881,42524,15654,670298,68822,789227,712822,,,,,0,0,0,0
1650441498.9800649,public.usertable,670688,68836,856465408,16782,public,usertable,1,0,1768611,2473319,713219,33888,42531,15656,670688,68836,789638,713219,,,,,0,0,0,0
1650441500.0100386,public.usertable,671087,68844,856940544,16782,public,usertable,1,0,1769561,2473641,713630,33892,42543,15659,671087,68844,790065,713630,,,,,0,0,0,0
1650441501.038293,public.usertable,671491,68856,857440256,16782,public,usertable,1,0,1770771,2473856,714042,33896,42551,15661,671491,68856,790489,714042,,,,,0,0,0,0
1650441502.0668576,public.usertable,671882,68874,857915392,16782,public,usertable,1,0,1771908,2474185,714446,33905,42564,15669,671882,68874,790915,714446,,,,,0,0,0,0
1650441503.0974674,public.usertable,672490,68888,858431488,16782,public,usertable,1,0,1773558,2474835,715066,33911,42576,15670,672490,68888,791553,715066,,,,,0,0,0,0
1650441504.12613,public.usertable,672876,68900,858898432,16782,public,usertable,1,0,1774700,2475079,715459,33916,42583,15671,672876,68900,791958,715459,,,,,0,0,0,0
1650441505.157145,public.usertable,673279,68907,859389952,16782,public,usertable,1,0,1775834,2475575,715865,33920,42586,15672,673279,68907,792371,715865,,,,,0,0,0,0
1650441506.1882484,public.usertable,673676,68920,859873280,16782,public,usertable,1,0,1776815,2475961,716271,33925,42595,15675,673676,68920,792791,716271,,,,,0,0,0,0
1650441507.2181675,public.usertable,674084,68937,860389376,16782,public,usertable,1,0,1777943,2476180,716690,33933,42606,15680,674084,68937,793229,716690,,,,,0,0,0,0
1650441508.2474256,public.usertable,674450,68947,860807168,16782,public,usertable,1,0,1779028,2476602,717064,33935,42614,15682,674450,68947,793613,717064,,,,,0,0,0,0
1650441509.2762136,public.usertable,674792,68959,861249536,16782,public,usertable,1,0,1780014,2476656,717413,33940,42621,15684,674792,68959,793974,717413,,,,,0,0,0,0
1650441510.3082778,public.usertable,675115,68965,861642752,16782,public,usertable,1,0,1780907,2477171,717739,33943,42624,15686,675115,68965,794306,717739,,,,,0,0,0,0
1650441511.3392935,public.usertable,675425,68976,862027776,16782,public,usertable,1,0,1781757,2477260,718057,33946,42632,15688,675425,68976,794635,718057,,,,,0,0,0,0
1650441512.371047,public.usertable,675765,68988,862445568,16782,public,usertable,1,0,1782693,2477465,718401,33954,42636,15692,675765,68988,794991,718401,,,,,0,0,0,0
1650441513.4008787,public.usertable,676117,68992,862896128,16782,public,usertable,1,0,1783540,2477677,718756,33955,42639,15692,676117,68992,795350,718756,,,,,0,0,0,0
1650441514.4297085,public.usertable,676489,69002,863346688,16782,public,usertable,1,0,1784593,2477884,719134,33959,42645,15695,676489,69002,795738,719134,,,,,0,0,0,0
1650441515.4587111,public.usertable,676854,69005,863797248,16782,public,usertable,1,0,1785497,2478090,719502,33961,42648,15696,676854,69005,796111,719502,,,,,0,0,0,0
1650441516.487889,public.usertable,677192,69010,864206848,16782,public,usertable,1,0,1786405,2478289,719846,33963,42654,15697,677192,69010,796463,719846,,,,,0,0,0,0
1650441517.5188994,public.usertable,677563,69014,864665600,16782,public,usertable,1,0,1787505,2478484,720220,33968,42657,15701,677563,69014,796845,720220,,,,,0,0,0,0
1650441518.5467346,public.usertable,677970,69027,865173504,16782,public,usertable,1,0,1788542,2478732,720633,33975,42663,15705,677970,69027,797271,720633,,,,,0,0,0,0
1650441519.5781598,public.usertable,678389,69043,865705984,16782,public,usertable,1,0,1789717,2478995,721063,33980,42674,15707,678389,69043,797717,721063,,,,,0,0,0,0
1650441520.608527,public.usertable,678801,69052,866181120,16782,public,usertable,1,0,1790736,2479724,721483,33985,42682,15709,678801,69052,798150,721483,,,,,0,0,0,0
1650441521.6403792,public.usertable,679192,69064,866664448,16782,public,usertable,1,0,1791915,2480006,721883,33988,42691,15712,679192,69064,798562,721883,,,,,0,0,0,0
1650441522.6696062,public.usertable,679758,69084,867131392,16782,public,usertable,1,0,1793469,2480646,722455,34002,42697,15719,679758,69084,799154,722455,,,,,0,0,0,0
1650441523.6983073,public.usertable,680162,69099,867631104,16782,public,usertable,1,0,1794577,2480758,722866,34010,42704,15724,680162,69099,799580,722866,,,,,0,0,0,0
1650441524.7292905,public.usertable,680574,69112,868139008,16782,public,usertable,1,0,1795655,2481148,723287,34015,42713,15726,680574,69112,800015,723287,,,,,0,0,0,0
1650441525.7583091,public.usertable,680980,69121,868638720,16782,public,usertable,1,0,1796733,2481683,723699,34018,42719,15727,680980,69121,800436,723699,,,,,0,0,0,0
1650441526.7895434,public.usertable,681395,69131,869146624,16782,public,usertable,1,0,1797877,2481860,724119,34023,42724,15730,681395,69131,800866,724119,,,,,0,0,0,0
1650441527.8202097,public.usertable,681793,69147,869638144,16782,public,usertable,1,0,1799025,2483008,724531,34025,42738,15730,681793,69147,801294,724531,,,,,0,0,0,0
1650441528.8502965,public.usertable,682206,69153,870154240,16782,public,usertable,1,0,1800233,2483676,724948,34032,42742,15734,682206,69153,801722,724948,,,,,0,0,0,0
1650441529.8793395,public.usertable,682620,69166,870662144,16782,public,usertable,1,0,1801424,2483978,725372,34039,42752,15738,682620,69166,802163,725372,,,,,0,0,0,0
1650441530.9106033,public.usertable,683013,69179,871137280,16782,public,usertable,1,0,1802539,2484473,725774,34043,42761,15739,683013,69179,802578,725774,,,,,0,0,0,0
1650441531.941803,public.usertable,683312,69185,871489536,16782,public,usertable,1,0,1803374,2484763,726079,34044,42767,15740,683312,69185,802890,726079,,,,,0,0,0,0
1650441532.9745078,public.usertable,683683,69193,871989248,16782,public,usertable,1,0,1804365,2485263,726454,34048,42771,15741,683683,69193,803273,726454,,,,,0,0,0,0
1650441534.0067835,public.usertable,684088,69199,872472576,16782,public,usertable,1,0,1805525,2485603,726863,34052,42775,15742,684088,69199,803690,726863,,,,,0,0,0,0
1650441535.0395539,public.usertable,684489,69209,872964096,16782,public,usertable,1,0,1806574,2485727,727270,34056,42781,15744,684489,69209,804107,727270,,,,,0,0,0,0
1650441536.0686386,public.usertable,684867,69216,873431040,16782,public,usertable,1,0,1807601,2486079,727650,34061,42783,15746,684867,69216,804494,727650,,,,,0,0,0,0
1650441537.0991411,public.usertable,685218,69224,873840640,16782,public,usertable,1,0,1808447,2486523,728007,34063,42789,15748,685218,69224,804859,728007,,,,,0,0,0,0
1650441538.129987,public.usertable,685576,69231,874307584,16782,public,usertable,1,0,1809344,2486855,728373,34066,42797,15749,685576,69231,805236,728373,,,,,0,0,0,0
1650441539.1595554,public.usertable,685907,69242,874708992,16782,public,usertable,1,0,1810172,2487249,728711,34072,42804,15753,685907,69242,805587,728711,,,,,0,0,0,0
1650441540.1887696,public.usertable,686276,69249,875094016,16782,public,usertable,1,0,1811184,2487375,729083,34076,42807,15755,686276,69249,805966,729083,,,,,0,0,0,0
1650441541.2184951,public.usertable,686711,69263,875462656,16782,public,usertable,1,0,1812571,2488166,729525,34085,42814,15761,686711,69263,806424,729525,,,,,0,0,0,0
1650441542.2478623,public.usertable,687006,69268,875831296,16782,public,usertable,1,0,1813391,2488316,729824,34086,42818,15762,687006,69268,806728,729824,,,,,0,0,0,0
1650441543.2795672,public.usertable,687371,69276,876281856,16782,public,usertable,1,0,1814479,2488483,730195,34088,42824,15763,687371,69276,807107,730195,,,,,0,0,0,0
1650441544.3097603,public.usertable,687785,69287,876781568,16782,public,usertable,1,0,1815698,2488653,730615,34094,42830,15767,687785,69287,807539,730615,,,,,0,0,0,0
1650441545.3413417,public.usertable,688211,69302,877322240,16782,public,usertable,1,0,1816741,2488809,731050,34100,42839,15770,688211,69302,807989,731050,,,,,0,0,0,0
1650441546.3722818,public.usertable,688617,69314,877789184,16782,public,usertable,1,0,1817859,2489211,731461,34107,42844,15771,688617,69314,808412,731461,,,,,0,0,0,0
1650441547.4054542,public.usertable,688966,69323,878231552,16782,public,usertable,1,0,1818842,2489372,731816,34110,42850,15772,688966,69323,808776,731816,,,,,0,0,0,0
1650441548.439874,public.usertable,689322,69332,878690304,16782,public,usertable,1,0,1819776,2489427,732175,34116,42853,15774,689322,69332,809144,732175,,,,,0,0,0,0
1650441549.4685328,public.usertable,689708,69344,879157248,16782,public,usertable,1,0,1820834,2490350,732574,34118,42866,15775,689708,69344,809558,732574,,,,,0,0,0,0
1650441550.497356,public.usertable,690113,69354,879656960,16782,public,usertable,1,0,1822033,2490737,732988,34122,42875,15777,690113,69354,809985,732988,,,,,0,0,0,0
1650441551.525745,public.usertable,690506,69366,880148480,16782,public,usertable,1,0,1823170,2490869,733388,34127,42882,15778,690506,69366,810397,733388,,,,,0,0,0,0
1650441552.5539005,public.usertable,690901,69374,880623616,16782,public,usertable,1,0,1824260,2491363,733787,34131,42886,15780,690901,69374,810804,733787,,,,,0,0,0,0
1650441553.582593,public.usertable,691279,69375,881098752,16782,public,usertable,1,0,1825285,2492081,734169,34137,42890,15782,691279,69375,811196,734169,,,,,0,0,0,0
1650441554.611164,public.usertable,691651,69385,881500160,16782,public,usertable,1,0,1826316,2492391,734549,34141,42898,15785,691651,69385,811588,734549,,,,,0,0,0,0
1650441555.6425207,public.usertable,691934,69392,881868800,16782,public,usertable,1,0,1827135,2492856,734838,34147,42904,15787,691934,69392,811889,734838,,,,,0,0,0,0
1650441556.6741328,public.usertable,692247,69400,882245632,16782,public,usertable,1,0,1827945,2493470,735157,34152,42910,15791,692247,69400,812219,735157,,,,,0,0,0,0
1650441557.7035863,public.usertable,692550,69402,882630656,16782,public,usertable,1,0,1828842,2493953,735467,34157,42917,15794,692550,69402,812541,735467,,,,,0,0,0,0
1650441558.7327635,public.usertable,692881,69407,883032064,16782,public,usertable,1,0,1829788,2494164,735803,34157,42922,15794,692881,69407,812882,735803,,,,,0,0,0,0
1650441559.761714,public.usertable,693354,69422,883417088,16782,public,usertable,1,0,1831073,2494786,736287,34161,42933,15795,693354,69422,813381,736287,,,,,0,0,0,0
1650441560.7931454,public.usertable,693689,69430,883834880,16782,public,usertable,1,0,1831916,2495063,736627,34164,42938,15797,693689,69430,813729,736627,,,,,0,0,0,0
1650441561.8256567,public.usertable,694010,69445,884219904,16782,public,usertable,1,0,1832768,2495520,736955,34172,42945,15800,694010,69445,814072,736955,,,,,0,0,0,0
1650441562.8550184,public.usertable,694300,69455,884596736,16782,public,usertable,1,0,1833522,2495717,737248,34179,42948,15806,694300,69455,814375,737248,,,,,0,0,0,0
1650441563.885145,public.usertable,694647,69460,885030912,16782,public,usertable,1,0,1834376,2496011,737600,34182,42953,15808,694647,69460,814735,737600,,,,,0,0,0,0
1650441564.9143207,public.usertable,695081,69470,885563392,16782,public,usertable,1,0,1835540,2496463,738041,34189,42960,15812,695081,69470,815190,738041,,,,,0,0,0,0
1650441565.9439638,public.usertable,695513,69480,886095872,16782,public,usertable,1,0,1836738,2497077,738482,34191,42969,15812,695513,69480,815642,738482,,,,,0,0,0,0
1650441566.973225,public.usertable,695954,69494,886636544,16782,public,usertable,1,0,1837991,2497441,738928,34202,42974,15819,695954,69494,816104,738928,,,,,0,0,0,0
1650441568.0042639,public.usertable,696387,69512,887169024,16782,public,usertable,1,0,1839221,2497590,739365,34216,42978,15827,696387,69512,816559,739365,,,,,0,0,0,0
1650441569.0362196,public.usertable,696814,69523,887693312,16782,public,usertable,1,0,1840460,2498259,739801,34222,42987,15831,696814,69523,817010,739801,,,,,0,0,0,0
1650441570.0671737,public.usertable,697248,69531,888225792,16782,public,usertable,1,0,1841589,2498769,740240,34226,42992,15833,697248,69531,817458,740240,,,,,0,0,0,0
1650441571.0972273,public.usertable,697654,69540,888709120,16782,public,usertable,1,0,1842716,2499261,740654,34227,43000,15833,697654,69540,817881,740654,,,,,0,0,0,0
1650441572.126429,public.usertable,698051,69554,889217024,16782,public,usertable,1,0,1843876,2499578,741059,34233,43008,15836,698051,69554,818300,741059,,,,,0,0,0,0
1650441573.155537,public.usertable,698451,69564,889716736,16782,public,usertable,1,0,1844947,2499905,741466,34239,43015,15841,698451,69564,818720,741466,,,,,0,0,0,0
1650441574.1855245,public.usertable,698868,69571,890216448,16782,public,usertable,1,0,1846140,2500514,741889,34244,43021,15842,698868,69571,819154,741889,,,,,0,0,0,0
1650441575.2156928,public.usertable,699275,69582,890699776,16782,public,usertable,1,0,1847205,2500819,742306,34245,43031,15843,699275,69582,819582,742306,,,,,0,0,0,0
1650441576.2462492,public.usertable,699682,69589,891215872,16782,public,usertable,1,0,1848238,2501245,742716,34253,43034,15848,699682,69589,820003,742716,,,,,0,0,0,0
1650441577.2776735,public.usertable,700096,69597,891707392,16782,public,usertable,1,0,1849434,2501459,743135,34256,43039,15850,700096,69597,820430,743135,,,,,0,0,0,0
1650441578.3064628,public.usertable,700667,69605,892166144,16782,public,usertable,1,0,1851044,2502109,743713,34264,43046,15854,700667,69605,821023,743713,,,,,0,0,0,0
1650441579.3346694,public.usertable,701100,69612,892690432,16782,public,usertable,1,0,1852131,2502565,744151,34269,43051,15857,701100,69612,821471,744151,,,,,0,0,0,0
1650441580.3651857,public.usertable,701511,69618,893198336,16782,public,usertable,1,0,1853234,2502799,744566,34271,43055,15858,701511,69618,821892,744566,,,,,0,0,0,0
1650441581.3926744,public.usertable,701924,69627,893689856,16782,public,usertable,1,0,1854367,2502918,744986,34273,43062,15858,701924,69627,822321,744986,,,,,0,0,0,0
1650441582.4241755,public.usertable,702317,69639,894197760,16782,public,usertable,1,0,1855592,2503349,745387,34280,43070,15860,702317,69639,822737,745387,,,,,0,0,0,0
1650441583.456572,public.usertable,702715,69650,894664704,16782,public,usertable,1,0,1856548,2503742,745790,34286,43075,15865,702715,69650,823151,745790,,,,,0,0,0,0
1650441584.4855537,public.usertable,703120,69663,895164416,16782,public,usertable,1,0,1857599,2503865,746199,34295,43079,15871,703120,69663,823573,746199,,,,,0,0,0,0
1650441585.5156014,public.usertable,703538,69670,895680512,16782,public,usertable,1,0,1858680,2504203,746623,34299,43085,15872,703538,69670,824007,746623,,,,,0,0,0,0
1650441586.5449162,public.usertable,703965,69679,896196608,16782,public,usertable,1,0,1859768,2504929,747056,34304,43091,15875,703965,69679,824451,747056,,,,,0,0,0,0
1650441587.5732892,public.usertable,704396,69686,896737280,16782,public,usertable,1,0,1860886,2505129,747490,34308,43094,15877,704396,69686,824892,747490,,,,,0,0,0,0
1650441588.6036036,public.usertable,704861,69692,897302528,16782,public,usertable,1,0,1861976,2505748,747963,34314,43102,15880,704861,69692,825379,747963,,,,,0,0,0,0
1650441589.6325579,public.usertable,705280,69703,897810432,16782,public,usertable,1,0,1863166,2506143,748392,34318,43112,15881,705280,69703,825822,748392,,,,,0,0,0,0
1650441590.6626124,public.usertable,705702,69705,898342912,16782,public,usertable,1,0,1864355,2506682,748817,34320,43115,15881,705702,69705,826252,748817,,,,,0,0,0,0
1650441591.6922402,public.usertable,706141,69719,898875392,16782,public,usertable,1,0,1865493,2507293,749264,34326,43123,15882,706141,69719,826713,749264,,,,,0,0,0,0
1650441592.7218018,public.usertable,706571,69730,899407872,16782,public,usertable,1,0,1866668,2507390,749700,34331,43129,15885,706571,69730,827160,749700,,,,,0,0,0,0
1650441593.7535603,public.usertable,706986,69739,899899392,16782,public,usertable,1,0,1867770,2507788,750120,34335,43134,15887,706986,69739,827589,750120,,,,,0,0,0,0
1650441594.7831414,public.usertable,707401,69751,900440064,16782,public,usertable,1,0,1868908,2508489,750541,34341,43140,15891,707401,69751,828022,750541,,,,,0,0,0,0
1650441595.8136394,public.usertable,707838,69767,900956160,16782,public,usertable,1,0,1870196,2509047,750987,34348,43149,15895,707838,69767,828484,750987,,,,,0,0,0,0
1650441596.844239,public.usertable,708252,69780,901480448,16782,public,usertable,1,0,1871231,2509392,751411,34351,43159,15896,708252,69780,828921,751411,,,,,0,0,0,0
1650441597.87517,public.usertable,708890,69788,901988352,16782,public,usertable,1,0,1872863,2509606,752052,34356,43162,15899,708890,69788,829570,752052,,,,,0,0,0,0
1650441598.9040968,public.usertable,709311,69795,902504448,16782,public,usertable,1,0,1873951,2509979,752479,34361,43168,15902,709311,69795,830008,752479,,,,,0,0,0,0
1650441599.9337943,public.usertable,709713,69812,903004160,16782,public,usertable,1,0,1875195,2510264,752888,34371,43175,15909,709713,69812,830434,752888,,,,,0,0,0,0
1650441600.9629416,public.usertable,710069,69827,903446528,16782,public,usertable,1,0,1876172,2510713,753249,34381,43180,15912,710069,69827,830810,753249,,,,,0,0,0,0
1650441601.9943132,public.usertable,710497,69833,903970816,16782,public,usertable,1,0,1877282,2511049,753680,34384,43183,15913,710497,69833,831247,753680,,,,,0,0,0,0
1650441603.0279257,public.usertable,710941,69844,904519680,16782,public,usertable,1,0,1878410,2511372,754130,34393,43189,15917,710941,69844,831712,754130,,,,,0,0,0,0
1650441604.0566914,public.usertable,711379,69851,905060352,16782,public,usertable,1,0,1879689,2511674,754574,34394,43195,15918,711379,69851,832163,754574,,,,,0,0,0,0
1650441605.0868275,public.usertable,711838,69860,905601024,16782,public,usertable,1,0,1880876,2512100,755038,34398,43200,15921,711838,69860,832636,755038,,,,,0,0,0,0
1650441606.11729,public.usertable,712260,69877,906125312,16782,public,usertable,1,0,1882041,2512611,755471,34404,43211,15924,712260,69877,833086,755471,,,,,0,0,0,0
1650441607.1492252,public.usertable,712677,69885,906649600,16782,public,usertable,1,0,1883269,2512830,755890,34412,43213,15928,712677,69885,833515,755890,,,,,0,0,0,0
1650441608.181091,public.usertable,713092,69895,907157504,16782,public,usertable,1,0,1884453,2513002,756312,34418,43220,15930,713092,69895,833950,756312,,,,,0,0,0,0
1650441609.2124386,public.usertable,713518,69903,907665408,16782,public,usertable,1,0,1885553,2513599,756743,34421,43225,15931,713518,69903,834389,756743,,,,,0,0,0,0
1650441610.2445698,public.usertable,713934,69910,908197888,16782,public,usertable,1,0,1886719,2514063,757164,34425,43230,15935,713934,69910,834819,757164,,,,,0,0,0,0
1650441611.2761462,public.usertable,714371,69925,908738560,16782,public,usertable,1,0,1887897,2514291,757612,34429,43241,15937,714371,69925,835282,757612,,,,,0,0,0,0
1650441612.3055894,public.usertable,714779,69937,909238272,16782,public,usertable,1,0,1889060,2514629,758029,34432,43250,15937,714779,69937,835711,758029,,,,,0,0,0,0
1650441613.333797,public.usertable,715186,69943,909737984,16782,public,usertable,1,0,1890242,2514772,758439,34438,43253,15941,715186,69943,836130,758439,,,,,0,0,0,0
1650441614.366508,public.usertable,715608,69957,910204928,16782,public,usertable,1,0,1891364,2515040,758870,34444,43262,15945,715608,69957,836576,758870,,,,,0,0,0,0
1650441615.3958178,public.usertable,716169,69966,910688256,16782,public,usertable,1,0,1892989,2515809,759442,34449,43273,15948,716169,69966,837164,759442,,,,,0,0,0,0
1650441616.4284632,public.usertable,716596,69977,911212544,16782,public,usertable,1,0,1894125,2516178,759876,34454,43280,15949,716596,69977,837610,759876,,,,,0,0,0,0
1650441617.458215,public.usertable,717012,69983,911720448,16782,public,usertable,1,0,1895253,2516464,760296,34456,43284,15950,717012,69983,838036,760296,,,,,0,0,0,0
1650441618.4885933,public.usertable,717437,69992,912228352,16782,public,usertable,1,0,1896357,2516852,760726,34460,43289,15950,717437,69992,838475,760726,,,,,0,0,0,0
1650441619.518392,public.usertable,717769,70004,912654336,16782,public,usertable,1,0,1897370,2517253,761068,34462,43299,15951,717769,70004,838829,761068,,,,,0,0,0,0
1650441620.5491674,public.usertable,718187,70017,913170432,16782,public,usertable,1,0,1898471,2517348,761491,34470,43304,15956,718187,70017,839265,761491,,,,,0,0,0,0
1650441621.57757,public.usertable,718556,70027,913596416,16782,public,usertable,1,0,1899354,2517586,761864,34476,43308,15958,718556,70027,839648,761864,,,,,0,0,0,0
1650441622.605837,public.usertable,718866,70034,913989632,16782,public,usertable,1,0,1900179,2517793,762179,34478,43313,15959,718866,70034,839970,762179,,,,,0,0,0,0
1650441623.6352537,public.usertable,719289,70044,914513920,16782,public,usertable,1,0,1901328,2518042,762606,34484,43317,15963,719289,70044,840407,762606,,,,,0,0,0,0
1650441624.6657674,public.usertable,719736,70048,915062784,16782,public,usertable,1,0,1902511,2518407,763058,34486,43322,15965,719736,70048,840866,763058,,,,,0,0,0,0
1650441625.6958,public.usertable,720152,70059,915603456,16782,public,usertable,1,0,1903628,2518503,763480,34491,43328,15969,720152,70059,841299,763480,,,,,0,0,0,0
1650441626.7302234,public.usertable,720619,70077,916168704,16782,public,usertable,1,0,1904880,2518730,763955,34501,43336,15972,720619,70077,841792,763955,,,,,0,0,0,0
1650441627.75982,public.usertable,721058,70094,916709376,16782,public,usertable,1,0,1906091,2519240,764405,34507,43347,15975,721058,70094,842259,764405,,,,,0,0,0,0
1650441628.78862,public.usertable,721511,70097,917258240,16782,public,usertable,1,0,1907344,2519534,764861,34507,43350,15975,721511,70097,842718,764861,,,,,0,0,0,0
1650441629.8174386,public.usertable,721943,70099,917749760,16782,public,usertable,1,0,1908497,2519770,765300,34509,43357,15977,721943,70099,843166,765300,,,,,0,0,0,0
1650441630.8479588,public.usertable,722346,70111,918265856,16782,public,usertable,1,0,1909493,2520112,765708,34516,43362,15981,722346,70111,843586,765708,,,,,0,0,0,0
1650441631.8782115,public.usertable,722773,70120,918781952,16782,public,usertable,1,0,1910574,2520738,766139,34521,43366,15986,722773,70120,844026,766139,,,,,0,0,0,0
1650441632.907802,public.usertable,723213,70131,919330816,16782,public,usertable,1,0,1911718,2521215,766588,34523,43375,15987,723213,70131,844486,766588,,,,,0,0,0,0
1650441633.9367177,public.usertable,723874,70144,919871488,16782,public,usertable,1,0,1913421,2521817,767258,34531,43384,15993,723874,70144,845173,767258,,,,,0,0,0,0
1650441634.9664445,public.usertable,724311,70153,920412160,16782,public,usertable,1,0,1914575,2522111,767700,34537,43389,15995,724311,70153,845626,767700,,,,,0,0,0,0
1650441635.9953701,public.usertable,724749,70169,920952832,16782,public,usertable,1,0,1915758,2522640,768147,34544,43398,15998,724749,70169,846089,768147,,,,,0,0,0,0
1650441637.0254323,public.usertable,725184,70177,921485312,16782,public,usertable,1,0,1916954,2523187,768588,34552,43404,16002,725184,70177,846544,768588,,,,,0,0,0,0
1650441638.0547504,public.usertable,725616,70188,922009600,16782,public,usertable,1,0,1918135,2523409,769027,34556,43411,16003,725616,70188,846994,769027,,,,,0,0,0,0
1650441639.0834405,public.usertable,726056,70197,922566656,16782,public,usertable,1,0,1919192,2523696,769472,34563,43416,16007,726056,70197,847451,769472,,,,,0,0,0,0
1650441640.1169877,public.usertable,726505,70211,923115520,16782,public,usertable,1,0,1920309,2524220,769926,34572,43421,16009,726505,70211,847919,769926,,,,,0,0,0,0
1650441641.1472127,public.usertable,726948,70227,923656192,16782,public,usertable,1,0,1921550,2524694,770380,34577,43432,16012,726948,70227,848389,770380,,,,,0,0,0,0
1650441642.1775486,public.usertable,727367,70239,924172288,16782,public,usertable,1,0,1922711,2524829,770808,34580,43441,16014,727367,70239,848829,770808,,,,,0,0,0,0
1650441643.2071326,public.usertable,727802,70246,924721152,16782,public,usertable,1,0,1923916,2525080,771248,34584,43446,16016,727802,70246,849278,771248,,,,,0,0,0,0
1650441644.2391043,public.usertable,728251,70256,925270016,16782,public,usertable,1,0,1925176,2525340,771704,34590,43453,16020,728251,70256,849747,771704,,,,,0,0,0,0
1650441645.271706,public.usertable,728640,70265,925761536,16782,public,usertable,1,0,1926290,2525665,772102,34594,43462,16021,728640,70265,850158,772102,,,,,0,0,0,0
1650441646.3027048,public.usertable,729099,70273,926318592,16782,public,usertable,1,0,1927594,2526141,772566,34598,43467,16022,729099,70273,850631,772566,,,,,0,0,0,0
1650441647.3321466,public.usertable,729536,70276,926834688,16782,public,usertable,1,0,1928745,2526550,773007,34604,43471,16024,729536,70276,851082,773007,,,,,0,0,0,0
1650441648.361738,public.usertable,729970,70276,927350784,16782,public,usertable,1,0,1929929,2526904,773443,34604,43473,16024,729970,70276,851520,773443,,,,,0,0,0,0
1650441649.393874,public.usertable,730376,70288,927899648,16782,public,usertable,1,0,1930990,2527053,773858,34607,43482,16025,730376,70288,851947,773858,,,,,0,0,0,0
1650441650.424362,public.usertable,730820,70304,928440320,16782,public,usertable,1,0,1932126,2527247,774313,34612,43493,16028,730820,70304,852418,774313,,,,,0,0,0,0
1650441651.4528506,public.usertable,731258,70316,928989184,16782,public,usertable,1,0,1933321,2527511,774758,34617,43500,16031,731258,70316,852875,774758,,,,,0,0,0,0
1650441652.482719,public.usertable,731959,70331,929546240,16782,public,usertable,1,0,1935103,2528430,775467,34625,43508,16033,731959,70331,853600,775467,,,,,0,0,0,0
1650441653.5116262,public.usertable,732421,70344,930119680,16782,public,usertable,1,0,1936387,2528627,775936,34631,43515,16035,732421,70344,854082,775936,,,,,0,0,0,0
1650441654.5437632,public.usertable,732903,70351,930709504,16782,public,usertable,1,0,1937736,2529218,776421,34635,43518,16037,732903,70351,854574,776421,,,,,0,0,0,0
1650441655.5723565,public.usertable,733363,70363,931274752,16782,public,usertable,1,0,1939036,2529620,776887,34641,43524,16042,733363,70363,855052,776887,,,,,0,0,0,0
1650441656.602446,public.usertable,733809,70382,931823616,16782,public,usertable,1,0,1940342,2529825,777347,34648,43538,16046,733809,70382,855533,777347,,,,,0,0,0,0
1650441657.6310964,public.usertable,734268,70399,932388864,16782,public,usertable,1,0,1941525,2530005,777816,34655,43548,16050,734268,70399,856019,777816,,,,,0,0,0,0
1650441658.6603165,public.usertable,734739,70407,932962304,16782,public,usertable,1,0,1942755,2530114,778293,34657,43554,16051,734739,70407,856504,778293,,,,,0,0,0,0
1650441659.6902845,public.usertable,735174,70419,933502976,16782,public,usertable,1,0,1943985,2530366,778735,34662,43561,16054,735174,70419,856958,778735,,,,,0,0,0,0
1650441660.723093,public.usertable,735622,70430,934060032,16782,public,usertable,1,0,1945173,2530490,779193,34666,43571,16056,735622,70430,857430,779193,,,,,0,0,0,0
1650441661.754438,public.usertable,736071,70439,934617088,16782,public,usertable,1,0,1946389,2530839,779649,34669,43578,16057,736071,70439,857896,779649,,,,,0,0,0,0
1650441662.783795,public.usertable,736522,70453,935165952,16782,public,usertable,1,0,1947452,2531253,780109,34675,43587,16063,736522,70453,858371,780109,,,,,0,0,0,0
1650441663.812793,public.usertable,736962,70466,935690240,16782,public,usertable,1,0,1948632,2531586,780553,34684,43591,16067,736962,70466,858828,780553,,,,,0,0,0,0
1650441664.8423233,public.usertable,737402,70473,936247296,16782,public,usertable,1,0,1949816,2532024,780999,34687,43597,16070,737402,70473,859283,780999,,,,,0,0,0,0
1650441665.8703778,public.usertable,737843,70481,936787968,16782,public,usertable,1,0,1951023,2532182,781446,34689,43603,16070,737843,70481,859738,781446,,,,,0,0,0,0
1650441666.8992376,public.usertable,738306,70492,937345024,16782,public,usertable,1,0,1952172,2532382,781916,34693,43610,16071,738306,70492,860219,781916,,,,,0,0,0,0
1650441667.9301891,public.usertable,738738,70510,937885696,16782,public,usertable,1,0,1953408,2532768,782358,34702,43620,16077,738738,70510,860680,782358,,,,,0,0,0,0
1650441668.9601555,public.usertable,739183,70523,938434560,16782,public,usertable,1,0,1954664,2533252,782811,34710,43628,16082,739183,70523,861149,782811,,,,,0,0,0,0
1650441669.989318,public.usertable,739644,70528,939008000,16782,public,usertable,1,0,1955923,2533524,783276,34715,43632,16083,739644,70528,861623,783276,,,,,0,0,0,0
1650441671.0190883,public.usertable,740341,70549,939581440,16782,public,usertable,1,0,1957862,2533756,783984,34725,43643,16087,740341,70549,862352,783984,,,,,0,0,0,0
1650441672.0482728,public.usertable,740806,70561,940163072,16782,public,usertable,1,0,1959092,2533888,784457,34729,43651,16088,740806,70561,862837,784457,,,,,0,0,0,0
1650441673.0776536,public.usertable,741268,70571,940720128,16782,public,usertable,1,0,1960381,2534336,784925,34736,43657,16089,741268,70571,863318,784925,,,,,0,0,0,0
1650441674.107239,public.usertable,741735,70577,941293568,16782,public,usertable,1,0,1961550,2534484,785396,34741,43661,16091,741735,70577,863798,785396,,,,,0,0,0,0
1650441675.1360168,public.usertable,742193,70587,941858816,16782,public,usertable,1,0,1962761,2534792,785862,34745,43669,16092,742193,70587,864276,785862,,,,,0,0,0,0
1650441676.1639788,public.usertable,742603,70594,942350336,16782,public,usertable,1,0,1963893,2534847,786277,34749,43674,16094,742603,70594,864700,786277,,,,,0,0,0,0
1650441677.1983566,public.usertable,743068,70604,942915584,16782,public,usertable,1,0,1965265,2535355,786745,34756,43677,16098,743068,70604,865178,786745,,,,,0,0,0,0
1650441678.227846,public.usertable,743508,70605,943439872,16782,public,usertable,1,0,1966387,2535774,787188,34761,43680,16100,743508,70605,865629,787188,,,,,0,0,0,0
1650441679.2579968,public.usertable,743943,70616,943988736,16782,public,usertable,1,0,1967640,2536537,787631,34764,43688,16101,743943,70616,866083,787631,,,,,0,0,0,0
1650441680.28894,public.usertable,744378,70622,944521216,16782,public,usertable,1,0,1968860,2536869,788071,34768,43693,16102,744378,70622,866532,788071,,,,,0,0,0,0
1650441681.317651,public.usertable,744824,70624,945078272,16782,public,usertable,1,0,1970043,2537609,788524,34772,43700,16103,744824,70624,866996,788524,,,,,0,0,0,0
1650441682.346171,public.usertable,745286,70634,945635328,16782,public,usertable,1,0,1971285,2537868,788993,34775,43707,16106,745286,70634,867475,788993,,,,,0,0,0,0
1650441683.376422,public.usertable,745724,70645,946167808,16782,public,usertable,1,0,1972485,2538453,789434,34783,43710,16109,745724,70645,867927,789434,,,,,0,0,0,0
1650441684.4055996,public.usertable,746174,70655,946716672,16782,public,usertable,1,0,1973748,2538865,789888,34789,43714,16113,746174,70655,868391,789888,,,,,0,0,0,0
1650441685.435815,public.usertable,746630,70669,947273728,16782,public,usertable,1,0,1974973,2539360,790349,34798,43719,16120,746630,70669,868866,790349,,,,,0,0,0,0
1650441686.4644861,public.usertable,747075,70677,947830784,16782,public,usertable,1,0,1976161,2539735,790800,34806,43725,16123,747075,70677,869331,790800,,,,,0,0,0,0
1650441687.494542,public.usertable,747537,70684,948387840,16782,public,usertable,1,0,1977441,2540018,791266,34809,43729,16125,747537,70684,869804,791266,,,,,0,0,0,0
1650441688.5247834,public.usertable,747994,70692,948953088,16782,public,usertable,1,0,1978720,2540400,791729,34814,43735,16127,747994,70692,870278,791729,,,,,0,0,0,0
1650441689.5544162,public.usertable,748659,70709,949485568,16782,public,usertable,1,0,1980601,2541081,792402,34827,43743,16134,748659,70709,870972,792402,,,,,0,0,0,0
1650441690.5847578,public.usertable,749054,70716,949960704,16782,public,usertable,1,0,1981669,2541218,792803,34831,43749,16136,749054,70716,871383,792803,,,,,0,0,0,0
1650441691.6146302,public.usertable,749364,70723,950345728,16782,public,usertable,1,0,1982535,2541574,793116,34835,43752,16139,749364,70723,871703,793116,,,,,0,0,0,0
1650441692.6454346,public.usertable,749678,70731,950738944,16782,public,usertable,1,0,1983393,2541680,793434,34839,43756,16142,749678,70731,872029,793434,,,,,0,0,0,0
1650441693.6801941,public.usertable,750037,70737,951164928,16782,public,usertable,1,0,1984391,2542007,793795,34843,43758,16144,750037,70737,872396,793795,,,,,0,0,0,0
1650441694.7104077,public.usertable,750397,70748,951607296,16782,public,usertable,1,0,1985314,2542260,794159,34850,43762,16149,750397,70748,872771,794159,,,,,0,0,0,0
1650441695.7415345,public.usertable,750720,70757,951992320,16782,public,usertable,1,0,1986285,2542911,794489,34852,43769,16151,750720,70757,873110,794489,,,,,0,0,0,0
1650441696.774236,public.usertable,751061,70763,952418304,16782,public,usertable,1,0,1987184,2543435,794836,34855,43775,16154,751061,70763,873466,794836,,,,,0,0,0,0
1650441697.8048449,public.usertable,751369,70773,952795136,16782,public,usertable,1,0,1988004,2543473,795149,34860,43780,16156,751369,70773,873789,795149,,,,,0,0,0,0
1650441698.8369203,public.usertable,751668,70780,953147392,16782,public,usertable,1,0,1988896,2543782,795453,34862,43785,16158,751668,70780,874100,795453,,,,,0,0,0,0
1650441699.8668911,public.usertable,752060,70789,953688064,16782,public,usertable,1,0,1989902,2544376,795850,34870,43790,16163,752060,70789,874510,795850,,,,,0,0,0,0
1650441700.896924,public.usertable,752518,70797,954253312,16782,public,usertable,1,0,1991158,2544888,796314,34872,43796,16163,752518,70797,874982,796314,,,,,0,0,0,0
1650441701.9298444,public.usertable,752982,70805,954810368,16782,public,usertable,1,0,1992375,2545091,796783,34875,43801,16165,752982,70805,875459,796783,,,,,0,0,0,0
1650441702.959452,public.usertable,753423,70814,955334656,16782,public,usertable,1,0,1993522,2545225,797229,34879,43806,16166,753423,70814,875914,797229,,,,,0,0,0,0
1650441703.989901,public.usertable,753861,70824,955883520,16782,public,usertable,1,0,1994592,2545381,797672,34884,43811,16170,753861,70824,876367,797672,,,,,0,0,0,0
1650441705.0190558,public.usertable,754312,70836,956448768,16782,public,usertable,1,0,1995812,2545533,798129,34890,43817,16172,754312,70836,876836,798129,,,,,0,0,0,0
1650441706.0476527,public.usertable,754775,70842,957014016,16782,public,usertable,1,0,1997147,2545883,798596,34892,43821,16173,754775,70842,877309,798596,,,,,0,0,0,0
1650441707.0772955,public.usertable,755191,70852,957505536,16782,public,usertable,1,0,1998299,2545937,799014,34901,43823,16176,755191,70852,877738,799014,,,,,0,0,0,0
1650441708.1134558,public.usertable,755845,70866,958038016,16782,public,usertable,1,0,1999998,2546435,799671,34912,43826,16181,755845,70866,878409,799671,,,,,0,0,0,0
1650441709.1422212,public.usertable,756287,70869,958586880,16782,public,usertable,1,0,2001194,2547388,800122,34914,43835,16183,756287,70869,878871,800122,,,,,0,0,0,0
1650441710.1712859,public.usertable,756746,70877,959152128,16782,public,usertable,1,0,2002386,2547629,800585,34918,43839,16185,756746,70877,879342,800585,,,,,0,0,0,0
1650441711.2007535,public.usertable,757195,70881,959692800,16782,public,usertable,1,0,2003446,2548121,801038,34921,43843,16187,757195,70881,879802,801038,,,,,0,0,0,0
1650441712.2310965,public.usertable,757639,70891,960233472,16782,public,usertable,1,0,2004614,2548344,801487,34926,43848,16191,757639,70891,880261,801487,,,,,0,0,0,0
1650441713.2619872,public.usertable,758074,70900,960765952,16782,public,usertable,1,0,2005827,2548547,801930,34927,43856,16192,758074,70900,880713,801930,,,,,0,0,0,0
1650441714.2926817,public.usertable,758447,70908,961208320,16782,public,usertable,1,0,2006840,2548960,802306,34935,43859,16196,758447,70908,881100,802306,,,,,0,0,0,0
1650441715.323102,public.usertable,758744,70915,961552384,16782,public,usertable,1,0,2007573,2549009,802607,34938,43863,16198,758744,70915,881408,802607,,,,,0,0,0,0
1650441716.351414,public.usertable,759060,70923,961978368,16782,public,usertable,1,0,2008482,2549213,802928,34941,43868,16201,759060,70923,881737,802928,,,,,0,0,0,0
1650441717.3798006,public.usertable,759477,70933,962469888,16782,public,usertable,1,0,2009563,2549503,803349,34947,43872,16204,759477,70933,882168,803349,,,,,0,0,0,0
1650441718.4105856,public.usertable,759838,70941,962887680,16782,public,usertable,1,0,2010597,2549667,803713,34952,43875,16206,759838,70941,882540,803713,,,,,0,0,0,0
1650441719.439733,public.usertable,760154,70948,963264512,16782,public,usertable,1,0,2011452,2549739,804032,34956,43878,16207,760154,70948,882866,804032,,,,,0,0,0,0
1650441720.4725254,public.usertable,760452,70954,963624960,16782,public,usertable,1,0,2012231,2550037,804331,34961,43879,16209,760452,70954,883171,804331,,,,,0,0,0,0
1650441721.504923,public.usertable,760779,70962,964034560,16782,public,usertable,1,0,2013042,2550285,804662,34965,43883,16211,760779,70962,883510,804662,,,,,0,0,0,0
1650441722.5355186,public.usertable,761100,70969,964411392,16782,public,usertable,1,0,2013865,2550720,804984,34971,43884,16215,761100,70969,883839,804984,,,,,0,0,0,0
1650441723.5665734,public.usertable,761389,70977,964780032,16782,public,usertable,1,0,2014658,2550931,805277,34977,43888,16220,761389,70977,884142,805277,,,,,0,0,0,0
1650441724.5991483,public.usertable,761647,70978,965050368,16782,public,usertable,1,0,2015317,2551056,805539,34978,43892,16221,761647,70978,884409,805539,,,,,0,0,0,0
1650441725.6346912,public.usertable,761875,70986,965353472,16782,public,usertable,1,0,2016034,2551319,805773,34980,43898,16223,761875,70986,884651,805773,,,,,0,0,0,0
1650441726.6675317,public.usertable,762151,70991,965738496,16782,public,usertable,1,0,2016805,2551626,806057,34984,43906,16225,762151,70991,884947,806057,,,,,0,0,0,0
1650441727.698837,public.usertable,762578,70995,966057984,16782,public,usertable,1,0,2017914,2551963,806490,34984,43912,16225,762578,70995,885386,806490,,,,,0,0,0,0
1650441728.7286952,public.usertable,762803,71000,966328320,16782,public,usertable,1,0,2018529,2552066,806716,34988,43913,16227,762803,71000,885617,806716,,,,,0,0,0,0
1650441729.7587473,public.usertable,763029,71000,966598656,16782,public,usertable,1,0,2019105,2552185,806944,34991,43915,16227,763029,71000,885850,806944,,,,,0,0,0,0
1650441730.7877164,public.usertable,763244,71005,966868992,16782,public,usertable,1,0,2019730,2552274,807161,34996,43917,16231,763244,71005,886074,807161,,,,,0,0,0,0
1650441731.8176084,public.usertable,763475,71003,967163904,16782,public,usertable,1,0,2020392,2552735,807396,35000,43921,16232,763475,71003,886317,807396,,,,,0,0,0,0
1650441732.846615,public.usertable,763743,71005,967483392,16782,public,usertable,1,0,2021080,2552803,807667,35001,43924,16233,763743,71005,886592,807667,,,,,0,0,0,0
1650441733.8754346,public.usertable,764010,71012,967835648,16782,public,usertable,1,0,2021731,2552954,807940,35002,43930,16233,764010,71012,886872,807940,,,,,0,0,0,0
1650441734.9084756,public.usertable,764292,71016,968146944,16782,public,usertable,1,0,2022473,2553279,808223,35005,43931,16235,764292,71016,887159,808223,,,,,0,0,0,0
1650441735.9397066,public.usertable,764520,71018,968458240,16782,public,usertable,1,0,2023074,2553902,808455,35005,43935,16235,764520,71018,887395,808455,,,,,0,0,0,0
1650441736.9709816,public.usertable,764839,71031,968802304,16782,public,usertable,1,0,2024015,2554072,808781,35011,43942,16238,764839,71031,887734,808781,,,,,0,0,0,0
1650441738.0015004,public.usertable,765101,71035,969154560,16782,public,usertable,1,0,2024766,2554146,809044,35014,43943,16239,765101,71035,888001,809044,,,,,0,0,0,0
1650441739.0329933,public.usertable,765408,71043,969531392,16782,public,usertable,1,0,2025513,2554296,809358,35015,43950,16240,765408,71043,888323,809358,,,,,0,0,0,0
1650441740.0641205,public.usertable,765703,71046,969940992,16782,public,usertable,1,0,2026284,2554838,809655,35019,43952,16242,765703,71046,888626,809655,,,,,0,0,0,0
1650441741.092302,public.usertable,766157,71052,970506240,16782,public,usertable,1,0,2027518,2555169,810113,35022,43956,16242,766157,71052,889091,810113,,,,,0,0,0,0
1650441742.1244318,public.usertable,766626,71060,971071488,16782,public,usertable,1,0,2028734,2555762,810588,35024,43962,16243,766626,71060,889574,810588,,,,,0,0,0,0
1650441743.1541753,public.usertable,767075,71069,971603968,16782,public,usertable,1,0,2029938,2555882,811040,35030,43965,16247,767075,71069,890035,811040,,,,,0,0,0,0
1650441744.1850026,public.usertable,767511,71079,972120064,16782,public,usertable,1,0,2031101,2556034,811481,35035,43970,16249,767511,71079,890486,811481,,,,,0,0,0,0
1650441745.2173367,public.usertable,767920,71083,972627968,16782,public,usertable,1,0,2032203,2556682,811892,35039,43972,16251,767920,71083,890903,811892,,,,,0,0,0,0
1650441746.249487,public.usertable,768330,71090,973168640,16782,public,usertable,1,0,2033310,2557515,812309,35043,43979,16252,768330,71090,891331,812309,,,,,0,0,0,0
1650441747.2788076,public.usertable,769023,71109,973742080,16782,public,usertable,1,0,2035189,2557719,813013,35054,43990,16255,769023,71109,892057,813013,,,,,0,0,0,0
1650441748.3082378,public.usertable,769442,71116,974249984,16782,public,usertable,1,0,2036288,2557983,813436,35057,43994,16256,769442,71116,892487,813436,,,,,0,0,0,0
1650441749.337139,public.usertable,769839,71120,974741504,16782,public,usertable,1,0,2037339,2558371,813837,35059,43998,16256,769839,71120,892894,813837,,,,,0,0,0,0
1650441750.3691947,public.usertable,770263,71130,975257600,16782,public,usertable,1,0,2038584,2558638,814267,35064,44004,16260,770263,71130,893335,814267,,,,,0,0,0,0
1650441751.3995497,public.usertable,770668,71142,975749120,16782,public,usertable,1,0,2039640,2558802,814678,35070,44010,16263,770668,71142,893758,814678,,,,,0,0,0,0
1650441752.4316802,public.usertable,771064,71148,976232448,16782,public,usertable,1,0,2040786,2559418,815076,35077,44012,16266,771064,71148,894165,815076,,,,,0,0,0,0
1650441753.4617245,public.usertable,771475,71155,976740352,16782,public,usertable,1,0,2041873,2559544,815489,35082,44014,16267,771475,71155,894585,815489,,,,,0,0,0,0
1650441754.492217,public.usertable,771894,71160,977248256,16782,public,usertable,1,0,2043044,2559832,815909,35087,44015,16269,771894,71160,895011,815909,,,,,0,0,0,0
1650441755.5219874,public.usertable,772287,71167,977723392,16782,public,usertable,1,0,2044195,2560260,816307,35090,44020,16272,772287,71167,895417,816307,,,,,0,0,0,0
1650441756.5515218,public.usertable,772675,71176,978206720,16782,public,usertable,1,0,2045243,2560309,816698,35096,44023,16276,772675,71176,895817,816698,,,,,0,0,0,0
1650441757.5799222,public.usertable,773034,71186,978616320,16782,public,usertable,1,0,2046288,2560570,817061,35102,44027,16276,773034,71186,896190,817061,,,,,0,0,0,0
1650441758.6115966,public.usertable,773370,71195,979034112,16782,public,usertable,1,0,2047219,2560640,817401,35107,44031,16279,773370,71195,896539,817401,,,,,0,0,0,0
1650441759.6407669,public.usertable,773717,71204,979435520,16782,public,usertable,1,0,2048126,2561383,817753,35113,44036,16282,773717,71204,896902,817753,,,,,0,0,0,0
1650441760.6695886,public.usertable,774025,71212,979845120,16782,public,usertable,1,0,2048905,2561604,818068,35114,44043,16282,774025,71212,897225,818068,,,,,0,0,0,0
1650441761.698036,public.usertable,774378,71220,980238336,16782,public,usertable,1,0,2049804,2561782,818424,35119,44046,16283,774378,71220,897589,818424,,,,,0,0,0,0
1650441762.7286444,public.usertable,774706,71230,980688896,16782,public,usertable,1,0,2050677,2562280,818757,35125,44051,16286,774706,71230,897933,818757,,,,,0,0,0,0
1650441763.759634,public.usertable,775102,71241,981172224,16782,public,usertable,1,0,2051776,2562465,819157,35132,44055,16289,775102,71241,898344,819157,,,,,0,0,0,0
1650441764.789742,public.usertable,775461,71250,981598208,16782,public,usertable,1,0,2052754,2562802,819518,35139,44057,16292,775461,71250,898714,819518,,,,,0,0,0,0
1650441765.8180592,public.usertable,775814,71250,982024192,16782,public,usertable,1,0,2053704,2563247,819878,35139,44064,16292,775814,71250,899081,819878,,,,,0,0,0,0
1650441766.8476388,public.usertable,776321,71257,982441984,16782,public,usertable,1,0,2055081,2564072,820391,35146,44070,16296,776321,71257,899607,820391,,,,,0,0,0,0
1650441767.8764496,public.usertable,776691,71262,982892544,16782,public,usertable,1,0,2056097,2564739,820767,35148,44076,16297,776691,71262,899991,820767,,,,,0,0,0,0
1650441768.9059124,public.usertable,777089,71268,983375872,16782,public,usertable,1,0,2057216,2565043,821171,35151,44082,16300,777089,71268,900404,821171,,,,,0,0,0,0
1650441769.9369628,public.usertable,777486,71279,983867392,16782,public,usertable,1,0,2058321,2565280,821575,35158,44089,16304,777486,71279,900822,821575,,,,,0,0,0,0
1650441770.9672523,public.usertable,777877,71289,984350720,16782,public,usertable,1,0,2059428,2565464,821972,35162,44095,16306,777877,71289,901229,821972,,,,,0,0,0,0
1650441771.9963284,public.usertable,778280,71295,984850432,16782,public,usertable,1,0,2060665,2565853,822380,35166,44100,16309,778280,71295,901646,822380,,,,,0,0,0,0
1650441773.0262477,public.usertable,778696,71304,985350144,16782,public,usertable,1,0,2061773,2566295,822801,35170,44105,16311,778696,71304,902076,822801,,,,,0,0,0,0
1650441774.057301,public.usertable,779095,71318,985849856,16782,public,usertable,1,0,2062842,2566443,823209,35175,44114,16314,779095,71318,902498,823209,,,,,0,0,0,0
1650441775.0890143,public.usertable,779507,71323,986333184,16782,public,usertable,1,0,2063862,2566828,823626,35176,44119,16314,779507,71323,902921,823626,,,,,0,0,0,0
1650441776.1206481,public.usertable,779870,71335,986808320,16782,public,usertable,1,0,2064790,2567080,823996,35181,44126,16317,779870,71335,903303,823996,,,,,0,0,0,0
1650441777.1526127,public.usertable,780240,71346,987250688,16782,public,usertable,1,0,2065809,2567638,824372,35186,44132,16320,780240,71346,903690,824372,,,,,0,0,0,0
1650441778.1814663,public.usertable,780627,71356,987693056,16782,public,usertable,1,0,2066850,2567984,824763,35192,44136,16323,780627,71356,904091,824763,,,,,0,0,0,0
1650441779.2138102,public.usertable,781014,71365,988209152,16782,public,usertable,1,0,2067779,2568195,825155,35196,44141,16324,781014,71365,904492,825155,,,,,0,0,0,0
1650441780.242549,public.usertable,781417,71371,988692480,16782,public,usertable,1,0,2068809,2568335,825564,35199,44147,16326,781417,71371,904910,825564,,,,,0,0,0,0
1650441781.2712765,public.usertable,781812,71377,989151232,16782,public,usertable,1,0,2069783,2568998,825962,35205,44150,16328,781812,71377,905317,825962,,,,,0,0,0,0
1650441782.2999241,public.usertable,782171,71381,989609984,16782,public,usertable,1,0,2070613,2569052,826324,35206,44153,16329,782171,71381,905683,826324,,,,,0,0,0,0
1650441783.3346303,public.usertable,782551,71380,990068736,16782,public,usertable,1,0,2071629,2569428,826705,35208,44154,16330,782551,71380,906067,826705,,,,,0,0,0,0
1650441784.3663056,public.usertable,782957,71384,990535680,16782,public,usertable,1,0,2072672,2569732,827113,35210,44156,16331,782957,71384,906479,827113,,,,,0,0,0,0
1650441785.39565,public.usertable,783525,71399,991010816,16782,public,usertable,1,0,2074243,2569960,827690,35216,44165,16334,783525,71399,907071,827690,,,,,0,0,0,0
1650441786.4244988,public.usertable,783818,71404,991371264,16782,public,usertable,1,0,2075111,2570115,827988,35221,44170,16337,783818,71404,907379,827988,,,,,0,0,0,0
1650441787.4555957,public.usertable,784043,71408,991641600,16782,public,usertable,1,0,2075714,2570333,828216,35222,44173,16338,784043,71408,907611,828216,,,,,0,0,0,0
1650441788.4858663,public.usertable,784283,71414,991936512,16782,public,usertable,1,0,2076370,2570425,828459,35225,44176,16339,784283,71414,907860,828459,,,,,0,0,0,0
1650441789.5163276,public.usertable,784508,71418,992198656,16782,public,usertable,1,0,2077006,2570547,828686,35227,44178,16340,784508,71418,908091,828686,,,,,0,0,0,0
1650441790.5469608,public.usertable,784761,71425,992518144,16782,public,usertable,1,0,2077741,2570734,828942,35231,44181,16341,784761,71425,908354,828942,,,,,0,0,0,0
1650441791.578628,public.usertable,784995,71437,992821248,16782,public,usertable,1,0,2078346,2570770,829184,35235,44189,16343,784995,71437,908608,829184,,,,,0,0,0,0
1650441792.6101506,public.usertable,785213,71444,993091584,16782,public,usertable,1,0,2078973,2570852,829407,35237,44194,16345,785213,71444,908838,829407,,,,,0,0,0,0
1650441793.6414814,public.usertable,785428,71448,993378304,16782,public,usertable,1,0,2079522,2570879,829622,35241,44194,16347,785428,71448,909057,829622,,,,,0,0,0,0
1650441794.670201,public.usertable,785789,71453,993828864,16782,public,usertable,1,0,2080415,2571245,829989,35243,44200,16348,785789,71453,909432,829989,,,,,0,0,0,0
1650441795.699913,public.usertable,786157,71459,994263040,16782,public,usertable,1,0,2081386,2571480,830362,35244,44205,16349,786157,71459,909811,830362,,,,,0,0,0,0
1650441796.731027,public.usertable,786528,71466,994713600,16782,public,usertable,1,0,2082355,2571923,830738,35250,44210,16351,786528,71466,910198,830738,,,,,0,0,0,0
1650441797.7619662,public.usertable,786886,71474,995155968,16782,public,usertable,1,0,2083265,2572532,831101,35253,44215,16353,786886,71474,910569,831101,,,,,0,0,0,0
1650441798.7932875,public.usertable,787224,71486,995590144,16782,public,usertable,1,0,2084150,2572978,831450,35257,44226,16354,787224,71486,910933,831450,,,,,0,0,0,0
1650441799.8228624,public.usertable,787626,71488,996081664,16782,public,usertable,1,0,2085186,2573247,831853,35258,44227,16355,787626,71488,911338,831853,,,,,0,0,0,0
1650441800.8515933,public.usertable,788010,71499,996564992,16782,public,usertable,1,0,2086198,2573602,832243,35263,44233,16359,788010,71499,911739,832243,,,,,0,0,0,0
1650441801.8817074,public.usertable,788402,71503,997015552,16782,public,usertable,1,0,2087298,2573751,832636,35266,44234,16361,788402,71503,912136,832636,,,,,0,0,0,0
1650441802.9166038,public.usertable,788783,71511,997490688,16782,public,usertable,1,0,2088359,2574211,833019,35272,44236,16364,788783,71511,912527,833019,,,,,0,0,0,0
1650441803.9483485,public.usertable,789162,71513,997957632,16782,public,usertable,1,0,2089322,2574632,833402,35276,44240,16364,789162,71513,912918,833402,,,,,0,0,0,0
1650441804.9780617,public.usertable,789733,71528,998424576,16782,public,usertable,1,0,2090876,2574875,833985,35279,44252,16364,789733,71528,913516,833985,,,,,0,0,0,0
1650441806.0090544,public.usertable,790129,71533,998899712,16782,public,usertable,1,0,2092035,2574988,834386,35279,44257,16364,790129,71533,913922,834386,,,,,0,0,0,0
1650441807.0420074,public.usertable,790521,71530,999383040,16782,public,usertable,1,0,2093153,2575372,834780,35282,44259,16366,790521,71530,914321,834780,,,,,0,0,0,0
1650441808.0719082,public.usertable,790887,71546,999841792,16782,public,usertable,1,0,2094309,2575563,835160,35284,44273,16366,790887,71546,914717,835160,,,,,0,0,0,0
1650441809.100373,public.usertable,791289,71558,1000349696,16782,public,usertable,1,0,2095483,2575672,835571,35287,44282,16368,791289,71558,915140,835571,,,,,0,0,0,0
1650441810.1300108,public.usertable,791701,71568,1000857600,16782,public,usertable,1,0,2096586,2576102,835992,35290,44291,16368,791701,71568,915573,835992,,,,,0,0,0,0
1650441811.1599636,public.usertable,792091,71578,1001332736,16782,public,usertable,1,0,2097726,2576182,836389,35293,44298,16370,792091,71578,915980,836389,,,,,0,0,0,0
1650441812.190923,public.usertable,792489,71590,1001816064,16782,public,usertable,1,0,2098752,2576513,836793,35299,44304,16376,792489,71590,916396,836793,,,,,0,0,0,0
1650441813.222445,public.usertable,792870,71599,1002291200,16782,public,usertable,1,0,2099897,2576953,837179,35303,44309,16377,792870,71599,916791,837179,,,,,0,0,0,0
1650441814.2535002,public.usertable,793295,71605,1002807296,16782,public,usertable,1,0,2100992,2577137,837609,35304,44314,16377,793295,71605,917227,837609,,,,,0,0,0,0
1650441815.2824142,public.usertable,793712,71617,1003307008,16782,public,usertable,1,0,2102233,2577283,838032,35310,44320,16382,793712,71617,917662,838032,,,,,0,0,0,0
1650441816.3129828,public.usertable,794118,71631,1003823104,16782,public,usertable,1,0,2103469,2577596,838446,35316,44328,16385,794118,71631,918090,838446,,,,,0,0,0,0
1650441817.3443863,public.usertable,794541,71644,1004347392,16782,public,usertable,1,0,2104598,2578360,838875,35323,44334,16389,794541,71644,918532,838875,,,,,0,0,0,0
1650441818.3735797,public.usertable,794954,71652,1004847104,16782,public,usertable,1,0,2105622,2578947,839291,35330,44337,16391,794954,71652,918958,839291,,,,,0,0,0,0
1650441819.4064727,public.usertable,795379,71662,1005363200,16782,public,usertable,1,0,2106711,2579188,839722,35334,44343,16392,795379,71662,919399,839722,,,,,0,0,0,0
1650441820.436763,public.usertable,795769,71667,1005854720,16782,public,usertable,1,0,2107742,2579463,840118,35337,44349,16394,795769,71667,919804,840118,,,,,0,0,0,0
1650441821.4652138,public.usertable,796161,71674,1006329856,16782,public,usertable,1,0,2108803,2579712,840518,35339,44357,16395,796161,71674,920214,840518,,,,,0,0,0,0
1650441822.4937365,public.usertable,796583,71681,1006854144,16782,public,usertable,1,0,2109920,2579876,840944,35342,44361,16396,796583,71681,920647,840944,,,,,0,0,0,0
1650441823.523621,public.usertable,797230,71691,1007386624,16782,public,usertable,1,0,2111701,2580429,841597,35348,44367,16399,797230,71691,921312,841597,,,,,0,0,0,0
1650441824.553162,public.usertable,797655,71702,1007894528,16782,public,usertable,1,0,2112866,2580673,842028,35353,44373,16400,797655,71702,921754,842028,,,,,0,0,0,0
1650441825.5824118,public.usertable,798045,71708,1008377856,16782,public,usertable,1,0,2113877,2581462,842423,35354,44378,16400,798045,71708,922155,842423,,,,,0,0,0,0
1650441826.6152713,public.usertable,798461,71708,1008877568,16782,public,usertable,1,0,2114975,2582093,842840,35355,44379,16401,798461,71708,922574,842840,,,,,0,0,0,0
1650441827.6454182,public.usertable,798843,71716,1009360896,16782,public,usertable,1,0,2116014,2582400,843225,35360,44382,16403,798843,71716,922967,843225,,,,,0,0,0,0
1650441828.6766202,public.usertable,799242,71725,1009844224,16782,public,usertable,1,0,2117095,2582487,843630,35363,44388,16404,799242,71725,923381,843630,,,,,0,0,0,0
1650441829.7073095,public.usertable,799636,71736,1010327552,16782,public,usertable,1,0,2118214,2582800,844032,35366,44396,16404,799636,71736,923794,844032,,,,,0,0,0,0
1650441830.7384741,public.usertable,800068,71737,1010868224,16782,public,usertable,1,0,2119453,2583106,844472,35369,44404,16406,800068,71737,924245,844472,,,,,0,0,0,0
1650441831.7702963,public.usertable,800501,71750,1011400704,16782,public,usertable,1,0,2120667,2583284,844909,35378,44408,16411,800501,71750,924695,844909,,,,,0,0,0,0
1650441832.8015544,public.usertable,800924,71761,1011933184,16782,public,usertable,1,0,2121856,2583456,845343,35381,44419,16411,800924,71761,925143,845343,,,,,0,0,0,0
1650441833.8356388,public.usertable,801344,71765,1012424704,16782,public,usertable,1,0,2122990,2583809,845767,35386,44423,16414,801344,71765,925576,845767,,,,,0,0,0,0
1650441834.8638587,public.usertable,801768,71772,1012948992,16782,public,usertable,1,0,2124022,2584105,846193,35391,44425,16415,801768,71772,926009,846193,,,,,0,0,0,0
1650441835.8938406,public.usertable,802159,71774,1013424128,16782,public,usertable,1,0,2125181,2584651,846591,35391,44432,16415,802159,71774,926414,846591,,,,,0,0,0,0
1650441836.923435,public.usertable,802581,71784,1013964800,16782,public,usertable,1,0,2126276,2585150,847018,35396,44437,16415,802581,71784,926851,847018,,,,,0,0,0,0
1650441837.952718,public.usertable,803005,71793,1014497280,16782,public,usertable,1,0,2127535,2585319,847447,35400,44442,16417,803005,71793,927289,847447,,,,,0,0,0,0
1650441838.9857943,public.usertable,803436,71808,1014996992,16782,public,usertable,1,0,2128640,2585553,847885,35408,44449,16422,803436,71808,927742,847885,,,,,0,0,0,0
1650441840.0183008,public.usertable,803869,71813,1015513088,16782,public,usertable,1,0,2129770,2585663,848321,35410,44452,16423,803869,71813,928183,848321,,,,,0,0,0,0
1650441841.0472896,public.usertable,804481,71826,1016029184,16782,public,usertable,1,0,2131346,2585896,848945,35415,44464,16425,804481,71826,928824,848945,,,,,0,0,0,0
1650441842.0780354,public.usertable,804880,71836,1016512512,16782,public,usertable,1,0,2132440,2586004,849348,35421,44468,16429,804880,71836,929237,849348,,,,,0,0,0,0
1650441843.107591,public.usertable,805283,71842,1016995840,16782,public,usertable,1,0,2133560,2586107,849753,35425,44470,16432,805283,71842,929648,849753,,,,,0,0,0,0
1650441844.1361885,public.usertable,805671,71848,1017479168,16782,public,usertable,1,0,2134657,2586348,850146,35429,44475,16433,805671,71848,930050,850146,,,,,0,0,0,0
1650441845.1673756,public.usertable,806056,71858,1017946112,16782,public,usertable,1,0,2135638,2586652,850540,35432,44484,16434,806056,71858,930456,850540,,,,,0,0,0,0
1650441846.1960752,public.usertable,806450,71865,1018437632,16782,public,usertable,1,0,2136682,2586944,850939,35438,44489,16437,806450,71865,930866,850939,,,,,0,0,0,0
1650441847.2288437,public.usertable,806856,71876,1018937344,16782,public,usertable,1,0,2137730,2587302,851353,35442,44497,16440,806856,71876,931292,851353,,,,,0,0,0,0
1650441848.2578905,public.usertable,807264,71879,1019428864,16782,public,usertable,1,0,2138875,2587792,851766,35445,44502,16440,807264,71879,931713,851766,,,,,0,0,0,0
1650441849.2862866,public.usertable,807660,71886,1019920384,16782,public,usertable,1,0,2139912,2588053,852167,35447,44507,16441,807660,71886,932121,852167,,,,,0,0,0,0
1650441850.3189104,public.usertable,808055,71896,1020403712,16782,public,usertable,1,0,2140987,2588391,852566,35453,44511,16445,808055,71896,932530,852566,,,,,0,0,0,0
1650441851.348935,public.usertable,808427,71904,1020846080,16782,public,usertable,1,0,2141991,2588554,852946,35453,44519,16445,808427,71904,932918,852946,,,,,0,0,0,0
1650441852.3801649,public.usertable,808803,71912,1021329408,16782,public,usertable,1,0,2143035,2588654,853324,35459,44521,16448,808803,71912,933304,853324,,,,,0,0,0,0
1650441853.4095767,public.usertable,809211,71920,1021812736,16782,public,usertable,1,0,2144070,2589012,853734,35465,44523,16448,809211,71920,933722,853734,,,,,0,0,0,0
1650441854.440226,public.usertable,809598,71927,1022287872,16782,public,usertable,1,0,2145135,2589249,854125,35468,44527,16451,809598,71927,934120,854125,,,,,0,0,0,0
1650441855.4698136,public.usertable,809985,71932,1022754816,16782,public,usertable,1,0,2146157,2589489,854515,35470,44530,16452,809985,71932,934515,854515,,,,,0,0,0,0
1650441856.5012875,public.usertable,810358,71945,1023221760,16782,public,usertable,1,0,2147272,2589646,854897,35476,44539,16454,810358,71945,934912,854897,,,,,0,0,0,0
1650441857.530344,public.usertable,810750,71953,1023721472,16782,public,usertable,1,0,2148404,2589682,855296,35477,44546,16455,810750,71953,935319,855296,,,,,0,0,0,0
1650441858.559941,public.usertable,811170,71954,1024221184,16782,public,usertable,1,0,2149585,2589986,855718,35480,44548,16457,811170,71954,935746,855718,,,,,0,0,0,0
1650441859.5897443,public.usertable,811787,71968,1024729088,16782,public,usertable,1,0,2151233,2590345,856340,35489,44553,16460,811787,71968,936382,856340,,,,,0,0,0,0
1650441860.6196325,public.usertable,812168,71970,1025187840,16782,public,usertable,1,0,2152166,2590639,856723,35489,44555,16460,812168,71970,936767,856723,,,,,0,0,0,0
1650441861.650318,public.usertable,812576,71982,1025695744,16782,public,usertable,1,0,2153313,2590784,857139,35493,44563,16462,812576,71982,937195,857139,,,,,0,0,0,0
1650441862.6795733,public.usertable,812995,71991,1026195456,16782,public,usertable,1,0,2154433,2590973,857564,35496,44569,16463,812995,71991,937629,857564,,,,,0,0,0,0
1650441863.7107272,public.usertable,813410,71999,1026703360,16782,public,usertable,1,0,2155609,2591083,857981,35502,44571,16466,813410,71999,938054,857981,,,,,0,0,0,0
1650441864.7412083,public.usertable,813828,72005,1027227648,16782,public,usertable,1,0,2156717,2591436,858401,35506,44573,16468,813828,72005,938480,858401,,,,,0,0,0,0
1650441865.7702487,public.usertable,814253,72012,1027751936,16782,public,usertable,1,0,2157996,2591835,858833,35512,44580,16471,814253,72012,938925,858833,,,,,0,0,0,0
1650441866.8008301,public.usertable,814682,72021,1028276224,16782,public,usertable,1,0,2159230,2592555,859269,35517,44587,16475,814682,72021,939373,859269,,,,,0,0,0,0
1650441867.8337963,public.usertable,815117,72028,1028800512,16782,public,usertable,1,0,2160494,2592829,859708,35520,44591,16476,815117,72028,939819,859708,,,,,0,0,0,0
1650441868.865359,public.usertable,815537,72032,1029308416,16782,public,usertable,1,0,2161585,2593430,860130,35523,44593,16476,815537,72032,940246,860130,,,,,0,0,0,0
1650441869.8973916,public.usertable,815936,72047,1029791744,16782,public,usertable,1,0,2162715,2593849,860539,35528,44603,16479,815936,72047,940670,860539,,,,,0,0,0,0
1650441870.9289238,public.usertable,816327,72051,1030266880,16782,public,usertable,1,0,2163870,2594042,860931,35531,44604,16480,816327,72051,941066,860931,,,,,0,0,0,0
1650441871.9594314,public.usertable,816735,72056,1030758400,16782,public,usertable,1,0,2164969,2594477,861341,35534,44606,16481,816735,72056,941481,861341,,,,,0,0,0,0
1650441872.9874203,public.usertable,817116,72064,1031217152,16782,public,usertable,1,0,2166074,2594789,861728,35538,44612,16485,817116,72064,941878,861728,,,,,0,0,0,0
1650441874.0174038,public.usertable,817482,72075,1031692288,16782,public,usertable,1,0,2167079,2595027,862100,35543,44618,16487,817482,72075,942261,862100,,,,,0,0,0,0
1650441875.0464914,public.usertable,817895,72081,1032175616,16782,public,usertable,1,0,2168292,2595281,862518,35544,44623,16487,817895,72081,942685,862518,,,,,0,0,0,0
1650441876.0756304,public.usertable,818279,72082,1032658944,16782,public,usertable,1,0,2169336,2595605,862906,35544,44627,16487,818279,72082,943077,862906,,,,,0,0,0,0
1650441877.105392,public.usertable,818676,72092,1033117696,16782,public,usertable,1,0,2170267,2595739,863309,35548,44633,16490,818676,72092,943490,863309,,,,,0,0,0,0
1650441878.1349797,public.usertable,819230,72105,1033568256,16782,public,usertable,1,0,2171693,2596128,863870,35554,44640,16493,819230,72105,944064,863870,,,,,0,0,0,0
1650441879.167986,public.usertable,819630,72110,1034067968,16782,public,usertable,1,0,2172774,2596553,864272,35559,44642,16495,819630,72110,944473,864272,,,,,0,0,0,0
1650441880.1971748,public.usertable,820036,72117,1034567680,16782,public,usertable,1,0,2173875,2596865,864685,35561,44649,16496,820036,72117,944895,864685,,,,,0,0,0,0
1650441881.227449,public.usertable,820397,72123,1035018240,16782,public,usertable,1,0,2174851,2597460,865054,35565,44657,16499,820397,72123,945276,865054,,,,,0,0,0,0
1650441882.2571142,public.usertable,820838,72126,1035550720,16782,public,usertable,1,0,2175896,2597904,865499,35566,44661,16499,820838,72126,945726,865499,,,,,0,0,0,0
1650441883.289052,public.usertable,821259,72133,1036058624,16782,public,usertable,1,0,2177046,2598143,865923,35572,44664,16501,821259,72133,946159,865923,,,,,0,0,0,0
1650441884.3180728,public.usertable,821642,72137,1036533760,16782,public,usertable,1,0,2178109,2598387,866308,35574,44666,16501,821642,72137,946548,866308,,,,,0,0,0,0
1650441885.349551,public.usertable,822041,72140,1037008896,16782,public,usertable,1,0,2179202,2598527,866709,35577,44668,16502,822041,72140,946954,866709,,,,,0,0,0,0
1650441886.3782427,public.usertable,822440,72149,1037508608,16782,public,usertable,1,0,2180513,2598660,867112,35582,44672,16505,822440,72149,947366,867112,,,,,0,0,0,0
1650441887.407131,public.usertable,822837,72162,1038000128,16782,public,usertable,1,0,2181612,2599040,867518,35591,44681,16509,822837,72162,947790,867518,,,,,0,0,0,0
1650441888.435807,public.usertable,823242,72167,1038508032,16782,public,usertable,1,0,2182652,2599215,867927,35592,44685,16510,823242,72167,948204,867927,,,,,0,0,0,0
1650441889.4639866,public.usertable,823671,72178,1039024128,16782,public,usertable,1,0,2183737,2599390,868362,35597,44691,16514,823671,72178,948650,868362,,,,,0,0,0,0
1650441890.4946406,public.usertable,824087,72185,1039499264,16782,public,usertable,1,0,2184846,2599563,868782,35600,44695,16515,824087,72185,949077,868782,,,,,0,0,0,0
1650441891.526467,public.usertable,824456,72194,1039998976,16782,public,usertable,1,0,2185802,2599771,869154,35606,44698,16516,824456,72194,949458,869154,,,,,0,0,0,0
1650441892.5563931,public.usertable,824898,72196,1040539648,16782,public,usertable,1,0,2186855,2600042,869598,35608,44700,16517,824898,72196,949906,869598,,,,,0,0,0,0
1650441893.587553,public.usertable,825354,72201,1041072128,16782,public,usertable,1,0,2188071,2600459,870056,35615,44702,16520,825354,72201,950373,870056,,,,,0,0,0,0
1650441894.6185834,public.usertable,825772,72208,1041580032,16782,public,usertable,1,0,2189207,2600880,870479,35617,44707,16521,825772,72208,950803,870479,,,,,0,0,0,0
1650441895.6475637,public.usertable,826193,72211,1042112512,16782,public,usertable,1,0,2190379,2601353,870903,35621,44710,16522,826193,72211,951234,870903,,,,,0,0,0,0
1650441896.6782384,public.usertable,826805,72224,1042595840,16782,public,usertable,1,0,2192031,2602103,871529,35622,44724,16523,826805,72224,951875,871529,,,,,0,0,0,0
1650441897.7069097,public.usertable,827209,72242,1043095552,16782,public,usertable,1,0,2193171,2602272,871944,35629,44735,16528,827209,72242,952308,871944,,,,,0,0,0,0
1650441898.7365048,public.usertable,827627,72260,1043619840,16782,public,usertable,1,0,2194243,2602623,872371,35638,44744,16531,827627,72260,952753,872371,,,,,0,0,0,0
1650441899.7654054,public.usertable,828038,72262,1044111360,16782,public,usertable,1,0,2195328,2603104,872786,35641,44748,16531,828038,72262,953175,872786,,,,,0,0,0,0
1650441900.7964418,public.usertable,828458,72259,1044627456,16782,public,usertable,1,0,2196492,2603289,873207,35644,44749,16532,828458,72259,953600,873207,,,,,0,0,0,0
1650441901.8259113,public.usertable,828844,72268,1045110784,16782,public,usertable,1,0,2197474,2603587,873600,35646,44756,16534,828844,72268,954002,873600,,,,,0,0,0,0
1650441902.853931,public.usertable,829273,72268,1045602304,16782,public,usertable,1,0,2198664,2603880,874031,35650,44758,16536,829273,72268,954439,874031,,,,,0,0,0,0
1650441903.88297,public.usertable,829656,72281,1046085632,16782,public,usertable,1,0,2199746,2603937,874420,35657,44764,16539,829656,72281,954841,874420,,,,,0,0,0,0
1650441904.911904,public.usertable,830046,72288,1046560768,16782,public,usertable,1,0,2200924,2604032,874814,35660,44768,16540,830046,72288,955242,874814,,,,,0,0,0,0
1650441905.9400122,public.usertable,830459,72291,1047068672,16782,public,usertable,1,0,2201943,2604442,875231,35662,44772,16541,830459,72291,955665,875231,,,,,0,0,0,0
1650441906.9696348,public.usertable,830882,72292,1047601152,16782,public,usertable,1,0,2203198,2604566,875658,35665,44776,16544,830882,72292,956099,875658,,,,,0,0,0,0
1650441907.9980435,public.usertable,831307,72295,1048084480,16782,public,usertable,1,0,2204413,2604916,876085,35668,44778,16544,831307,72295,956531,876085,,,,,0,0,0,0
1650441909.0276558,public.usertable,831688,72298,1048576000,16782,public,usertable,1,0,2205377,2605143,876468,35670,44780,16544,831688,72298,956918,876468,,,,,0,0,0,0
1650441910.0566099,public.usertable,832123,72305,1049108480,16782,public,usertable,1,0,2206586,2605500,876906,35674,44783,16545,832123,72305,957363,876906,,,,,0,0,0,0
1650441911.0896323,public.usertable,832538,72315,1049600000,16782,public,usertable,1,0,2207752,2605612,877323,35682,44785,16546,832538,72315,957790,877323,,,,,0,0,0,0
1650441912.12028,public.usertable,832929,72325,1050083328,16782,public,usertable,1,0,2208849,2605935,877718,35688,44789,16548,832929,72325,958195,877718,,,,,0,0,0,0
1650441913.1498733,public.usertable,833337,72334,1050591232,16782,public,usertable,1,0,2209941,2605972,878129,35694,44792,16551,833337,72334,958615,878129,,,,,0,0,0,0
1650441914.1789472,public.usertable,833759,72345,1051090944,16782,public,usertable,1,0,2211039,2606205,878557,35699,44798,16554,833759,72345,959054,878557,,,,,0,0,0,0
1650441915.2099996,public.usertable,834354,72351,1051582464,16782,public,usertable,1,0,2212640,2606736,879157,35702,44803,16555,834354,72351,959662,879157,,,,,0,0,0,0
1650441916.2388752,public.usertable,834746,72360,1052057600,16782,public,usertable,1,0,2213707,2606892,879555,35706,44809,16555,834746,72360,960070,879555,,,,,0,0,0,0
1650441917.2674859,public.usertable,835136,72364,1052532736,16782,public,usertable,1,0,2214776,2607311,879948,35709,44812,16556,835136,72364,960469,879948,,,,,0,0,0,0
1650441918.2972403,public.usertable,835571,72370,1053065216,16782,public,usertable,1,0,2215977,2607866,880387,35714,44816,16557,835571,72370,960917,880387,,,,,0,0,0,0
1650441919.3260114,public.usertable,835988,72380,1053573120,16782,public,usertable,1,0,2217149,2608051,880808,35720,44820,16559,835988,72380,961348,880808,,,,,0,0,0,0
1650441920.355608,public.usertable,836424,72390,1054113792,16782,public,usertable,1,0,2218272,2608298,881251,35725,44827,16561,836424,72390,961803,881251,,,,,0,0,0,0
1650441921.384894,public.usertable,836820,72396,1054564352,16782,public,usertable,1,0,2219335,2608512,881651,35731,44831,16562,836820,72396,962213,881651,,,,,0,0,0,0
1650441922.4147778,public.usertable,837225,72397,1055072256,16782,public,usertable,1,0,2220376,2608820,882057,35734,44832,16565,837225,72397,962623,882057,,,,,0,0,0,0
1650441923.4444292,public.usertable,837634,72411,1055596544,16782,public,usertable,1,0,2221547,2609079,882474,35743,44840,16571,837634,72411,963057,882474,,,,,0,0,0,0
1650441924.4730263,public.usertable,838103,72415,1056161792,16782,public,usertable,1,0,2222698,2609386,882945,35748,44842,16573,838103,72415,963535,882945,,,,,0,0,0,0
1650441925.5035877,public.usertable,838522,72430,1056677888,16782,public,usertable,1,0,2223913,2609611,883372,35755,44850,16575,838522,72430,963977,883372,,,,,0,0,0,0
1650441926.5337214,public.usertable,838969,72440,1057218560,16782,public,usertable,1,0,2225249,2609793,883826,35758,44857,16576,838969,72440,964441,883826,,,,,0,0,0,0
1650441927.5632339,public.usertable,839393,72449,1057734656,16782,public,usertable,1,0,2226431,2609949,884257,35760,44864,16578,839393,72449,964881,884257,,,,,0,0,0,0
1650441928.5924928,public.usertable,839807,72456,1058226176,16782,public,usertable,1,0,2227536,2610101,884674,35764,44867,16580,839807,72456,965305,884674,,,,,0,0,0,0
1650441929.626324,public.usertable,840205,72463,1058734080,16782,public,usertable,1,0,2228626,2610492,885079,35766,44874,16581,840205,72463,965719,885079,,,,,0,0,0,0
1650441930.656156,public.usertable,840627,72474,1059274752,16782,public,usertable,1,0,2229670,2610856,885509,35773,44882,16583,840627,72474,966164,885509,,,,,0,0,0,0
1650441931.6858034,public.usertable,841056,72481,1059758080,16782,public,usertable,1,0,2230827,2610939,885941,35777,44885,16586,841056,72481,966603,885941,,,,,0,0,0,0
1650441932.7158718,public.usertable,841437,72491,1060241408,16782,public,usertable,1,0,2231930,2611178,886328,35782,44891,16590,841437,72491,967001,886328,,,,,0,0,0,0
1650441933.7446396,public.usertable,841841,72498,1060724736,16782,public,usertable,1,0,2232964,2611317,886736,35786,44895,16591,841841,72498,967417,886736,,,,,0,0,0,0
1650441934.7748992,public.usertable,842461,72512,1061240832,16782,public,usertable,1,0,2234489,2611425,887364,35792,44903,16594,842461,72512,968059,887364,,,,,0,0,0,0
1650441935.8053048,public.usertable,842882,72518,1061756928,16782,public,usertable,1,0,2235643,2611571,887787,35796,44905,16595,842882,72518,968488,887787,,,,,0,0,0,0
1650441936.837808,public.usertable,843288,72526,1062248448,16782,public,usertable,1,0,2236775,2611820,888199,35800,44911,16596,843288,72526,968910,888199,,,,,0,0,0,0
1650441937.8659606,public.usertable,843647,72529,1062690816,16782,public,usertable,1,0,2237814,2612156,888561,35804,44914,16597,843647,72529,969279,888561,,,,,0,0,0,0
1650441938.895481,public.usertable,844030,72535,1063149568,16782,public,usertable,1,0,2238908,2612320,888947,35807,44917,16598,844030,72535,969671,888947,,,,,0,0,0,0
1650441939.9258225,public.usertable,844420,72541,1063641088,16782,public,usertable,1,0,2240046,2612493,889339,35811,44919,16600,844420,72541,970069,889339,,,,,0,0,0,0
1650441940.9571323,public.usertable,844821,72546,1064116224,16782,public,usertable,1,0,2241179,2612865,889743,35816,44922,16602,844821,72546,970481,889743,,,,,0,0,0,0
1650441941.9865499,public.usertable,845216,72546,1064591360,16782,public,usertable,1,0,2242315,2613135,890142,35818,44926,16604,845216,72546,970886,890142,,,,,0,0,0,0
1650441943.0167074,public.usertable,845611,72550,1065099264,16782,public,usertable,1,0,2243452,2613418,890540,35819,44929,16605,845611,72550,971288,890540,,,,,0,0,0,0
1650441944.045371,public.usertable,846046,72554,1065590784,16782,public,usertable,1,0,2244611,2613569,890977,35821,44931,16606,846046,72554,971729,890977,,,,,0,0,0,0
1650441945.0796216,public.usertable,846436,72561,1066098688,16782,public,usertable,1,0,2245696,2613690,891371,35824,44935,16608,846436,72561,972130,891371,,,,,0,0,0,0
1650441946.1109755,public.usertable,846859,72570,1066590208,16782,public,usertable,1,0,2246756,2613929,891798,35829,44939,16611,846859,72570,972566,891798,,,,,0,0,0,0
1650441947.1401675,public.usertable,847254,72574,1067089920,16782,public,usertable,1,0,2247746,2614090,892198,35835,44944,16614,847254,72574,972977,892198,,,,,0,0,0,0
1650441948.1689987,public.usertable,847683,72576,1067622400,16782,public,usertable,1,0,2248818,2614301,892630,35840,44947,16614,847683,72576,973417,892630,,,,,0,0,0,0
1650441949.1977377,public.usertable,848110,72583,1068146688,16782,public,usertable,1,0,2250056,2614598,893060,35844,44950,16616,848110,72583,973854,893060,,,,,0,0,0,0
1650441950.2269185,public.usertable,848535,72595,1068670976,16782,public,usertable,1,0,2251214,2614787,893493,35848,44958,16618,848535,72595,974299,893493,,,,,0,0,0,0
1650441951.2564974,public.usertable,848985,72604,1069219840,16782,public,usertable,1,0,2252402,2615085,893946,35854,44961,16621,848985,72604,974761,893946,,,,,0,0,0,0
1650441952.2869473,public.usertable,849430,72603,1069703168,16782,public,usertable,1,0,2253575,2615200,894394,35855,44964,16622,849430,72603,975213,894394,,,,,0,0,0,0
1650441953.3187985,public.usertable,850007,72617,1070202880,16782,public,usertable,1,0,2255225,2615657,894979,35864,44972,16625,850007,72617,975815,894979,,,,,0,0,0,0
1650441954.3491652,public.usertable,850401,72623,1070694400,16782,public,usertable,1,0,2256292,2615971,895377,35868,44976,16627,850401,72623,976221,895377,,,,,0,0,0,0
1650441955.3794394,public.usertable,850814,72624,1071194112,16782,public,usertable,1,0,2257260,2616268,895793,35870,44979,16628,850814,72624,976642,895793,,,,,0,0,0,0
1650441956.4106786,public.usertable,851198,72638,1071661056,16782,public,usertable,1,0,2258340,2616564,896183,35878,44985,16633,851198,72638,977046,896183,,,,,0,0,0,0
1650441957.4418154,public.usertable,851596,72645,1072152576,16782,public,usertable,1,0,2259468,2616823,896587,35880,44991,16634,851596,72645,977458,896587,,,,,0,0,0,0
1650441958.4726813,public.usertable,851990,72650,1072635904,16782,public,usertable,1,0,2260556,2617066,896983,35883,44993,16635,851990,72650,977859,896983,,,,,0,0,0,0
1650441959.5049376,public.usertable,852385,72655,1073078272,16782,public,usertable,1,0,2261602,2617136,897380,35886,44995,16636,852385,72655,978261,897380,,,,,0,0,0,0
1650441960.5335646,public.usertable,852632,72658,1073389568,16782,public,usertable,1,0,2262262,2617206,897629,35889,44997,16637,852632,72658,978515,897629,,,,,0,0,0,0
1650441961.5673785,public.usertable,852976,72664,1073831936,16782,public,usertable,1,0,2263254,2617317,897978,35890,45002,16638,852976,72664,978870,897978,,,,,0,0,0,0
1650441962.5972722,public.usertable,853335,72668,1074257920,16782,public,usertable,1,0,2264089,2617612,898342,35891,45007,16639,853335,72668,979240,898342,,,,,0,0,0,0
1650441963.6264305,public.usertable,853691,72667,1074675712,16782,public,usertable,1,0,2265075,2617914,898699,35891,45008,16639,853691,72667,979598,898699,,,,,0,0,0,0
1650441964.6555693,public.usertable,854051,72672,1075134464,16782,public,usertable,1,0,2266025,2618603,899062,35895,45011,16641,854051,72672,979968,899062,,,,,0,0,0,0
1650441965.6872625,public.usertable,854407,72678,1075576832,16782,public,usertable,1,0,2266940,2618715,899424,35895,45017,16641,854407,72678,980336,899424,,,,,0,0,0,0
1650441966.7189221,public.usertable,854793,72681,1076051968,16782,public,usertable,1,0,2268019,2619116,899811,35898,45018,16644,854793,72681,980727,899811,,,,,0,0,0,0
1650441967.7513096,public.usertable,855193,72687,1076527104,16782,public,usertable,1,0,2269019,2619500,900217,35901,45024,16646,855193,72687,981142,900217,,,,,0,0,0,0
1650441968.7801461,public.usertable,855568,72691,1076985856,16782,public,usertable,1,0,2270019,2619515,900595,35902,45027,16647,855568,72691,981524,900595,,,,,0,0,0,0
1650441969.8091593,public.usertable,855969,72697,1077485568,16782,public,usertable,1,0,2271095,2619777,901001,35906,45032,16649,855969,72697,981939,901001,,,,,0,0,0,0
1650441970.8441312,public.usertable,856378,72708,1078009856,16782,public,usertable,1,0,2272196,2619978,901419,35908,45041,16651,856378,72708,982368,901419,,,,,0,0,0,0
1650441971.8753977,public.usertable,856996,72714,1078493184,16782,public,usertable,1,0,2273976,2620135,902040,35911,45044,16652,856996,72714,982995,902040,,,,,0,0,0,0
1650441972.9069588,public.usertable,857402,72725,1078992896,16782,public,usertable,1,0,2275120,2620492,902451,35917,45049,16654,857402,72725,983417,902451,,,,,0,0,0,0
1650441973.9365852,public.usertable,857816,72737,1079500800,16782,public,usertable,1,0,2276219,2620644,902872,35922,45056,16655,857816,72737,983850,902872,,,,,0,0,0,0
1650441974.9676266,public.usertable,858238,72741,1080016896,16782,public,usertable,1,0,2277281,2621493,903296,35924,45058,16657,858238,72741,984278,903296,,,,,0,0,0,0
1650441975.9988356,public.usertable,858656,72747,1080524800,16782,public,usertable,1,0,2278385,2621559,903719,35925,45063,16657,858656,72747,984707,903719,,,,,0,0,0,0
1650441977.0283122,public.usertable,859084,72754,1081049088,16782,public,usertable,1,0,2279619,2621939,904154,35929,45070,16660,859084,72754,985153,904154,,,,,0,0,0,0
1650441978.057739,public.usertable,859494,72761,1081540608,16782,public,usertable,1,0,2280711,2622146,904568,35934,45074,16663,859494,72761,985576,904568,,,,,0,0,0,0
1650441979.0885625,public.usertable,859922,72766,1082073088,16782,public,usertable,1,0,2281817,2622484,904999,35936,45077,16664,859922,72766,986012,904999,,,,,0,0,0,0
1650441980.1194952,public.usertable,860357,72770,1082597376,16782,public,usertable,1,0,2282824,2622517,905436,35938,45079,16665,860357,72770,986453,905436,,,,,0,0,0,0
1650441981.1497705,public.usertable,860771,72778,1083105280,16782,public,usertable,1,0,2283966,2622687,905853,35943,45082,16668,860771,72778,986878,905853,,,,,0,0,0,0
1650441982.1802316,public.usertable,861186,72781,1083621376,16782,public,usertable,1,0,2285129,2623182,906274,35943,45088,16668,861186,72781,987305,906274,,,,,0,0,0,0
1650441983.2121139,public.usertable,861593,72789,1084104704,16782,public,usertable,1,0,2286248,2623452,906687,35945,45094,16669,861593,72789,987726,906687,,,,,0,0,0,0
1650441984.2417254,public.usertable,862025,72796,1084637184,16782,public,usertable,1,0,2287416,2623560,907124,35947,45099,16669,862025,72796,988170,907124,,,,,0,0,0,0
1650441985.2697973,public.usertable,862459,72803,1085169664,16782,public,usertable,1,0,2288558,2623739,907562,35950,45103,16671,862459,72803,988615,907562,,,,,0,0,0,0
1650441986.3001688,public.usertable,862904,72813,1085710336,16782,public,usertable,1,0,2289674,2624826,908012,35955,45108,16673,862904,72813,989075,908012,,,,,0,0,0,0
1650441987.3288493,public.usertable,863353,72814,1086251008,16782,public,usertable,1,0,2290858,2625293,908465,35958,45112,16674,863353,72814,989535,908465,,,,,0,0,0,0
1650441988.3610408,public.usertable,863768,72827,1086758912,16782,public,usertable,1,0,2291888,2625409,908885,35966,45117,16677,863768,72827,989968,908885,,,,,0,0,0,0
1650441989.3897066,public.usertable,864176,72835,1087250432,16782,public,usertable,1,0,2292983,2625660,909297,35970,45121,16678,864176,72835,990388,909297,,,,,0,0,0,0
1650441990.4206455,public.usertable,864806,72852,1087782912,16782,public,usertable,1,0,2294672,2626135,909940,35974,45134,16679,864806,72852,991048,909940,,,,,0,0,0,0
1650441991.4527755,public.usertable,865221,72856,1088290816,16782,public,usertable,1,0,2295821,2626523,910358,35977,45137,16681,865221,72856,991472,910358,,,,,0,0,0,0
1650441992.482955,public.usertable,865625,72865,1088782336,16782,public,usertable,1,0,2296917,2626838,910765,35983,45140,16685,865625,72865,991888,910765,,,,,0,0,0,0
1650441993.5141594,public.usertable,866010,72870,1089232896,16782,public,usertable,1,0,2297968,2627326,911153,35985,45143,16686,866010,72870,992281,911153,,,,,0,0,0,0
1650441994.5473127,public.usertable,866428,72877,1089740800,16782,public,usertable,1,0,2299019,2627659,911576,35989,45148,16689,866428,72877,992713,911576,,,,,0,0,0,0
1650441995.5786705,public.usertable,866853,72884,1090273280,16782,public,usertable,1,0,2300146,2627804,912006,35991,45153,16690,866853,72884,993150,912006,,,,,0,0,0,0
1650441996.6075196,public.usertable,867262,72893,1090756608,16782,public,usertable,1,0,2301268,2628822,912422,35993,45160,16691,867262,72893,993575,912422,,,,,0,0,0,0
1650441997.6378758,public.usertable,867661,72898,1091223552,16782,public,usertable,1,0,2302362,2629348,912825,35996,45164,16694,867661,72898,993985,912825,,,,,0,0,0,0
1650441998.6666763,public.usertable,868022,72909,1091690496,16782,public,usertable,1,0,2303279,2629498,913191,36002,45169,16698,868022,72909,994362,913191,,,,,0,0,0,0
1650441999.6959667,public.usertable,868430,72914,1092182016,16782,public,usertable,1,0,2304429,2629731,913601,36005,45171,16699,868430,72914,994777,913601,,,,,0,0,0,0
1650442000.7275918,public.usertable,868840,72920,1092681728,16782,public,usertable,1,0,2305529,2629785,914015,36007,45175,16701,868840,72920,995197,914015,,,,,0,0,0,0
1650442001.7585542,public.usertable,869229,72933,1093148672,16782,public,usertable,1,0,2306672,2630097,914409,36015,45180,16705,869229,72933,995604,914409,,,,,0,0,0,0
1650442002.7894077,public.usertable,869633,72939,1093656576,16782,public,usertable,1,0,2307754,2630433,914817,36018,45184,16707,869633,72939,996019,914817,,,,,0,0,0,0
1650442003.819926,public.usertable,870049,72947,1094172672,16782,public,usertable,1,0,2308759,2630837,915238,36021,45189,16707,870049,72947,996448,915238,,,,,0,0,0,0
1650442004.8498256,public.usertable,870475,72953,1094680576,16782,public,usertable,1,0,2309862,2630995,915667,36024,45192,16709,870475,72953,996883,915667,,,,,0,0,0,0
1650442005.8792238,public.usertable,870888,72964,1095180288,16782,public,usertable,1,0,2311004,2631133,916088,36027,45200,16711,870888,72964,997315,916088,,,,,0,0,0,0
1650442006.9084017,public.usertable,871279,72971,1095655424,16782,public,usertable,1,0,2312080,2631195,916483,36030,45204,16712,871279,72971,997717,916483,,,,,0,0,0,0
1650442007.936598,public.usertable,871668,72976,1096146944,16782,public,usertable,1,0,2313128,2631546,916877,36032,45209,16713,871668,72976,998118,916877,,,,,0,0,0,0
1650442008.9647222,public.usertable,872071,72981,1096638464,16782,public,usertable,1,0,2314297,2632118,917286,36033,45215,16714,872071,72981,998534,917286,,,,,0,0,0,0
1650442009.9938052,public.usertable,872707,72978,1097154560,16782,public,usertable,1,0,2316038,2633029,917925,36036,45218,16715,872707,72978,999179,917925,,,,,0,0,0,0
1650442011.0248868,public.usertable,873096,72996,1097654272,16782,public,usertable,1,0,2317235,2633337,918324,36044,45228,16715,873096,72996,999596,918324,,,,,0,0,0,0
1650442012.0542471,public.usertable,873517,73004,1098162176,16782,public,usertable,1,0,2318369,2633392,918748,36049,45231,16717,873517,73004,1000028,918748,,,,,0,0,0,0
1650442013.086679,public.usertable,873937,73012,1098678272,16782,public,usertable,1,0,2319511,2633559,919174,36051,45237,16717,873937,73012,1000462,919174,,,,,0,0,0,0
1650442014.1171877,public.usertable,874345,73015,1099169792,16782,public,usertable,1,0,2320735,2633932,919585,36053,45240,16718,874345,73015,1000878,919585,,,,,0,0,0,0
1650442015.1468184,public.usertable,874770,73025,1099694080,16782,public,usertable,1,0,2321861,2634192,920016,36057,45246,16719,874770,73025,1001319,920016,,,,,0,0,0,0
1650442016.1746223,public.usertable,875192,73034,1100210176,16782,public,usertable,1,0,2322951,2634695,920445,36059,45253,16719,875192,73034,1001757,920445,,,,,0,0,0,0
1650442017.2039511,public.usertable,875606,73040,1100726272,16782,public,usertable,1,0,2324150,2634760,920862,36062,45256,16720,875606,73040,1002180,920862,,,,,0,0,0,0
1650442018.2341356,public.usertable,876029,73045,1101242368,16782,public,usertable,1,0,2325379,2635074,921288,36064,45259,16721,876029,73045,1002611,921288,,,,,0,0,0,0
1650442019.2637696,public.usertable,876439,73059,1101750272,16782,public,usertable,1,0,2326481,2635335,921705,36071,45266,16723,876439,73059,1003042,921705,,,,,0,0,0,0
1650442020.2948508,public.usertable,876872,73060,1102266368,16782,public,usertable,1,0,2327739,2635447,922139,36073,45267,16724,876872,73060,1003479,922139,,,,,0,0,0,0
1650442021.3247964,public.usertable,877306,73066,1102782464,16782,public,usertable,1,0,2328838,2635460,922577,36075,45271,16725,877306,73066,1003923,922577,,,,,0,0,0,0
1650442022.3577487,public.usertable,877691,73072,1103265792,16782,public,usertable,1,0,2329911,2635841,922964,36079,45273,16726,877691,73072,1004316,922964,,,,,0,0,0,0
1650442023.3885312,public.usertable,878109,73079,1103765504,16782,public,usertable,1,0,2331019,2636327,923385,36083,45276,16729,878109,73079,1004744,923385,,,,,0,0,0,0
1650442024.4169614,public.usertable,878475,73089,1104216064,16782,public,usertable,1,0,2332038,2636462,923755,36089,45280,16731,878475,73089,1005124,923755,,,,,0,0,0,0
1650442025.4506032,public.usertable,878879,73098,1104740352,16782,public,usertable,1,0,2333046,2636670,924163,36094,45284,16734,878879,73098,1005541,924163,,,,,0,0,0,0
1650442026.482933,public.usertable,879318,73099,1105256448,16782,public,usertable,1,0,2334077,2637229,924608,36096,45290,16735,879318,73099,1005994,924608,,,,,0,0,0,0
1650442027.5144923,public.usertable,879748,73102,1105764352,16782,public,usertable,1,0,2335240,2637514,925044,36096,45296,16735,879748,73102,1006436,925044,,,,,0,0,0,0
1650442028.543501,public.usertable,880242,73112,1106124800,16782,public,usertable,1,0,2336590,2637848,925544,36100,45302,16739,880242,73112,1006946,925544,,,,,0,0,0,0
1650442029.5716078,public.usertable,880610,73114,1106583552,16782,public,usertable,1,0,2337615,2638081,925914,36100,45304,16739,880610,73114,1007318,925914,,,,,0,0,0,0
1650442030.5999815,public.usertable,881037,73120,1107099648,16782,public,usertable,1,0,2338791,2638361,926345,36102,45308,16739,881037,73120,1007755,926345,,,,,0,0,0,0
1650442031.6342838,public.usertable,881464,73129,1107632128,16782,public,usertable,1,0,2339896,2638709,926780,36105,45316,16739,881464,73129,1008201,926780,,,,,0,0,0,0
1650442032.6684337,public.usertable,881862,73137,1108115456,16782,public,usertable,1,0,2341108,2638819,927186,36107,45324,16739,881862,73137,1008617,927186,,,,,0,0,0,0
1650442033.6978502,public.usertable,882269,73147,1108598784,16782,public,usertable,1,0,2342181,2639175,927599,36111,45330,16742,882269,73147,1009040,927599,,,,,0,0,0,0
1650442034.7282865,public.usertable,882632,73151,1109024768,16782,public,usertable,1,0,2343230,2639505,927967,36118,45335,16745,882632,73151,1009420,927967,,,,,0,0,0,0
1650442035.7575998,public.usertable,882947,73156,1109434368,16782,public,usertable,1,0,2344039,2639530,928286,36119,45339,16745,882947,73156,1009744,928286,,,,,0,0,0,0
1650442036.7869554,public.usertable,883276,73164,1109827584,16782,public,usertable,1,0,2344953,2639815,928619,36123,45343,16748,883276,73164,1010085,928619,,,,,0,0,0,0
1650442037.816053,public.usertable,883615,73170,1110237184,16782,public,usertable,1,0,2345849,2639846,928960,36127,45345,16749,883615,73170,1010432,928960,,,,,0,0,0,0
1650442038.846927,public.usertable,883951,73177,1110663168,16782,public,usertable,1,0,2346771,2639880,929301,36129,45350,16750,883951,73177,1010780,929301,,,,,0,0,0,0
1650442039.8766413,public.usertable,884267,73184,1111056384,16782,public,usertable,1,0,2347560,2639932,929622,36131,45355,16752,884267,73184,1011108,929622,,,,,0,0,0,0
1650442040.9086819,public.usertable,884633,73194,1111498752,16782,public,usertable,1,0,2348634,2640143,929994,36135,45361,16752,884633,73194,1011490,929994,,,,,0,0,0,0
1650442041.9367752,public.usertable,885043,73197,1112039424,16782,public,usertable,1,0,2349655,2640539,930405,36137,45362,16754,885043,73197,1011904,930405,,,,,0,0,0,0
1650442042.9696436,public.usertable,885471,73202,1112563712,16782,public,usertable,1,0,2350872,2640637,930835,36140,45364,16754,885471,73202,1012339,930835,,,,,0,0,0,0
1650442043.9988356,public.usertable,885909,73209,1113096192,16782,public,usertable,1,0,2352054,2640892,931276,36144,45367,16755,885909,73209,1012787,931276,,,,,0,0,0,0
1650442045.0273333,public.usertable,886316,73212,1113571328,16782,public,usertable,1,0,2352995,2640939,931684,36146,45368,16757,886316,73212,1013198,931684,,,,,0,0,0,0
1650442046.0573082,public.usertable,886744,73210,1114120192,16782,public,usertable,1,0,2354173,2641074,932114,36146,45370,16757,886744,73210,1013630,932114,,,,,0,0,0,0
1650442047.087932,public.usertable,887436,73215,1114677248,16782,public,usertable,1,0,2356016,2641605,932815,36151,45379,16760,887436,73215,1014345,932815,,,,,0,0,0,0
1650442048.1188738,public.usertable,887871,73220,1115201536,16782,public,usertable,1,0,2357217,2641788,933252,36154,45381,16762,887871,73220,1014787,933252,,,,,0,0,0,0
1650442049.147321,public.usertable,888308,73223,1115725824,16782,public,usertable,1,0,2358411,2642090,933691,36155,45383,16762,888308,73223,1015229,933691,,,,,0,0,0,0
1650442050.1803854,public.usertable,888757,73226,1116282880,16782,public,usertable,1,0,2359691,2642426,934142,36156,45385,16762,888757,73226,1015683,934142,,,,,0,0,0,0
1650442051.2092962,public.usertable,889219,73231,1116839936,16782,public,usertable,1,0,2360926,2642605,934607,36158,45388,16763,889219,73231,1016153,934607,,,,,0,0,0,0
1650442052.2404459,public.usertable,889644,73237,1117356032,16782,public,usertable,1,0,2362083,2643153,935035,36169,45391,16770,889644,73237,1016595,935035,,,,,0,0,0,0
1650442053.269717,public.usertable,890074,73246,1117888512,16782,public,usertable,1,0,2363177,2643276,935469,36174,45395,16773,890074,73246,1017038,935469,,,,,0,0,0,0
1650442054.3026273,public.usertable,890508,73253,1118396416,16782,public,usertable,1,0,2364307,2643550,935906,36178,45398,16773,890508,73253,1017482,935906,,,,,0,0,0,0
1650442055.332093,public.usertable,890891,73259,1118887936,16782,public,usertable,1,0,2365312,2643703,936294,36179,45403,16773,890891,73259,1017876,936294,,,,,0,0,0,0
1650442056.362964,public.usertable,891303,73266,1119379456,16782,public,usertable,1,0,2366436,2643924,936710,36182,45407,16774,891303,73266,1018299,936710,,,,,0,0,0,0
1650442057.3957531,public.usertable,891695,73276,1119870976,16782,public,usertable,1,0,2367523,2644008,937108,36186,45413,16775,891695,73276,1018707,937108,,,,,0,0,0,0
1650442058.4257398,public.usertable,892109,73282,1120337920,16782,public,usertable,1,0,2368600,2644338,937523,36191,45414,16777,892109,73282,1019128,937523,,,,,0,0,0,0
1650442059.4551656,public.usertable,892496,73288,1120837632,16782,public,usertable,1,0,2369603,2644638,937914,36193,45418,16779,892496,73288,1019525,937914,,,,,0,0,0,0
1650442060.48525,public.usertable,892910,73290,1121337344,16782,public,usertable,1,0,2370667,2645008,938332,36197,45422,16781,892910,73290,1019951,938332,,,,,0,0,0,0
1650442061.516064,public.usertable,893299,73295,1121804288,16782,public,usertable,1,0,2371803,2645371,938724,36199,45425,16782,893299,73295,1020348,938724,,,,,0,0,0,0
1650442062.5474396,public.usertable,893685,73304,1122279424,16782,public,usertable,1,0,2372906,2645593,939114,36204,45429,16784,893685,73304,1020747,939114,,,,,0,0,0,0
1650442063.5786061,public.usertable,894101,73308,1122795520,16782,public,usertable,1,0,2374060,2645682,939533,36205,45432,16785,894101,73308,1021170,939533,,,,,0,0,0,0
1650442064.609285,public.usertable,894508,73313,1123287040,16782,public,usertable,1,0,2375125,2646046,939942,36209,45434,16787,894508,73313,1021585,939942,,,,,0,0,0,0
1650442065.6376338,public.usertable,895136,73325,1123803136,16782,public,usertable,1,0,2376909,2646481,940578,36215,45442,16788,895136,73325,1022235,940578,,,,,0,0,0,0
1650442066.6667092,public.usertable,895524,73333,1124286464,16782,public,usertable,1,0,2377984,2646543,940971,36218,45447,16788,895524,73333,1022636,940971,,,,,0,0,0,0
1650442067.6953537,public.usertable,895901,73334,1124737024,16782,public,usertable,1,0,2379011,2646830,941349,36218,45448,16788,895901,73334,1023015,941349,,,,,0,0,0,0
1650442068.7253714,public.usertable,896303,73339,1125212160,16782,public,usertable,1,0,2380074,2646944,941752,36222,45449,16789,896303,73339,1023423,941752,,,,,0,0,0,0
1650442069.7559755,public.usertable,896645,73345,1125629952,16782,public,usertable,1,0,2380974,2647147,942097,36225,45452,16792,896645,73345,1023774,942097,,,,,0,0,0,0
1650442070.7867665,public.usertable,897014,73348,1126088704,16782,public,usertable,1,0,2381936,2647288,942469,36226,45455,16792,897014,73348,1024150,942469,,,,,0,0,0,0
1650442071.8162951,public.usertable,897381,73352,1126531072,16782,public,usertable,1,0,2382905,2647488,942841,36227,45460,16792,897381,73352,1024528,942841,,,,,0,0,0,0
1650442072.8457472,public.usertable,897720,73362,1126957056,16782,public,usertable,1,0,2383856,2647732,943186,36231,45466,16792,897720,73362,1024883,943186,,,,,0,0,0,0
1650442073.8747377,public.usertable,898122,73368,1127456768,16782,public,usertable,1,0,2384900,2648097,943591,36234,45469,16794,898122,73368,1025294,943591,,,,,0,0,0,0
1650442074.9049013,public.usertable,898539,73374,1127956480,16782,public,usertable,1,0,2386081,2648270,944012,36239,45473,16795,898539,73374,1025724,944012,,,,,0,0,0,0
1650442075.9357646,public.usertable,898940,73380,1128464384,16782,public,usertable,1,0,2387142,2648475,944417,36241,45477,16796,898940,73380,1026135,944417,,,,,0,0,0,0
1650442076.9666474,public.usertable,899375,73387,1128980480,16782,public,usertable,1,0,2388278,2648764,944857,36244,45482,16799,899375,73387,1026583,944857,,,,,0,0,0,0
1650442077.9996653,public.usertable,899764,73395,1129455616,16782,public,usertable,1,0,2389336,2648925,945250,36248,45486,16799,899764,73395,1026984,945250,,,,,0,0,0,0
1650442079.02781,public.usertable,900170,73401,1129938944,16782,public,usertable,1,0,2390459,2649076,945657,36253,45487,16801,900170,73401,1027397,945657,,,,,0,0,0,0
1650442080.0585475,public.usertable,900575,73408,1130438656,16782,public,usertable,1,0,2391527,2649756,946068,36255,45493,16801,900575,73408,1027816,946068,,,,,0,0,0,0
1650442081.0877054,public.usertable,900983,73413,1130905600,16782,public,usertable,1,0,2392587,2649812,946479,36257,45496,16803,900983,73413,1028232,946479,,,,,0,0,0,0
1650442082.1211658,public.usertable,901363,73417,1131413504,16782,public,usertable,1,0,2393592,2650255,946866,36262,45503,16803,901363,73417,1028631,946866,,,,,0,0,0,0
1650442083.152668,public.usertable,901777,73421,1131913216,16782,public,usertable,1,0,2394717,2650443,947284,36263,45507,16804,901777,73421,1029054,947284,,,,,0,0,0,0
1650442084.182292,public.usertable,902181,73427,1132380160,16782,public,usertable,1,0,2395807,2650549,947693,36264,45512,16805,902181,73427,1029469,947693,,,,,0,0,0,0
1650442085.2196836,public.usertable,902704,73434,1132789760,16782,public,usertable,1,0,2397106,2650719,948223,36268,45519,16806,902704,73434,1030010,948223,,,,,0,0,0,0
1650442086.251804,public.usertable,903112,73444,1133289472,16782,public,usertable,1,0,2398225,2650763,948635,36274,45523,16809,903112,73444,1030432,948635,,,,,0,0,0,0
1650442087.2831628,public.usertable,903486,73454,1133764608,16782,public,usertable,1,0,2399363,2650863,949010,36283,45524,16813,903486,73454,1030817,949010,,,,,0,0,0,0
1650442088.3142216,public.usertable,903905,73460,1134256128,16782,public,usertable,1,0,2400467,2651079,949434,36284,45529,16814,903905,73460,1031247,949434,,,,,0,0,0,0
1650442089.3429456,public.usertable,904293,73460,1134739456,16782,public,usertable,1,0,2401427,2651227,949824,36286,45531,16815,904293,73460,1031641,949824,,,,,0,0,0,0
1650442090.3778126,public.usertable,904663,73466,1135181824,16782,public,usertable,1,0,2402457,2651690,950197,36289,45534,16815,904663,73466,1032020,950197,,,,,0,0,0,0
1650442091.4125965,public.usertable,904952,73468,1135509504,16782,public,usertable,1,0,2403269,2651748,950487,36290,45535,16816,904952,73468,1032312,950487,,,,,0,0,0,0
1650442092.4413755,public.usertable,905227,73473,1135853568,16782,public,usertable,1,0,2404035,2651965,950766,36291,45539,16816,905227,73473,1032596,950766,,,,,0,0,0,0
1650442093.4697409,public.usertable,905536,73480,1136254976,16782,public,usertable,1,0,2404805,2652182,951078,36295,45542,16818,905536,73480,1032915,951078,,,,,0,0,0,0
1650442094.4984667,public.usertable,905877,73491,1136664576,16782,public,usertable,1,0,2405756,2652262,951425,36300,45548,16819,905877,73491,1033273,951425,,,,,0,0,0,0
1650442095.527602,public.usertable,906231,73495,1137082368,16782,public,usertable,1,0,2406630,2652493,951782,36301,45551,16819,906231,73495,1033634,951782,,,,,0,0,0,0
1650442096.5568364,public.usertable,906552,73501,1137491968,16782,public,usertable,1,0,2407582,2652764,952108,36304,45556,16820,906552,73501,1033968,952108,,,,,0,0,0,0
1650442097.585715,public.usertable,906915,73505,1137967104,16782,public,usertable,1,0,2408571,2653000,952474,36305,45559,16820,906915,73505,1034338,952474,,,,,0,0,0,0
1650442098.6193323,public.usertable,907303,73511,1138417664,16782,public,usertable,1,0,2409616,2653228,952867,36307,45564,16822,907303,73511,1034738,952867,,,,,0,0,0,0
1650442099.6493337,public.usertable,907694,73512,1138876416,16782,public,usertable,1,0,2410665,2653434,953259,36310,45565,16823,907694,73512,1035134,953259,,,,,0,0,0,0
1650442100.6786976,public.usertable,908053,73517,1139310592,16782,public,usertable,1,0,2411687,2653508,953623,36310,45570,16823,908053,73517,1035503,953623,,,,,0,0,0,0
1650442101.708943,public.usertable,908401,73521,1139769344,16782,public,usertable,1,0,2412692,2654125,953973,36312,45572,16824,908401,73521,1035857,953973,,,,,0,0,0,0
1650442102.7404673,public.usertable,908820,73526,1140285440,16782,public,usertable,1,0,2413647,2654425,954394,36315,45574,16825,908820,73526,1036283,954394,,,,,0,0,0,0
1650442103.7699912,public.usertable,909252,73531,1140817920,16782,public,usertable,1,0,2414733,2654586,954829,36317,45577,16826,909252,73531,1036723,954829,,,,,0,0,0,0
1650442104.8018227,public.usertable,909911,73542,1141350400,16782,public,usertable,1,0,2416452,2654798,955493,36324,45582,16828,909911,73542,1037399,955493,,,,,0,0,0,0
1650442105.8303883,public.usertable,910344,73547,1141874688,16782,public,usertable,1,0,2417624,2654927,955932,36327,45588,16830,910344,73547,1037847,955932,,,,,0,0,0,0
1650442106.8602972,public.usertable,910790,73554,1142423552,16782,public,usertable,1,0,2418823,2655162,956384,36328,45594,16830,910790,73554,1038306,956384,,,,,0,0,0,0
1650442107.8894083,public.usertable,911203,73560,1142923264,16782,public,usertable,1,0,2419949,2655233,956803,36328,45600,16830,911203,73560,1038731,956803,,,,,0,0,0,0
1650442108.9215343,public.usertable,911609,73572,1143422976,16782,public,usertable,1,0,2421110,2655472,957216,36333,45607,16832,911609,73572,1039156,957216,,,,,0,0,0,0
1650442109.9515097,public.usertable,912030,73580,1143922688,16782,public,usertable,1,0,2422283,2655865,957640,36338,45610,16834,912030,73580,1039588,957640,,,,,0,0,0,0
1650442110.9833255,public.usertable,912432,73587,1144422400,16782,public,usertable,1,0,2423465,2656013,958046,36341,45614,16837,912432,73587,1040001,958046,,,,,0,0,0,0
1650442112.011835,public.usertable,912840,73589,1144913920,16782,public,usertable,1,0,2424521,2656043,958455,36342,45615,16838,912840,73589,1040412,958455,,,,,0,0,0,0
1650442113.0433311,public.usertable,913244,73596,1145405440,16782,public,usertable,1,0,2425661,2656484,958864,36344,45620,16838,913244,73596,1040828,958864,,,,,0,0,0,0
1650442114.0736835,public.usertable,913638,73607,1145896960,16782,public,usertable,1,0,2426873,2656521,959264,36349,45626,16841,913638,73607,1041239,959264,,,,,0,0,0,0
1650442115.1025143,public.usertable,914044,73609,1146380288,16782,public,usertable,1,0,2427899,2656911,959674,36350,45630,16841,914044,73609,1041654,959674,,,,,0,0,0,0
1650442116.130945,public.usertable,914440,73615,1146855424,16782,public,usertable,1,0,2428947,2656994,960073,36353,45633,16843,914440,73615,1042059,960073,,,,,0,0,0,0
1650442117.159115,public.usertable,914830,73623,1147338752,16782,public,usertable,1,0,2430038,2657403,960470,36354,45640,16843,914830,73623,1042464,960470,,,,,0,0,0,0
1650442118.1906831,public.usertable,915237,73628,1147846656,16782,public,usertable,1,0,2431088,2657547,960881,36357,45644,16844,915237,73628,1042882,960881,,,,,0,0,0,0
1650442119.2229679,public.usertable,915644,73633,1148362752,16782,public,usertable,1,0,2432215,2657788,961290,36360,45646,16844,915644,73633,1043296,961290,,,,,0,0,0,0
1650442120.253976,public.usertable,916066,73637,1148854272,16782,public,usertable,1,0,2433332,2657966,961712,36364,45646,16845,916066,73637,1043722,961712,,,,,0,0,0,0
1650442121.2822585,public.usertable,916469,73640,1149353984,16782,public,usertable,1,0,2434493,2658101,962117,36365,45648,16845,916469,73640,1044130,962117,,,,,0,0,0,0
1650442122.3110287,public.usertable,916899,73646,1149861888,16782,public,usertable,1,0,2435655,2658293,962551,36367,45652,16846,916899,73646,1044570,962551,,,,,0,0,0,0
1650442123.342816,public.usertable,917523,73660,1150377984,16782,public,usertable,1,0,2437505,2658505,963184,36372,45661,16849,917523,73660,1045217,963184,,,,,0,0,0,0
1650442124.3736544,public.usertable,917958,73665,1150902272,16782,public,usertable,1,0,2438667,2658642,963620,36376,45662,16851,917958,73665,1045658,963620,,,,,0,0,0,0
1650442125.4031563,public.usertable,918377,73668,1151401984,16782,public,usertable,1,0,2439914,2658851,964041,36380,45664,16853,918377,73668,1046085,964041,,,,,0,0,0,0
1650442126.4337945,public.usertable,918757,73679,1151885312,16782,public,usertable,1,0,2440927,2659119,964426,36386,45669,16855,918757,73679,1046481,964426,,,,,0,0,0,0
1650442127.463524,public.usertable,919187,73686,1152401408,16782,public,usertable,1,0,2441989,2659303,964861,36388,45674,16856,919187,73686,1046923,964861,,,,,0,0,0,0
1650442128.493022,public.usertable,919589,73692,1152901120,16782,public,usertable,1,0,2443008,2659576,965269,36389,45680,16856,919589,73692,1047338,965269,,,,,0,0,0,0
1650442129.5216398,public.usertable,919992,73702,1153400832,16782,public,usertable,1,0,2444051,2659675,965679,36392,45687,16857,919992,73702,1047758,965679,,,,,0,0,0,0
1650442130.5524094,public.usertable,920369,73708,1153851392,16782,public,usertable,1,0,2445141,2659786,966060,36394,45691,16858,920369,73708,1048145,966060,,,,,0,0,0,0
1650442131.5811656,public.usertable,920722,73713,1154277376,16782,public,usertable,1,0,2446164,2660030,966417,36397,45695,16859,920722,73713,1048509,966417,,,,,0,0,0,0
1650442132.6110597,public.usertable,921101,73715,1154736128,16782,public,usertable,1,0,2447260,2660103,966798,36397,45697,16859,921101,73715,1048892,966798,,,,,0,0,0,0
1650442133.644306,public.usertable,921502,73720,1155235840,16782,public,usertable,1,0,2448215,2660246,967201,36402,45699,16863,921502,73720,1049302,967201,,,,,0,0,0,0
1650442134.6737099,public.usertable,921918,73724,1155735552,16782,public,usertable,1,0,2449213,2661288,967619,36405,45701,16863,921918,73724,1049725,967619,,,,,0,0,0,0
1650442135.702894,public.usertable,922314,73731,1156218880,16782,public,usertable,1,0,2450315,2661643,968021,36409,45707,16866,922314,73731,1050137,968021,,,,,0,0,0,0
1650442136.7325952,public.usertable,922693,73737,1156694016,16782,public,usertable,1,0,2451363,2662032,968403,36412,45710,16867,922693,73737,1050525,968403,,,,,0,0,0,0
1650442137.7617989,public.usertable,923124,73742,1157201920,16782,public,usertable,1,0,2452459,2662275,968837,36414,45713,16868,923124,73742,1050964,968837,,,,,0,0,0,0
1650442138.7946768,public.usertable,923534,73748,1157718016,16782,public,usertable,1,0,2453583,2662516,969251,36416,45717,16869,923534,73748,1051384,969251,,,,,0,0,0,0
1650442139.8251588,public.usertable,923959,73755,1158258688,16782,public,usertable,1,0,2454705,2662817,969684,36418,45725,16870,923959,73755,1051827,969684,,,,,0,0,0,0
1650442140.8543973,public.usertable,924386,73762,1158750208,16782,public,usertable,1,0,2455753,2662962,970116,36420,45730,16871,924386,73762,1052266,970116,,,,,0,0,0,0
1650442141.8853111,public.usertable,925001,73770,1159241728,16782,public,usertable,1,0,2457344,2663096,970735,36424,45734,16874,925001,73770,1052893,970735,,,,,0,0,0,0
1650442142.913838,public.usertable,925408,73775,1159741440,16782,public,usertable,1,0,2458422,2663284,971147,36424,45739,16874,925408,73775,1053310,971147,,,,,0,0,0,0
1650442143.9432151,public.usertable,925766,73788,1160175616,16782,public,usertable,1,0,2459421,2663337,971512,36430,45746,16875,925766,73788,1053688,971512,,,,,0,0,0,0
1650442144.9738054,public.usertable,926134,73789,1160626176,16782,public,usertable,1,0,2460406,2663478,971884,36430,45750,16875,926134,73789,1054064,971884,,,,,0,0,0,0
1650442146.005332,public.usertable,926540,73793,1161125888,16782,public,usertable,1,0,2461458,2663578,972293,36431,45753,16875,926540,73793,1054477,972293,,,,,0,0,0,0
1650442147.0345426,public.usertable,926890,73800,1161560064,16782,public,usertable,1,0,2462555,2663754,972646,36435,45756,16878,926890,73800,1054837,972646,,,,,0,0,0,0
1650442148.0626838,public.usertable,927287,73804,1162043392,16782,public,usertable,1,0,2463755,2663833,973045,36437,45758,16878,927287,73804,1055240,973045,,,,,0,0,0,0
1650442149.0932848,public.usertable,927664,73812,1162493952,16782,public,usertable,1,0,2464761,2664123,973425,36442,45761,16880,927664,73812,1055628,973425,,,,,0,0,0,0
1650442150.1230354,public.usertable,928024,73819,1162928128,16782,public,usertable,1,0,2465777,2664383,973788,36446,45764,16880,928024,73819,1055998,973788,,,,,0,0,0,0
1650442151.1523902,public.usertable,928420,73827,1163419648,16782,public,usertable,1,0,2466864,2664594,974189,36449,45769,16881,928420,73827,1056407,974189,,,,,0,0,0,0
1650442152.1811109,public.usertable,928826,73834,1163927552,16782,public,usertable,1,0,2467991,2664749,974599,36452,45773,16883,928826,73834,1056824,974599,,,,,0,0,0,0
1650442153.209638,public.usertable,929237,73842,1164443648,16782,public,usertable,1,0,2469036,2664898,975016,36457,45779,16887,929237,73842,1057252,975016,,,,,0,0,0,0
1650442154.238401,public.usertable,929692,73847,1164992512,16782,public,usertable,1,0,2470199,2665210,975479,36460,45787,16889,929692,73847,1057726,975479,,,,,0,0,0,0
1650442155.267869,public.usertable,930128,73856,1165516800,16782,public,usertable,1,0,2471285,2665380,975919,36465,45791,16892,930128,73856,1058175,975919,,,,,0,0,0,0
1650442156.2962892,public.usertable,930547,73861,1166024704,16782,public,usertable,1,0,2472372,2665499,976342,36466,45795,16892,930547,73861,1058603,976342,,,,,0,0,0,0
1650442157.3291245,public.usertable,930957,73864,1166516224,16782,public,usertable,1,0,2473427,2665886,976753,36468,45796,16893,930957,73864,1059017,976753,,,,,0,0,0,0
1650442158.3578947,public.usertable,931362,73871,1167040512,16782,public,usertable,1,0,2474521,2666080,977161,36475,45799,16896,931362,73871,1059435,977161,,,,,0,0,0,0
1650442159.3871105,public.usertable,931784,73880,1167556608,16782,public,usertable,1,0,2475666,2666117,977589,36478,45805,16897,931784,73880,1059872,977589,,,,,0,0,0,0
1650442160.4156735,public.usertable,932402,73889,1168048128,16782,public,usertable,1,0,2477333,2666319,978212,36482,45810,16898,932402,73889,1060504,978212,,,,,0,0,0,0
1650442161.4450967,public.usertable,932794,73885,1168523264,16782,public,usertable,1,0,2478485,2666764,978606,36483,45812,16898,932794,73885,1060901,978606,,,,,0,0,0,0
1650442162.4750388,public.usertable,933162,73888,1168973824,16782,public,usertable,1,0,2479476,2667246,978976,36486,45814,16898,933162,73888,1061276,978976,,,,,0,0,0,0
1650442163.506405,public.usertable,933576,73891,1169473536,16782,public,usertable,1,0,2480616,2667471,979393,36490,45817,16898,933576,73891,1061700,979393,,,,,0,0,0,0
1650442164.5361638,public.usertable,933986,73898,1169965056,16782,public,usertable,1,0,2481824,2667588,979808,36495,45822,16902,933986,73898,1062125,979808,,,,,0,0,0,0
1650442165.565042,public.usertable,934357,73903,1170423808,16782,public,usertable,1,0,2482777,2667967,980181,36501,45824,16903,934357,73903,1062506,980181,,,,,0,0,0,0
1650442166.593572,public.usertable,934744,73909,1170898944,16782,public,usertable,1,0,2483924,2668078,980571,36504,45827,16906,934744,73909,1062902,980571,,,,,0,0,0,0
1650442167.6232324,public.usertable,935101,73913,1171316736,16782,public,usertable,1,0,2484765,2668351,980930,36506,45829,16907,935101,73913,1063265,980930,,,,,0,0,0,0
1650442168.6519232,public.usertable,935430,73919,1171726336,16782,public,usertable,1,0,2485729,2668522,981263,36508,45833,16907,935430,73919,1063604,981263,,,,,0,0,0,0
1650442169.6819794,public.usertable,935846,73921,1172226048,16782,public,usertable,1,0,2486881,2668783,981679,36511,45833,16909,935846,73921,1064023,981679,,,,,0,0,0,0
1650442170.7127006,public.usertable,936259,73930,1172742144,16782,public,usertable,1,0,2488006,2669065,982099,36513,45840,16910,936259,73930,1064452,982099,,,,,0,0,0,0
1650442171.743155,public.usertable,936667,73934,1173250048,16782,public,usertable,1,0,2489074,2669321,982509,36515,45842,16910,936667,73934,1064866,982509,,,,,0,0,0,0
1650442172.772642,public.usertable,937083,73933,1173741568,16782,public,usertable,1,0,2490157,2669463,982927,36517,45844,16911,937083,73933,1065288,982927,,,,,0,0,0,0
1650442173.8048997,public.usertable,937475,73936,1174208512,16782,public,usertable,1,0,2491336,2669604,983321,36518,45846,16911,937475,73936,1065685,983321,,,,,0,0,0,0
1650442174.8340623,public.usertable,937884,73939,1174724608,16782,public,usertable,1,0,2492363,2669627,983731,36520,45847,16911,937884,73939,1066098,983731,,,,,0,0,0,0
1650442175.8638208,public.usertable,938313,73946,1175257088,16782,public,usertable,1,0,2493647,2669762,984166,36521,45853,16912,938313,73946,1066540,984166,,,,,0,0,0,0
1650442176.8938143,public.usertable,938748,73953,1175773184,16782,public,usertable,1,0,2494758,2669913,984606,36523,45858,16913,938748,73953,1066987,984606,,,,,0,0,0,0
1650442177.9255297,public.usertable,939122,73956,1176223744,16782,public,usertable,1,0,2495776,2669982,984983,36526,45861,16915,939122,73956,1067370,984983,,,,,0,0,0,0
1650442178.9545872,public.usertable,939702,73965,1176690688,16782,public,usertable,1,0,2497580,2670662,985571,36527,45869,16915,939702,73965,1067967,985571,,,,,0,0,0,0
1650442179.9842718,public.usertable,940094,73969,1177165824,16782,public,usertable,1,0,2498657,2670707,985967,36527,45873,16915,940094,73969,1068367,985967,,,,,0,0,0,0
1650442181.0126247,public.usertable,940485,73974,1177640960,16782,public,usertable,1,0,2499874,2670799,986361,36529,45876,16915,940485,73974,1068766,986361,,,,,0,0,0,0
1650442182.0422313,public.usertable,940883,73977,1178116096,16782,public,usertable,1,0,2500948,2671145,986761,36530,45878,16916,940883,73977,1069169,986761,,,,,0,0,0,0
1650442183.0710542,public.usertable,941305,73982,1178632192,16782,public,usertable,1,0,2501972,2671410,987185,36533,45880,16919,941305,73982,1069598,987185,,,,,0,0,0,0
1650442184.0992222,public.usertable,941697,73987,1179107328,16782,public,usertable,1,0,2502984,2671487,987578,36537,45881,16920,941697,73987,1069996,987578,,,,,0,0,0,0
1650442185.131367,public.usertable,942086,73992,1179590656,16782,public,usertable,1,0,2504130,2671600,987969,36540,45883,16921,942086,73992,1070392,987969,,,,,0,0,0,0
1650442186.1610174,public.usertable,942492,73990,1180057600,16782,public,usertable,1,0,2505203,2672416,988379,36540,45887,16921,942492,73990,1070806,988379,,,,,0,0,0,0
1650442187.1907914,public.usertable,942857,73997,1180499968,16782,public,usertable,1,0,2506137,2672512,988747,36544,45890,16924,942857,73997,1071181,988747,,,,,0,0,0,0
1650442188.2197535,public.usertable,943212,74006,1180958720,16782,public,usertable,1,0,2507178,2672591,989107,36548,45895,16925,943212,74006,1071550,989107,,,,,0,0,0,0
1650442189.247909,public.usertable,943607,74011,1181409280,16782,public,usertable,1,0,2508189,2672747,989504,36551,45897,16926,943607,74011,1071952,989504,,,,,0,0,0,0
1650442190.2801766,public.usertable,943974,74016,1181851648,16782,public,usertable,1,0,2509040,2672857,989872,36555,45898,16928,943974,74016,1072325,989872,,,,,0,0,0,0
1650442191.310245,public.usertable,944302,74018,1182261248,16782,public,usertable,1,0,2509841,2672976,990201,36556,45899,16929,944302,74018,1072656,990201,,,,,0,0,0,0
1650442192.3385537,public.usertable,944649,74024,1182695424,16782,public,usertable,1,0,2510817,2673042,990551,36559,45902,16931,944649,74024,1073012,990551,,,,,0,0,0,0
1650442193.3697324,public.usertable,944998,74031,1183105024,16782,public,usertable,1,0,2511691,2673310,990903,36563,45905,16932,944998,74031,1073371,990903,,,,,0,0,0,0
1650442194.3990076,public.usertable,945331,74035,1183473664,16782,public,usertable,1,0,2512532,2673503,991238,36567,45907,16934,945331,74035,1073712,991238,,,,,0,0,0,0
1650442195.4285898,public.usertable,945685,74043,1183948800,16782,public,usertable,1,0,2513540,2673569,991597,36570,45912,16935,945685,74043,1074079,991597,,,,,0,0,0,0
1650442196.4591584,public.usertable,946054,74047,1184391168,16782,public,usertable,1,0,2514453,2673723,991970,36570,45916,16935,946054,74047,1074456,991970,,,,,0,0,0,0
1650442197.4883587,public.usertable,946434,74048,1184784384,16782,public,usertable,1,0,2515380,2673857,992350,36573,45916,16937,946434,74048,1074839,992350,,,,,0,0,0,0
1650442198.5191467,public.usertable,946698,74049,1185079296,16782,public,usertable,1,0,2516054,2673952,992614,36574,45916,16937,946698,74049,1075104,992614,,,,,0,0,0,0
1650442199.5470247,public.usertable,946960,74054,1185431552,16782,public,usertable,1,0,2516806,2674914,992880,36578,45920,16940,946960,74054,1075378,992880,,,,,0,0,0,0
1650442200.577657,public.usertable,947268,74060,1185783808,16782,public,usertable,1,0,2517628,2675018,993189,36583,45921,16940,947268,74060,1075693,993189,,,,,0,0,0,0
1650442201.6077042,public.usertable,947681,74065,1186127872,16782,public,usertable,1,0,2518755,2675112,993604,36586,45923,16943,947681,74065,1076113,993604,,,,,0,0,0,0
1650442202.6385896,public.usertable,948023,74069,1186545664,16782,public,usertable,1,0,2519703,2675177,993948,36588,45925,16944,948023,74069,1076461,993948,,,,,0,0,0,0
1650442203.6706467,public.usertable,948419,74076,1187028992,16782,public,usertable,1,0,2520707,2675191,994348,36591,45929,16945,948419,74076,1076868,994348,,,,,0,0,0,0
1650442204.7009706,public.usertable,948825,74081,1187520512,16782,public,usertable,1,0,2521854,2675327,994757,36593,45932,16946,948825,74081,1077282,994757,,,,,0,0,0,0
1650442205.7309594,public.usertable,949234,74088,1188028416,16782,public,usertable,1,0,2522850,2675406,995168,36598,45934,16948,949234,74088,1077700,995168,,,,,0,0,0,0
1650442206.7630897,public.usertable,949677,74100,1188569088,16782,public,usertable,1,0,2524018,2675503,995617,36604,45940,16952,949677,74100,1078161,995617,,,,,0,0,0,0
1650442207.796066,public.usertable,950121,74105,1189109760,16782,public,usertable,1,0,2525235,2675832,996064,36606,45943,16953,950121,74105,1078613,996064,,,,,0,0,0,0
1650442208.8244982,public.usertable,950540,74109,1189617664,16782,public,usertable,1,0,2526318,2676065,996485,36608,45945,16954,950540,74109,1079038,996485,,,,,0,0,0,0
1650442209.8547974,public.usertable,950966,74110,1190125568,16782,public,usertable,1,0,2527522,2676299,996914,36610,45948,16956,950966,74110,1079472,996914,,,,,0,0,0,0
1650442210.8847191,public.usertable,951419,74114,1190674432,16782,public,usertable,1,0,2528667,2676797,997372,36611,45953,16957,951419,74114,1079936,997372,,,,,0,0,0,0
1650442211.9141388,public.usertable,951848,74124,1191198720,16782,public,usertable,1,0,2529891,2677134,997805,36617,45957,16962,951848,74124,1080379,997805,,,,,0,0,0,0
1650442212.9460638,public.usertable,952284,74129,1191739392,16782,public,usertable,1,0,2530973,2677219,998244,36619,45960,16963,952284,74129,1080823,998244,,,,,0,0,0,0
1650442213.9751143,public.usertable,952714,74134,1192239104,16782,public,usertable,1,0,2532221,2677309,998677,36621,45963,16963,952714,74134,1081261,998677,,,,,0,0,0,0
1650442215.0042355,public.usertable,953120,74135,1192722432,16782,public,usertable,1,0,2533404,2677888,999083,36622,45963,16964,953120,74135,1081668,999083,,,,,0,0,0,0
1650442216.0356393,public.usertable,953526,74138,1193222144,16782,public,usertable,1,0,2534540,2678028,999489,36625,45963,16966,953526,74138,1082077,999489,,,,,0,0,0,0
1650442217.065147,public.usertable,953921,74144,1193689088,16782,public,usertable,1,0,2535471,2678365,999888,36627,45967,16967,953921,74144,1082482,999888,,,,,0,0,0,0
1650442218.0942142,public.usertable,954297,74146,1194147840,16782,public,usertable,1,0,2536518,2678497,1000267,36630,45970,16968,954297,74146,1082867,1000267,,,,,0,0,0,0
1650442219.1228268,public.usertable,954677,74153,1194614784,16782,public,usertable,1,0,2537632,2678547,1000649,36635,45972,16971,954677,74153,1083256,1000649,,,,,0,0,0,0
1650442220.1518743,public.usertable,955304,74162,1195139072,16782,public,usertable,1,0,2539266,2678997,1001279,36641,45975,16974,955304,74162,1083895,1001279,,,,,0,0,0,0
1650442221.1824832,public.usertable,955713,74170,1195638784,16782,public,usertable,1,0,2540299,2679228,1001692,36645,45979,16976,955713,74170,1084316,1001692,,,,,0,0,0,0
1650442222.2137783,public.usertable,956110,74175,1196113920,16782,public,usertable,1,0,2541328,2679300,1002091,36648,45981,16978,956110,74175,1084720,1002091,,,,,0,0,0,0
1650442223.2444005,public.usertable,956406,74174,1196474368,16782,public,usertable,1,0,2542157,2679655,1002389,36648,45983,16978,956406,74174,1085020,1002389,,,,,0,0,0,0
1650442224.2746077,public.usertable,956758,74179,1196900352,16782,public,usertable,1,0,2543065,2679766,1002745,36649,45987,16978,956758,74179,1085381,1002745,,,,,0,0,0,0
1650442225.3072877,public.usertable,957147,74182,1197383680,16782,public,usertable,1,0,2543979,2680095,1003137,36649,45990,16978,957147,74182,1085776,1003137,,,,,0,0,0,0
1650442226.3357658,public.usertable,957567,74187,1197875200,16782,public,usertable,1,0,2545171,2680320,1003560,36652,45993,16980,957567,74187,1086205,1003560,,,,,0,0,0,0
1650442227.3651884,public.usertable,957986,74192,1198391296,16782,public,usertable,1,0,2546239,2680508,1003985,36655,45999,16982,957986,74192,1086639,1003985,,,,,0,0,0,0
1650442228.3957562,public.usertable,958374,74196,1198850048,16782,public,usertable,1,0,2547392,2680555,1004373,36659,45999,16984,958374,74196,1087031,1004373,,,,,0,0,0,0
1650442229.4255357,public.usertable,958731,74198,1199308800,16782,public,usertable,1,0,2548346,2680748,1004733,36660,46002,16984,958731,74198,1087395,1004733,,,,,0,0,0,0
1650442230.4558256,public.usertable,959150,74202,1199816704,16782,public,usertable,1,0,2549363,2680904,1005155,36661,46005,16984,959150,74202,1087821,1005155,,,,,0,0,0,0
1650442231.4862847,public.usertable,959554,74205,1200316416,16782,public,usertable,1,0,2550432,2681327,1005561,36662,46007,16985,959554,74205,1088230,1005561,,,,,0,0,0,0
1650442232.5155673,public.usertable,959983,74212,1200832512,16782,public,usertable,1,0,2551391,2681365,1005995,36664,46012,16985,959983,74212,1088671,1005995,,,,,0,0,0,0
1650442233.5449235,public.usertable,960373,74215,1201291264,16782,public,usertable,1,0,2552462,2681561,1006386,36666,46013,16985,960373,74215,1089065,1006386,,,,,0,0,0,0
1650442234.5749872,public.usertable,960744,74223,1201766400,16782,public,usertable,1,0,2553563,2681824,1006762,36669,46018,16986,960744,74223,1089449,1006762,,,,,0,0,0,0
1650442235.603717,public.usertable,961148,74227,1202257920,16782,public,usertable,1,0,2554667,2681988,1007169,36671,46021,16987,961148,74227,1089861,1007169,,,,,0,0,0,0
1650442236.6329815,public.usertable,961556,74233,1202741248,16782,public,usertable,1,0,2555814,2682158,1007579,36675,46023,16990,961556,74233,1090277,1007579,,,,,0,0,0,0
1650442237.6620188,public.usertable,961946,74238,1203208192,16782,public,usertable,1,0,2556837,2682437,1007974,36678,46028,16992,961946,74238,1090680,1007974,,,,,0,0,0,0
1650442238.6901708,public.usertable,962330,74245,1203642368,16782,public,usertable,1,0,2557891,2682682,1008361,36682,46031,16993,962330,74245,1091074,1008361,,,,,0,0,0,0
1650442239.7218564,public.usertable,962878,74248,1204101120,16782,public,usertable,1,0,2559438,2682946,1008911,36683,46033,16994,962878,74248,1091627,1008911,,,,,0,0,0,0
1650442240.7508023,public.usertable,963260,74255,1204568064,16782,public,usertable,1,0,2560467,2683135,1009296,36688,46036,16996,963260,74255,1092020,1009296,,,,,0,0,0,0
1650442241.780215,public.usertable,963695,74262,1205100544,16782,public,usertable,1,0,2561646,2683257,1009734,36692,46039,16997,963695,74262,1092465,1009734,,,,,0,0,0,0
1650442242.8106287,public.usertable,964110,74262,1205592064,16782,public,usertable,1,0,2562764,2683408,1010151,36694,46041,16997,964110,74262,1092886,1010151,,,,,0,0,0,0
1650442243.840911,public.usertable,964490,74267,1206050816,16782,public,usertable,1,0,2563814,2683601,1010536,36697,46046,16999,964490,74267,1093279,1010536,,,,,0,0,0,0
1650442244.8712106,public.usertable,964874,74275,1206525952,16782,public,usertable,1,0,2564745,2683667,1010923,36702,46049,17001,964874,74275,1093674,1010923,,,,,0,0,0,0
1650442245.9011304,public.usertable,965288,74283,1207042048,16782,public,usertable,1,0,2565854,2684175,1011343,36704,46055,17001,965288,74283,1094102,1011343,,,,,0,0,0,0
1650442246.9315686,public.usertable,965705,74288,1207549952,16782,public,usertable,1,0,2566963,2684226,1011763,36706,46058,17002,965705,74288,1094527,1011763,,,,,0,0,0,0
1650442247.9625034,public.usertable,966109,74291,1208033280,16782,public,usertable,1,0,2567999,2684251,1012168,36708,46059,17004,966109,74291,1094935,1012168,,,,,0,0,0,0
1650442248.99241,public.usertable,966534,74289,1208557568,16782,public,usertable,1,0,2569142,2684727,1012593,36712,46059,17006,966534,74289,1095364,1012593,,,,,0,0,0,0
1650442250.0221393,public.usertable,966972,74300,1209090048,16782,public,usertable,1,0,2570334,2685012,1013033,36721,46061,17007,966972,74300,1095815,1013033,,,,,0,0,0,0
1650442251.0501244,public.usertable,967403,74306,1209606144,16782,public,usertable,1,0,2571502,2685260,1013470,36724,46067,17008,967403,74306,1096261,1013470,,,,,0,0,0,0
1650442252.0777497,public.usertable,967799,74311,1210089472,16782,public,usertable,1,0,2572535,2685437,1013871,36724,46072,17008,967799,74311,1096667,1013871,,,,,0,0,0,0
1650442253.1053243,public.usertable,968215,74313,1210605568,16782,public,usertable,1,0,2573769,2685825,1014291,36726,46076,17010,968215,74313,1097093,1014291,,,,,0,0,0,0
1650442254.136277,public.usertable,968634,74318,1211097088,16782,public,usertable,1,0,2574726,2685902,1014713,36728,46079,17010,968634,74318,1097520,1014713,,,,,0,0,0,0
1650442255.1657264,public.usertable,969045,74321,1211613184,16782,public,usertable,1,0,2575850,2686348,1015126,36729,46081,17010,969045,74321,1097936,1015126,,,,,0,0,0,0
1650442256.1968837,public.usertable,969455,74332,1212112896,16782,public,usertable,1,0,2576964,2686583,1015543,36733,46088,17012,969455,74332,1098364,1015543,,,,,0,0,0,0
1650442257.225732,public.usertable,969859,74340,1212604416,16782,public,usertable,1,0,2578137,2686879,1015955,36733,46096,17012,969859,74340,1098784,1015955,,,,,0,0,0,0
1650442258.2546635,public.usertable,970260,74350,1213087744,16782,public,usertable,1,0,2579235,2687097,1016361,36738,46101,17015,970260,74350,1099200,1016361,,,,,0,0,0,0
1650442259.2848594,public.usertable,970888,74353,1213603840,16782,public,usertable,1,0,2580949,2687411,1016990,36740,46102,17015,970888,74353,1099832,1016990,,,,,0,0,0,0
1650442260.313961,public.usertable,971333,74354,1214136320,16782,public,usertable,1,0,2582058,2687621,1017436,36744,46103,17017,971333,74354,1100283,1017436,,,,,0,0,0,0
1650442261.3432949,public.usertable,971748,74356,1214644224,16782,public,usertable,1,0,2583044,2687764,1017855,36747,46107,17017,971748,74356,1100709,1017855,,,,,0,0,0,0
1650442262.3732839,public.usertable,972133,74362,1215119360,16782,public,usertable,1,0,2584212,2688052,1018243,36750,46110,17019,972133,74362,1101103,1018243,,,,,0,0,0,0
1650442263.4065351,public.usertable,972535,74368,1215610880,16782,public,usertable,1,0,2585186,2688176,1018648,36755,46113,17022,972535,74368,1101516,1018648,,,,,0,0,0,0
1650442264.4367642,public.usertable,972923,74369,1216094208,16782,public,usertable,1,0,2586325,2688530,1019037,36758,46114,17024,972923,74369,1101909,1019037,,,,,0,0,0,0
1650442265.4670396,public.usertable,973338,74371,1216593920,16782,public,usertable,1,0,2587425,2688754,1019452,36760,46114,17026,973338,74371,1102326,1019452,,,,,0,0,0,0
1650442266.4963703,public.usertable,973796,74366,1217134592,16782,public,usertable,1,0,2588591,2689006,1019912,36760,46116,17026,973796,74366,1102788,1019912,,,,,0,0,0,0
1650442267.5266929,public.usertable,974230,74373,1217658880,16782,public,usertable,1,0,2589806,2689078,1020351,36762,46121,17027,974230,74373,1103234,1020351,,,,,0,0,0,0
1650442268.5552652,public.usertable,974635,74377,1218142208,16782,public,usertable,1,0,2590793,2689150,1020758,36764,46123,17027,974635,74377,1103645,1020758,,,,,0,0,0,0
1650442269.585046,public.usertable,975025,74381,1218584576,16782,public,usertable,1,0,2591880,2689324,1021151,36765,46126,17027,975025,74381,1104042,1021151,,,,,0,0,0,0
1650442270.6151304,public.usertable,975415,74389,1219108864,16782,public,usertable,1,0,2592865,2689425,1021544,36770,46129,17029,975415,74389,1104443,1021544,,,,,0,0,0,0
1650442271.645743,public.usertable,975815,74391,1219584000,16782,public,usertable,1,0,2593970,2689461,1021945,36771,46130,17030,975815,74391,1104846,1021945,,,,,0,0,0,0
1650442272.67808,public.usertable,976202,74396,1220050944,16782,public,usertable,1,0,2594965,2689698,1022333,36775,46131,17032,976202,74396,1105239,1022333,,,,,0,0,0,0
1650442273.7065866,public.usertable,976607,74404,1220550656,16782,public,usertable,1,0,2596157,2689861,1022743,36778,46136,17033,976607,74404,1105657,1022743,,,,,0,0,0,0
1650442274.734926,public.usertable,976996,74410,1221017600,16782,public,usertable,1,0,2597234,2689956,1023137,36779,46141,17034,976996,74410,1106057,1023137,,,,,0,0,0,0
1650442275.7668445,public.usertable,977400,74413,1221492736,16782,public,usertable,1,0,2598184,2690256,1023544,36780,46144,17034,977400,74413,1106468,1023544,,,,,0,0,0,0
1650442276.798062,public.usertable,977977,74419,1221967872,16782,public,usertable,1,0,2600061,2690646,1024125,36785,46148,17036,977977,74419,1107058,1024125,,,,,0,0,0,0
1650442277.8267658,public.usertable,978364,74424,1222443008,16782,public,usertable,1,0,2601140,2690819,1024515,36787,46151,17036,978364,74424,1107453,1024515,,,,,0,0,0,0
1650442278.8562558,public.usertable,978783,74429,1222950912,16782,public,usertable,1,0,2602339,2690993,1024937,36789,46154,17037,978783,74429,1107880,1024937,,,,,0,0,0,0
1650442279.8889966,public.usertable,979205,74436,1223475200,16782,public,usertable,1,0,2603466,2691009,1025363,36792,46158,17037,979205,74436,1108313,1025363,,,,,0,0,0,0
1650442280.919735,public.usertable,979636,74442,1223991296,16782,public,usertable,1,0,2604645,2691295,1025798,36794,46162,17039,979636,74442,1108754,1025798,,,,,0,0,0,0
1650442281.9500613,public.usertable,980058,74449,1224499200,16782,public,usertable,1,0,2605787,2691527,1026222,36799,46164,17042,980058,74449,1109185,1026222,,,,,0,0,0,0
1650442282.9795012,public.usertable,980485,74453,1225031680,16782,public,usertable,1,0,2606880,2691936,1026650,36802,46165,17043,980485,74453,1109617,1026650,,,,,0,0,0,0
1650442284.0106864,public.usertable,980903,74463,1225531392,16782,public,usertable,1,0,2607919,2692053,1027075,36805,46172,17046,980903,74463,1110052,1027075,,,,,0,0,0,0
1650442285.0394447,public.usertable,981328,74466,1226047488,16782,public,usertable,1,0,2608999,2692139,1027500,36808,46172,17047,981328,74466,1110480,1027500,,,,,0,0,0,0
1650442286.0710819,public.usertable,981746,74470,1226555392,16782,public,usertable,1,0,2610193,2692398,1027919,36811,46173,17050,981746,74470,1110903,1027919,,,,,0,0,0,0
1650442287.1005764,public.usertable,982166,74465,1227071488,16782,public,usertable,1,0,2611359,2692751,1028346,36813,46180,17051,982166,74465,1111339,1028346,,,,,0,0,0,0
1650442288.133344,public.usertable,982578,74470,1227530240,16782,public,usertable,1,0,2612545,2693065,1028762,36815,46184,17051,982578,74470,1111761,1028762,,,,,0,0,0,0
1650442289.1662567,public.usertable,982872,74476,1227849728,16782,public,usertable,1,0,2613333,2693256,1029059,36818,46187,17053,982872,74476,1112064,1029059,,,,,0,0,0,0
1650442290.1997864,public.usertable,983112,74478,1228177408,16782,public,usertable,1,0,2613942,2693335,1029300,36819,46188,17053,983112,74478,1112307,1029300,,,,,0,0,0,0
1650442291.2288134,public.usertable,983447,74487,1228562432,16782,public,usertable,1,0,2614837,2693511,1029642,36821,46195,17055,983447,74487,1112658,1029642,,,,,0,0,0,0
1650442292.2604744,public.usertable,983741,74491,1228922880,16782,public,usertable,1,0,2615722,2693603,1029939,36822,46198,17056,983741,74491,1112959,1029939,,,,,0,0,0,0
1650442293.289548,public.usertable,984060,74493,1229340672,16782,public,usertable,1,0,2616499,2693787,1030260,36822,46200,17056,984060,74493,1113282,1030260,,,,,0,0,0,0
1650442294.3200984,public.usertable,984380,74498,1229733888,16782,public,usertable,1,0,2617413,2694008,1030582,36825,46202,17058,984380,74498,1113609,1030582,,,,,0,0,0,0
1650442295.3496969,public.usertable,984925,74501,1230192640,16782,public,usertable,1,0,2618814,2694713,1031132,36826,46207,17059,984925,74501,1114165,1031132,,,,,0,0,0,0
1650442296.3778074,public.usertable,985334,74508,1230684160,16782,public,usertable,1,0,2619932,2694879,1031546,36828,46212,17061,985334,74508,1114586,1031546,,,,,0,0,0,0
1650442297.408411,public.usertable,985723,74511,1231159296,16782,public,usertable,1,0,2620940,2695081,1031937,36829,46214,17061,985723,74511,1114980,1031937,,,,,0,0,0,0
1650442298.440955,public.usertable,986111,74517,1231634432,16782,public,usertable,1,0,2622109,2695287,1032330,36830,46219,17061,986111,74517,1115379,1032330,,,,,0,0,0,0
1650442299.4714508,public.usertable,986507,74523,1232117760,16782,public,usertable,1,0,2623163,2695361,1032730,36832,46223,17062,986507,74523,1115785,1032730,,,,,0,0,0,0
1650442300.5012293,public.usertable,986857,74526,1232543744,16782,public,usertable,1,0,2624178,2695464,1033082,36833,46225,17062,986857,74526,1116140,1033082,,,,,0,0,0,0
1650442301.5314157,public.usertable,987262,74525,1233043456,16782,public,usertable,1,0,2625282,2695872,1033490,36835,46228,17063,987262,74525,1116553,1033490,,,,,0,0,0,0
1650442302.5642347,public.usertable,987644,74531,1233494016,16782,public,usertable,1,0,2626287,2695946,1033876,36837,46232,17064,987644,74531,1116945,1033876,,,,,0,0,0,0
1650442303.5943072,public.usertable,987963,74536,1233854464,16782,public,usertable,1,0,2627137,2696033,1034198,36839,46235,17064,987963,74536,1117272,1034198,,,,,0,0,0,0
1650442304.6246667,public.usertable,988227,74537,1234182144,16782,public,usertable,1,0,2627820,2696112,1034463,36839,46236,17064,988227,74537,1117538,1034463,,,,,0,0,0,0
1650442305.652608,public.usertable,988470,74541,1234493440,16782,public,usertable,1,0,2628617,2696269,1034708,36841,46238,17064,988470,74541,1117787,1034708,,,,,0,0,0,0
1650442306.6836352,public.usertable,988710,74541,1234796544,16782,public,usertable,1,0,2629253,2696405,1034950,36841,46240,17064,988710,74541,1118031,1034950,,,,,0,0,0,0
1650442307.7137074,public.usertable,988983,74540,1235107840,16782,public,usertable,1,0,2630045,2696539,1035226,36841,46243,17064,988983,74540,1118310,1035226,,,,,0,0,0,0
1650442308.7441792,public.usertable,989253,74543,1235410944,16782,public,usertable,1,0,2630836,2696618,1035498,36842,46245,17064,989253,74543,1118585,1035498,,,,,0,0,0,0
1650442309.7766378,public.usertable,989500,74547,1235755008,16782,public,usertable,1,0,2631461,2696937,1035747,36844,46247,17065,989500,74547,1118838,1035747,,,,,0,0,0,0
1650442310.8064775,public.usertable,989842,74553,1236164608,16782,public,usertable,1,0,2632386,2698389,1036092,36847,46250,17066,989842,74553,1119189,1036092,,,,,0,0,0,0
1650442311.83486,public.usertable,990176,74555,1236590592,16782,public,usertable,1,0,2633359,2698632,1036428,36847,46252,17066,990176,74555,1119527,1036428,,,,,0,0,0,0
1650442312.864242,public.usertable,990543,74562,1237049344,16782,public,usertable,1,0,2634380,2698679,1036801,36848,46258,17067,990543,74562,1119907,1036801,,,,,0,0,0,0
1650442313.894117,public.usertable,990944,74567,1237540864,16782,public,usertable,1,0,2635456,2698758,1037205,36850,46261,17069,990944,74567,1120316,1037205,,,,,0,0,0,0
1650442314.9233701,public.usertable,991336,74574,1238016000,16782,public,usertable,1,0,2636488,2699090,1037601,36853,46265,17069,991336,74574,1120719,1037601,,,,,0,0,0,0
1650442315.9530063,public.usertable,991936,74580,1238507520,16782,public,usertable,1,0,2638000,2699177,1038206,36854,46270,17070,991936,74580,1121330,1038206,,,,,0,0,0,0
1650442316.9838223,public.usertable,992361,74582,1239023616,16782,public,usertable,1,0,2639159,2699288,1038634,36855,46273,17070,992361,74582,1121762,1038634,,,,,0,0,0,0
1650442318.0152416,public.usertable,992765,74583,1239506944,16782,public,usertable,1,0,2640231,2699447,1039039,36855,46274,17070,992765,74583,1122168,1039039,,,,,0,0,0,0
1650442319.044656,public.usertable,993149,74582,1239982080,16782,public,usertable,1,0,2641395,2699664,1039428,36857,46279,17072,993149,74582,1122564,1039428,,,,,0,0,0,0
1650442320.0752013,public.usertable,993563,74584,1240489984,16782,public,usertable,1,0,2642530,2699873,1039843,36862,46280,17074,993563,74584,1122985,1039843,,,,,0,0,0,0
1650442321.1065042,public.usertable,993962,74588,1240965120,16782,public,usertable,1,0,2643569,2700072,1040242,36866,46280,17076,993962,74588,1123388,1040242,,,,,0,0,0,0
1650442322.1383984,public.usertable,994356,74597,1241440256,16782,public,usertable,1,0,2644661,2700270,1040643,36868,46287,17077,994356,74597,1123798,1040643,,,,,0,0,0,0
1650442323.167226,public.usertable,994731,74603,1241907200,16782,public,usertable,1,0,2645721,2700426,1041023,36869,46292,17077,994731,74603,1124184,1041023,,,,,0,0,0,0
1650442324.1962292,public.usertable,995132,74603,1242390528,16782,public,usertable,1,0,2646821,2700706,1041428,36870,46296,17077,995132,74603,1124594,1041428,,,,,0,0,0,0
1650442325.2257223,public.usertable,995526,74608,1242890240,16782,public,usertable,1,0,2647874,2701168,1041826,36871,46300,17077,995526,74608,1124997,1041826,,,,,0,0,0,0
1650442326.2559683,public.usertable,995967,74618,1243422720,16782,public,usertable,1,0,2649023,2701306,1042271,36877,46304,17081,995967,74618,1125452,1042271,,,,,0,0,0,0
1650442327.285608,public.usertable,996389,74623,1243938816,16782,public,usertable,1,0,2650165,2701335,1042697,36878,46308,17082,996389,74623,1125883,1042697,,,,,0,0,0,0
1650442328.3158789,public.usertable,996775,74627,1244381184,16782,public,usertable,1,0,2651208,2701461,1043086,36879,46311,17082,996775,74627,1126276,1043086,,,,,0,0,0,0
1650442329.344804,public.usertable,997164,74633,1244864512,16782,public,usertable,1,0,2652259,2701572,1043480,36880,46316,17082,997164,74633,1126676,1043480,,,,,0,0,0,0
1650442330.3737326,public.usertable,997565,74635,1245339648,16782,public,usertable,1,0,2653337,2701766,1043882,36881,46317,17082,997565,74635,1127080,1043882,,,,,0,0,0,0
1650442331.4022877,public.usertable,997927,74638,1245790208,16782,public,usertable,1,0,2654198,2701802,1044247,36881,46320,17082,997927,74638,1127448,1044247,,,,,0,0,0,0
1650442332.4317372,public.usertable,998317,74644,1246257152,16782,public,usertable,1,0,2655200,2701950,1044642,36882,46325,17082,998317,74644,1127849,1044642,,,,,0,0,0,0
1650442333.4620075,public.usertable,998887,74654,1246724096,16782,public,usertable,1,0,2656857,2702299,1045219,36885,46332,17084,998887,74654,1128436,1045219,,,,,0,0,0,0
1650442334.4925158,public.usertable,999274,74661,1247199232,16782,public,usertable,1,0,2657952,2702322,1045611,36887,46337,17084,999274,74661,1128835,1045611,,,,,0,0,0,0
1650442335.5241714,public.usertable,999637,74664,1247649792,16782,public,usertable,1,0,2658875,2702714,1045978,36889,46341,17085,999637,74664,1129208,1045978,,,,,0,0,0,0
1650442336.554734,public.usertable,1000017,74666,1248092160,16782,public,usertable,1,0,2659885,2702811,1046359,36890,46342,17085,1000017,74666,1129591,1046359,,,,,0,0,0,0
1650442337.585268,public.usertable,1000367,74673,1248518144,16782,public,usertable,1,0,2660736,2703097,1046710,36896,46343,17088,1000367,74673,1129949,1046710,,,,,0,0,0,0
1650442338.6153429,public.usertable,1000698,74674,1248919552,16782,public,usertable,1,0,2661689,2703192,1047041,36897,46343,17088,1000698,74674,1130281,1047041,,,,,0,0,0,0
1650442339.6471665,public.usertable,1001016,74678,1249312768,16782,public,usertable,1,0,2662592,2703369,1047361,36899,46345,17089,1001016,74678,1130605,1047361,,,,,0,0,0,0
1650442340.680532,public.usertable,1001392,74686,1249771520,16782,public,usertable,1,0,2663608,2703444,1047741,36903,46349,17090,1001392,74686,1130993,1047741,,,,,0,0,0,0
1650442341.7090642,public.usertable,1001750,74691,1250213888,16782,public,usertable,1,0,2664666,2703655,1048102,36905,46352,17091,1001750,74691,1131359,1048102,,,,,0,0,0,0
1650442342.7385004,public.usertable,1002118,74693,1250639872,16782,public,usertable,1,0,2665692,2703746,1048471,36906,46353,17092,1002118,74693,1131730,1048471,,,,,0,0,0,0
1650442343.7669237,public.usertable,1002481,74704,1251106816,16782,public,usertable,1,0,2666618,2703983,1048840,36911,46359,17094,1002481,74704,1132110,1048840,,,,,0,0,0,0
1650442344.7986825,public.usertable,1002859,74707,1251565568,16782,public,usertable,1,0,2667545,2704078,1049220,36912,46361,17095,1002859,74707,1132493,1049220,,,,,0,0,0,0
1650442345.8299978,public.usertable,1003255,74711,1252057088,16782,public,usertable,1,0,2668669,2704326,1049619,36913,46364,17096,1003255,74711,1132896,1049619,,,,,0,0,0,0
1650442346.8605266,public.usertable,1003614,74712,1252483072,16782,public,usertable,1,0,2669683,2704576,1049979,36914,46365,17096,1003614,74712,1133258,1049979,,,,,0,0,0,0
1650442347.892617,public.usertable,1003987,74716,1252900864,16782,public,usertable,1,0,2670693,2704731,1050356,36914,46369,17096,1003987,74716,1133639,1050356,,,,,0,0,0,0
1650442348.9224873,public.usertable,1004289,74720,1253285888,16782,public,usertable,1,0,2671489,2704751,1050659,36917,46370,17096,1004289,74720,1133946,1050659,,,,,0,0,0,0
1650442349.952115,public.usertable,1004676,74724,1253769216,16782,public,usertable,1,0,2672479,2704864,1051049,36918,46373,17097,1004676,74724,1134340,1051049,,,,,0,0,0,0
1650442350.9806206,public.usertable,1005087,74728,1254277120,16782,public,usertable,1,0,2673566,2704985,1051464,36918,46377,17097,1005087,74728,1134759,1051464,,,,,0,0,0,0
1650442352.0097077,public.usertable,1005488,74731,1254694912,16782,public,usertable,1,0,2674671,2705169,1051867,36921,46379,17098,1005488,74731,1135167,1051867,,,,,0,0,0,0
1650442353.0382447,public.usertable,1005808,74733,1255088128,16782,public,usertable,1,0,2675535,2705311,1052187,36923,46379,17099,1005808,74733,1135489,1052187,,,,,0,0,0,0
1650442354.0672083,public.usertable,1006262,74739,1255456768,16782,public,usertable,1,0,2676753,2705451,1052644,36926,46382,17100,1006262,74739,1135952,1052644,,,,,0,0,0,0
1650442355.099119,public.usertable,1006590,74738,1255841792,16782,public,usertable,1,0,2677651,2705596,1052974,36927,46384,17101,1006590,74738,1136285,1052974,,,,,0,0,0,0
1650442356.1279833,public.usertable,1006923,74743,1256251392,16782,public,usertable,1,0,2678531,2705779,1053310,36929,46387,17102,1006923,74743,1136626,1053310,,,,,0,0,0,0
1650442357.1573672,public.usertable,1007245,74745,1256644608,16782,public,usertable,1,0,2679396,2705848,1053632,36931,46387,17103,1007245,74745,1136950,1053632,,,,,0,0,0,0
1650442358.1879578,public.usertable,1007563,74750,1257021440,16782,public,usertable,1,0,2680241,2705860,1053952,36934,46389,17105,1007563,74750,1137275,1053952,,,,,0,0,0,0
1650442359.2169101,public.usertable,1007879,74753,1257422848,16782,public,usertable,1,0,2681028,2705981,1054270,36935,46391,17106,1007879,74753,1137596,1054270,,,,,0,0,0,0
1650442360.247797,public.usertable,1008231,74755,1257840640,16782,public,usertable,1,0,2681992,2706211,1054624,36937,46393,17107,1008231,74755,1137954,1054624,,,,,0,0,0,0
1650442361.2802808,public.usertable,1008604,74760,1258307584,16782,public,usertable,1,0,2682965,2706302,1055002,36937,46398,17107,1008604,74760,1138337,1055002,,,,,0,0,0,0
1650442362.3096611,public.usertable,1008982,74766,1258782720,16782,public,usertable,1,0,2683963,2706576,1055386,36939,46404,17108,1008982,74766,1138729,1055386,,,,,0,0,0,0
1650442363.339211,public.usertable,1009406,74771,1259282432,16782,public,usertable,1,0,2685070,2706772,1055815,36941,46409,17109,1009406,74771,1139165,1055815,,,,,0,0,0,0
1650442364.3705475,public.usertable,1009812,74777,1259782144,16782,public,usertable,1,0,2686117,2706913,1056224,36944,46412,17109,1009812,74777,1139580,1056224,,,,,0,0,0,0
1650442365.4004192,public.usertable,1010211,74783,1260290048,16782,public,usertable,1,0,2687171,2707025,1056628,36949,46417,17110,1010211,74783,1139994,1056628,,,,,0,0,0,0
1650442366.429359,public.usertable,1010609,74791,1260756992,16782,public,usertable,1,0,2688174,2707095,1057030,36953,46421,17111,1010609,74791,1140404,1057030,,,,,0,0,0,0
1650442367.4601624,public.usertable,1011008,74798,1261232128,16782,public,usertable,1,0,2689182,2707442,1057432,36957,46424,17112,1011008,74798,1140813,1057432,,,,,0,0,0,0
1650442368.4890788,public.usertable,1011399,74813,1261740032,16782,public,usertable,1,0,2690358,2707924,1057834,36961,46435,17114,1011399,74813,1141230,1057834,,,,,0,0,0,0
1650442369.5177512,public.usertable,1011808,74815,1262231552,16782,public,usertable,1,0,2691406,2708005,1058247,36963,46439,17116,1011808,74815,1141649,1058247,,,,,0,0,0,0
1650442370.5474346,public.usertable,1012229,74818,1262739456,16782,public,usertable,1,0,2692480,2708111,1058669,36965,46440,17117,1012229,74818,1142074,1058669,,,,,0,0,0,0
1650442371.579734,public.usertable,1012626,74822,1263222784,16782,public,usertable,1,0,2693409,2708228,1059069,36966,46443,17117,1012626,74822,1142478,1059069,,,,,0,0,0,0
1650442372.6079333,public.usertable,1013199,74832,1263673344,16782,public,usertable,1,0,2694956,2708308,1059646,36972,46447,17120,1013199,74832,1143065,1059646,,,,,0,0,0,0
1650442373.6369255,public.usertable,1013568,74835,1264115712,16782,public,usertable,1,0,2695973,2708395,1060017,36973,46449,17121,1013568,74835,1143439,1060017,,,,,0,0,0,0
1650442374.6661122,public.usertable,1013911,74841,1264541696,16782,public,usertable,1,0,2696889,2708469,1060362,36977,46451,17122,1013911,74841,1143790,1060362,,,,,0,0,0,0
1650442375.693738,public.usertable,1014272,74842,1264975872,16782,public,usertable,1,0,2697856,2708790,1060724,36977,46452,17122,1014272,74842,1144153,1060724,,,,,0,0,0,0
1650442376.7234955,public.usertable,1014635,74843,1265410048,16782,public,usertable,1,0,2698712,2708919,1061088,36980,46453,17125,1014635,74843,1144521,1061088,,,,,0,0,0,0
1650442377.7525249,public.usertable,1014981,74844,1265811456,16782,public,usertable,1,0,2699662,2709064,1061435,36980,46454,17125,1014981,74844,1144869,1061435,,,,,0,0,0,0
1650442378.7831068,public.usertable,1015335,74850,1266237440,16782,public,usertable,1,0,2700670,2709358,1061792,36984,46457,17127,1015335,74850,1145233,1061792,,,,,0,0,0,0
1650442379.8140078,public.usertable,1015699,74852,1266696192,16782,public,usertable,1,0,2701674,2709371,1062157,36985,46458,17127,1015699,74852,1145600,1062157,,,,,0,0,0,0
1650442380.8443902,public.usertable,1016064,74859,1267154944,16782,public,usertable,1,0,2702580,2709569,1062523,36991,46459,17131,1016064,74859,1145973,1062523,,,,,0,0,0,0
1650442381.873207,public.usertable,1016457,74863,1267630080,16782,public,usertable,1,0,2703702,2709817,1062919,36992,46462,17132,1016457,74863,1146373,1062919,,,,,0,0,0,0
1650442382.9025707,public.usertable,1016807,74864,1268031488,16782,public,usertable,1,0,2704645,2709875,1063270,36992,46463,17132,1016807,74864,1146725,1063270,,,,,0,0,0,0
1650442383.9311752,public.usertable,1017157,74870,1268482048,16782,public,usertable,1,0,2705586,2710065,1063622,36996,46465,17132,1017157,74870,1147083,1063622,,,,,0,0,0,0
1650442384.9596057,public.usertable,1017556,74879,1268948992,16782,public,usertable,1,0,2706660,2710106,1064028,36998,46472,17133,1017556,74879,1147498,1064028,,,,,0,0,0,0
1650442385.9896588,public.usertable,1017951,74883,1269448704,16782,public,usertable,1,0,2707634,2710347,1064424,37001,46473,17134,1017951,74883,1147898,1064424,,,,,0,0,0,0
1650442387.0243545,public.usertable,1018344,74887,1269915648,16782,public,usertable,1,0,2708691,2710494,1064820,37002,46476,17135,1018344,74887,1148298,1064820,,,,,0,0,0,0
1650442388.0549269,public.usertable,1018726,74893,1270358016,16782,public,usertable,1,0,2709655,2710620,1065205,37005,46479,17135,1018726,74893,1148689,1065205,,,,,0,0,0,0
1650442389.083678,public.usertable,1019102,74895,1270824960,16782,public,usertable,1,0,2710758,2710848,1065583,37005,46481,17135,1019102,74895,1149069,1065583,,,,,0,0,0,0
1650442390.1142395,public.usertable,1019500,74895,1271324672,16782,public,usertable,1,0,2711722,2711013,1065983,37005,46483,17135,1019500,74895,1149471,1065983,,,,,0,0,0,0
1650442391.1428022,public.usertable,1019905,74903,1271791616,16782,public,usertable,1,0,2712810,2711086,1066393,37008,46488,17136,1019905,74903,1149889,1066393,,,,,0,0,0,0
1650442392.1744459,public.usertable,1020288,74904,1272258560,16782,public,usertable,1,0,2713752,2711104,1066776,37014,46488,17140,1020288,74904,1150278,1066776,,,,,0,0,0,0
1650442393.204629,public.usertable,1020624,74899,1272643584,16782,public,usertable,1,0,2714556,2711242,1067113,37015,46489,17141,1020624,74899,1150617,1067113,,,,,0,0,0,0
1650442394.233889,public.usertable,1021161,74909,1273085952,16782,public,usertable,1,0,2715972,2711338,1067655,37020,46494,17142,1021161,74909,1151169,1067655,,,,,0,0,0,0
1650442395.2639356,public.usertable,1021498,74915,1273503744,16782,public,usertable,1,0,2716884,2711535,1067995,37023,46497,17145,1021498,74915,1151515,1067995,,,,,0,0,0,0
1650442396.2929893,public.usertable,1021870,74922,1273962496,16782,public,usertable,1,0,2717920,2711744,1068369,37028,46499,17146,1021870,74922,1151896,1068369,,,,,0,0,0,0
1650442397.3220668,public.usertable,1022252,74923,1274421248,16782,public,usertable,1,0,2719059,2712032,1068753,37029,46501,17147,1022252,74923,1152283,1068753,,,,,0,0,0,0
1650442398.3508787,public.usertable,1022656,74930,1274912768,16782,public,usertable,1,0,2720176,2712263,1069160,37033,46504,17150,1022656,74930,1152697,1069160,,,,,0,0,0,0
1650442399.380108,public.usertable,1023071,74936,1275404288,16782,public,usertable,1,0,2721169,2712332,1069576,37038,46505,17153,1023071,74936,1153119,1069576,,,,,0,0,0,0
1650442400.4101188,public.usertable,1023460,74942,1275887616,16782,public,usertable,1,0,2722196,2712464,1069969,37040,46509,17153,1023460,74942,1153518,1069969,,,,,0,0,0,0
1650442401.439873,public.usertable,1023859,74949,1276370944,16782,public,usertable,1,0,2723222,2712543,1070373,37042,46514,17154,1023859,74949,1153929,1070373,,,,,0,0,0,0
1650442402.4728038,public.usertable,1024258,74954,1276846080,16782,public,usertable,1,0,2724188,2712917,1070775,37044,46517,17154,1024258,74954,1154336,1070775,,,,,0,0,0,0
1650442403.5025437,public.usertable,1024647,74954,1277337600,16782,public,usertable,1,0,2725158,2713203,1071167,37045,46520,17154,1024647,74954,1154732,1071167,,,,,0,0,0,0
1650442404.5329602,public.usertable,1025071,74953,1277861888,16782,public,usertable,1,0,2726298,2713233,1071593,37046,46522,17155,1025071,74953,1155161,1071593,,,,,0,0,0,0
1650442405.5617461,public.usertable,1025496,74953,1278361600,16782,public,usertable,1,0,2727486,2713699,1072021,37048,46525,17157,1025496,74953,1155594,1072021,,,,,0,0,0,0
1650442406.5928464,public.usertable,1025915,74964,1278910464,16782,public,usertable,1,0,2728741,2713971,1072447,37053,46532,17161,1025915,74964,1156032,1072447,,,,,0,0,0,0
1650442407.6243532,public.usertable,1026362,74968,1279393792,16782,public,usertable,1,0,2729884,2714352,1072898,37057,46536,17163,1026362,74968,1156491,1072898,,,,,0,0,0,0
1650442408.6556113,public.usertable,1026750,74971,1279909888,16782,public,usertable,1,0,2731025,2714592,1073288,37060,46538,17164,1026750,74971,1156886,1073288,,,,,0,0,0,0
1650442409.6846836,public.usertable,1027168,74974,1280401408,16782,public,usertable,1,0,2732113,2714782,1073709,37060,46541,17164,1027168,74974,1157310,1073709,,,,,0,0,0,0
1650442410.7133224,public.usertable,1027580,74981,1280909312,16782,public,usertable,1,0,2733320,2714877,1074125,37063,46545,17165,1027580,74981,1157733,1074125,,,,,0,0,0,0
1650442411.7417858,public.usertable,1028008,74988,1281433600,16782,public,usertable,1,0,2734374,2715087,1074558,37065,46550,17167,1028008,74988,1158173,1074558,,,,,0,0,0,0
1650442412.7710452,public.usertable,1028634,74996,1281933312,16782,public,usertable,1,0,2736086,2715346,1075190,37069,46556,17169,1028634,74996,1158815,1075190,,,,,0,0,0,0
1650442413.8011074,public.usertable,1029057,75002,1282449408,16782,public,usertable,1,0,2737109,2715403,1075615,37073,46558,17172,1029057,75002,1159246,1075615,,,,,0,0,0,0
1650442414.834552,public.usertable,1029453,75010,1282932736,16782,public,usertable,1,0,2738170,2715481,1076014,37078,46561,17174,1029453,75010,1159653,1076014,,,,,0,0,0,0
1650442415.867102,public.usertable,1029877,75016,1283448832,16782,public,usertable,1,0,2739381,2715642,1076441,37081,46564,17175,1029877,75016,1160086,1076441,,,,,0,0,0,0
1650442416.8960657,public.usertable,1030318,75020,1283989504,16782,public,usertable,1,0,2740480,2715737,1076884,37083,46566,17176,1030318,75020,1160533,1076884,,,,,0,0,0,0
1650442417.9278257,public.usertable,1030702,75028,1284415488,16782,public,usertable,1,0,2741566,2715819,1077272,37087,46570,17178,1030702,75028,1160929,1077272,,,,,0,0,0,0
1650442418.9602752,public.usertable,1031032,75031,1284825088,16782,public,usertable,1,0,2742533,2715861,1077605,37087,46573,17178,1031032,75031,1161265,1077605,,,,,0,0,0,0
1650442419.999141,public.usertable,1031339,75033,1285193728,16782,public,usertable,1,0,2743415,2715954,1077913,37088,46574,17179,1031339,75033,1161575,1077913,,,,,0,0,0,0
1650442421.0297318,public.usertable,1031658,75034,1285595136,16782,public,usertable,1,0,2744222,2715964,1078232,37089,46574,17179,1031658,75034,1161895,1078232,,,,,0,0,0,0
1650442422.0585954,public.usertable,1031976,75036,1285988352,16782,public,usertable,1,0,2744954,2716238,1078551,37090,46575,17179,1031976,75036,1162216,1078551,,,,,0,0,0,0
1650442423.0889807,public.usertable,1032252,75037,1286258688,16782,public,usertable,1,0,2745675,2716242,1078828,37090,46576,17179,1032252,75037,1162494,1078828,,,,,0,0,0,0
1650442424.1181936,public.usertable,1032517,75037,1286610944,16782,public,usertable,1,0,2746363,2716443,1079094,37091,46577,17180,1032517,75037,1162762,1079094,,,,,0,0,0,0
1650442425.1490405,public.usertable,1032797,75038,1286963200,16782,public,usertable,1,0,2747023,2716470,1079375,37091,46578,17180,1032797,75038,1163044,1079375,,,,,0,0,0,0
1650442426.1800022,public.usertable,1033069,75042,1287299072,16782,public,usertable,1,0,2747765,2716530,1079648,37094,46579,17182,1033069,75042,1163321,1079648,,,,,0,0,0,0
1650442427.2082863,public.usertable,1033387,75047,1287692288,16782,public,usertable,1,0,2748577,2716646,1079968,37097,46581,17183,1033387,75047,1163646,1079968,,,,,0,0,0,0
1650442428.2372284,public.usertable,1033748,75053,1288167424,16782,public,usertable,1,0,2749537,2716784,1080334,37098,46586,17183,1033748,75053,1164018,1080334,,,,,0,0,0,0
1650442429.2666528,public.usertable,1034144,75060,1288650752,16782,public,usertable,1,0,2750711,2716909,1080734,37101,46590,17184,1034144,75060,1164425,1080734,,,,,0,0,0,0
1650442430.295553,public.usertable,1034530,75062,1289109504,16782,public,usertable,1,0,2751761,2717193,1081122,37101,46592,17184,1034530,75062,1164815,1081122,,,,,0,0,0,0
1650442431.3275142,public.usertable,1035140,75070,1289617408,16782,public,usertable,1,0,2753355,2717358,1081735,37106,46595,17188,1035140,75070,1165436,1081735,,,,,0,0,0,0
1650442432.3560781,public.usertable,1035535,75081,1290100736,16782,public,usertable,1,0,2754328,2717538,1082134,37113,46599,17190,1035535,75081,1165846,1082134,,,,,0,0,0,0
1650442433.3848362,public.usertable,1035942,75087,1290592256,16782,public,usertable,1,0,2755342,2717614,1082545,37115,46603,17191,1035942,75087,1166263,1082545,,,,,0,0,0,0
1650442434.4160917,public.usertable,1036377,75092,1291124736,16782,public,usertable,1,0,2756479,2718401,1082982,37118,46605,17193,1036377,75092,1166705,1082982,,,,,0,0,0,0
1650442435.4473825,public.usertable,1036810,75096,1291649024,16782,public,usertable,1,0,2757678,2718612,1083415,37122,46605,17194,1036810,75096,1167142,1083415,,,,,0,0,0,0
1650442436.4772968,public.usertable,1037228,75101,1292148736,16782,public,usertable,1,0,2758770,2718777,1083835,37125,46607,17194,1037228,75101,1167567,1083835,,,,,0,0,0,0
1650442437.507748,public.usertable,1037650,75104,1292664832,16782,public,usertable,1,0,2759810,2718857,1084260,37125,46610,17194,1037650,75104,1167995,1084260,,,,,0,0,0,0
1650442438.5385756,public.usertable,1038066,75106,1293180928,16782,public,usertable,1,0,2761012,2719050,1084679,37127,46613,17194,1038066,75106,1168419,1084679,,,,,0,0,0,0
1650442439.56752,public.usertable,1038516,75109,1293721600,16782,public,usertable,1,0,2762148,2719616,1085132,37129,46616,17196,1038516,75109,1168877,1085132,,,,,0,0,0,0
1650442440.5969265,public.usertable,1038938,75116,1294237696,16782,public,usertable,1,0,2763403,2719758,1085557,37133,46619,17196,1038938,75116,1169309,1085557,,,,,0,0,0,0
1650442441.6267848,public.usertable,1039369,75121,1294761984,16782,public,usertable,1,0,2764525,2719850,1085993,37133,46624,17196,1039369,75121,1169750,1085993,,,,,0,0,0,0
1650442442.6579287,public.usertable,1039790,75127,1295261696,16782,public,usertable,1,0,2765661,2720219,1086420,37133,46630,17196,1039790,75127,1170183,1086420,,,,,0,0,0,0
1650442443.6887553,public.usertable,1040197,75132,1295769600,16782,public,usertable,1,0,2766881,2720347,1086830,37135,46633,17197,1040197,75132,1170598,1086830,,,,,0,0,0,0
1650442444.7186322,public.usertable,1040631,75137,1296302080,16782,public,usertable,1,0,2767971,2720397,1087267,37137,46636,17199,1040631,75137,1171040,1087267,,,,,0,0,0,0
1650442445.7473514,public.usertable,1041054,75142,1296801792,16782,public,usertable,1,0,2769099,2720537,1087693,37139,46639,17200,1041054,75142,1171471,1087693,,,,,0,0,0,0
1650442446.7751753,public.usertable,1041458,75145,1297309696,16782,public,usertable,1,0,2770333,2720866,1088101,37140,46643,17200,1041458,75145,1171884,1088101,,,,,0,0,0,0
1650442447.8035862,public.usertable,1041889,75148,1297801216,16782,public,usertable,1,0,2771696,2721046,1088534,37144,46645,17201,1041889,75148,1172323,1088534,,,,,0,0,0,0
1650442448.8337913,public.usertable,1042309,75154,1298341888,16782,public,usertable,1,0,2772766,2721109,1088955,37149,46646,17204,1042309,75154,1172750,1088955,,,,,0,0,0,0
1650442449.86198,public.usertable,1042927,75159,1298825216,16782,public,usertable,1,0,2774474,2721590,1089579,37155,46652,17205,1042927,75159,1173386,1089579,,,,,0,0,0,0
1650442450.8917465,public.usertable,1043353,75163,1299349504,16782,public,usertable,1,0,2775716,2721716,1090009,37160,46656,17208,1043353,75163,1173825,1090009,,,,,0,0,0,0
1650442451.9219027,public.usertable,1043758,75165,1299832832,16782,public,usertable,1,0,2776694,2721858,1090417,37163,46659,17211,1043758,75165,1174239,1090417,,,,,0,0,0,0
1650442452.9507816,public.usertable,1044174,75170,1300348928,16782,public,usertable,1,0,2777667,2722158,1090837,37165,46663,17212,1044174,75170,1174665,1090837,,,,,0,0,0,0
1650442453.9815066,public.usertable,1044563,75176,1300824064,16782,public,usertable,1,0,2778739,2722267,1091229,37168,46666,17213,1044563,75176,1175063,1091229,,,,,0,0,0,0
1650442455.0100572,public.usertable,1044956,75183,1301299200,16782,public,usertable,1,0,2779967,2722325,1091626,37171,46670,17214,1044956,75183,1175467,1091626,,,,,0,0,0,0
1650442456.0379863,public.usertable,1045344,75185,1301782528,16782,public,usertable,1,0,2780980,2722468,1092016,37171,46672,17214,1045344,75185,1175859,1092016,,,,,0,0,0,0
1650442457.0663197,public.usertable,1045697,75190,1302192128,16782,public,usertable,1,0,2782041,2722869,1092372,37173,46675,17214,1045697,75190,1176220,1092372,,,,,0,0,0,0
1650442458.0952094,public.usertable,1046004,75190,1302568960,16782,public,usertable,1,0,2782756,2722919,1092679,37173,46675,17214,1046004,75190,1176527,1092679,,,,,0,0,0,0
1650442459.1258295,public.usertable,1046333,75194,1302953984,16782,public,usertable,1,0,2783584,2722987,1093009,37176,46676,17214,1046333,75194,1176861,1093009,,,,,0,0,0,0
1650442460.1580856,public.usertable,1046626,75191,1303289856,16782,public,usertable,1,0,2784430,2723212,1093305,37176,46679,17214,1046626,75191,1177160,1093305,,,,,0,0,0,0
1650442461.187218,public.usertable,1046924,75194,1303666688,16782,public,usertable,1,0,2785209,2723326,1093605,37177,46681,17215,1046924,75194,1177463,1093605,,,,,0,0,0,0
1650442462.2203565,public.usertable,1047187,75200,1303977984,16782,public,usertable,1,0,2785940,2723396,1093873,37178,46686,17216,1047187,75200,1177737,1093873,,,,,0,0,0,0
1650442463.2507484,public.usertable,1047450,75203,1304272896,16782,public,usertable,1,0,2786604,2723535,1094139,37178,46689,17216,1047450,75203,1178006,1094139,,,,,0,0,0,0
1650442464.28203,public.usertable,1047721,75205,1304682496,16782,public,usertable,1,0,2787291,2723556,1094412,37178,46691,17216,1047721,75205,1178281,1094412,,,,,0,0,0,0
1650442465.3108697,public.usertable,1048066,75206,1305075712,16782,public,usertable,1,0,2788091,2723571,1094757,37179,46691,17216,1048066,75206,1178627,1094757,,,,,0,0,0,0
1650442466.3403943,public.usertable,1048437,75210,1305493504,16782,public,usertable,1,0,2789136,2723947,1095132,37183,46695,17217,1048437,75210,1179010,1095132,,,,,0,0,0,0
1650442467.3703861,public.usertable,1048817,75214,1306017792,16782,public,usertable,1,0,2790219,2724078,1095515,37184,46698,17218,1048817,75214,1179397,1095515,,,,,0,0,0,0
1650442468.401327,public.usertable,1049231,75214,1306533888,16782,public,usertable,1,0,2791328,2724199,1095934,37186,46703,17218,1049231,75214,1179823,1095934,,,,,0,0,0,0
1650442469.432571,public.usertable,1049860,75223,1307041792,16782,public,usertable,1,0,2792942,2724489,1096571,37187,46711,17218,1049860,75223,1180469,1096571,,,,,0,0,0,0
1650442470.461492,public.usertable,1050263,75229,1307525120,16782,public,usertable,1,0,2793986,2724558,1096980,37187,46717,17218,1050263,75229,1180884,1096980,,,,,0,0,0,0
1650442471.494014,public.usertable,1050660,75233,1308016640,16782,public,usertable,1,0,2794976,2724637,1097378,37192,46718,17220,1050660,75233,1181288,1097378,,,,,0,0,0,0
1650442472.5221941,public.usertable,1051043,75238,1308475392,16782,public,usertable,1,0,2796099,2725018,1097765,37193,46722,17221,1051043,75238,1181680,1097765,,,,,0,0,0,0
1650442473.5519407,public.usertable,1051402,75240,1308901376,16782,public,usertable,1,0,2797044,2725209,1098126,37193,46724,17221,1051402,75240,1182043,1098126,,,,,0,0,0,0
1650442474.5817716,public.usertable,1051705,75250,1309302784,16782,public,usertable,1,0,2797930,2725269,1098434,37198,46729,17223,1051705,75250,1182361,1098434,,,,,0,0,0,0
1650442475.611449,public.usertable,1052029,75250,1309687808,16782,public,usertable,1,0,2798870,2725571,1098761,37199,46732,17223,1052029,75250,1182692,1098761,,,,,0,0,0,0
1650442476.640417,public.usertable,1052367,75253,1310064640,16782,public,usertable,1,0,2799802,2725582,1099101,37200,46734,17224,1052367,75253,1183035,1099101,,,,,0,0,0,0
1650442477.6726487,public.usertable,1052664,75255,1310441472,16782,public,usertable,1,0,2800617,2725875,1099399,37201,46735,17225,1052664,75255,1183335,1099399,,,,,0,0,0,0
1650442478.7030895,public.usertable,1052938,75260,1310760960,16782,public,usertable,1,0,2801379,2726142,1099676,37203,46738,17226,1052938,75260,1183617,1099676,,,,,0,0,0,0
1650442479.7336168,public.usertable,1053207,75261,1311072256,16782,public,usertable,1,0,2802076,2726315,1099946,37203,46739,17226,1053207,75261,1183888,1099946,,,,,0,0,0,0
1650442480.7638144,public.usertable,1053478,75265,1311449088,16782,public,usertable,1,0,2802891,2726551,1100217,37207,46739,17229,1053478,75265,1184163,1100217,,,,,0,0,0,0
1650442481.7942703,public.usertable,1053793,75267,1311809536,16782,public,usertable,1,0,2803840,2726599,1100534,37207,46741,17229,1053793,75267,1184482,1100534,,,,,0,0,0,0
1650442482.822411,public.usertable,1054098,75275,1312186368,16782,public,usertable,1,0,2804633,2726767,1100840,37214,46742,17233,1054098,75275,1184796,1100840,,,,,0,0,0,0
1650442483.8510075,public.usertable,1054458,75279,1312653312,16782,public,usertable,1,0,2805628,2727103,1101202,37216,46744,17235,1054458,75279,1185162,1101202,,,,,0,0,0,0
1650442484.884251,public.usertable,1054831,75282,1313103872,16782,public,usertable,1,0,2806726,2727352,1101576,37218,46745,17236,1054831,75282,1185539,1101576,,,,,0,0,0,0
1650442485.9195044,public.usertable,1055231,75283,1313570816,16782,public,usertable,1,0,2807933,2727481,1101978,37221,46747,17238,1055231,75283,1185946,1101978,,,,,0,0,0,0
1650442486.9504592,public.usertable,1055597,75289,1314013184,16782,public,usertable,1,0,2808955,2727537,1102347,37224,46750,17238,1055597,75289,1186321,1102347,,,,,0,0,0,0
1650442487.9817667,public.usertable,1055996,75293,1314545664,16782,public,usertable,1,0,2810074,2727721,1102748,37226,46752,17239,1055996,75293,1186726,1102748,,,,,0,0,0,0
1650442489.0131402,public.usertable,1056637,75304,1315053568,16782,public,usertable,1,0,2811740,2727897,1103394,37232,46757,17241,1056637,75304,1187383,1103394,,,,,0,0,0,0
1650442490.042648,public.usertable,1057031,75307,1315528704,16782,public,usertable,1,0,2812828,2728189,1103791,37234,46760,17242,1057031,75307,1187785,1103791,,,,,0,0,0,0
1650442491.0713344,public.usertable,1057452,75315,1316044800,16782,public,usertable,1,0,2813901,2728249,1104216,37238,46764,17243,1057452,75315,1188218,1104216,,,,,0,0,0,0
1650442492.0997083,public.usertable,1057847,75320,1316528128,16782,public,usertable,1,0,2814908,2728280,1104612,37242,46765,17245,1057847,75320,1188619,1104612,,,,,0,0,0,0
1650442493.1283555,public.usertable,1058267,75323,1317027840,16782,public,usertable,1,0,2815972,2728323,1105032,37245,46765,17246,1058267,75323,1189042,1105032,,,,,0,0,0,0
1650442494.1589334,public.usertable,1058669,75333,1317535744,16782,public,usertable,1,0,2817025,2728418,1105442,37247,46773,17246,1058669,75333,1189462,1105442,,,,,0,0,0,0
1650442495.187578,public.usertable,1059105,75332,1318060032,16782,public,usertable,1,0,2818223,2728774,1105878,37249,46773,17247,1059105,75332,1189900,1105878,,,,,0,0,0,0
1650442496.2159061,public.usertable,1059550,75334,1318592512,16782,public,usertable,1,0,2819407,2729008,1106325,37249,46775,17247,1059550,75334,1190349,1106325,,,,,0,0,0,0
1650442497.2466028,public.usertable,1059977,75335,1319108608,16782,public,usertable,1,0,2820624,2729201,1106752,37250,46775,17247,1059977,75335,1190777,1106752,,,,,0,0,0,0
1650442498.275078,public.usertable,1060403,75335,1319624704,16782,public,usertable,1,0,2821759,2729425,1107178,37250,46775,17247,1060403,75335,1191203,1107178,,,,,0,0,0,0
1650442499.3041675,public.usertable,1060834,75335,1320140800,16782,public,usertable,1,0,2822872,2729695,1107609,37252,46775,17247,1060834,75335,1191636,1107609,,,,,0,0,0,0
1650442500.3337033,public.usertable,1061241,75343,1320640512,16782,public,usertable,1,0,2824017,2729770,1108021,37255,46780,17248,1061241,75343,1192056,1108021,,,,,0,0,0,0
1650442501.364433,public.usertable,1061640,75347,1321099264,16782,public,usertable,1,0,2825072,2730103,1108423,37258,46783,17250,1061640,75347,1192464,1108423,,,,,0,0,0,0
1650442502.3931742,public.usertable,1061986,75357,1321492480,16782,public,usertable,1,0,2826070,2730300,1108773,37264,46787,17252,1061986,75357,1192824,1108773,,,,,0,0,0,0
1650442503.422625,public.usertable,1062302,75362,1321918464,16782,public,usertable,1,0,2827009,2730377,1109093,37265,46791,17252,1062302,75362,1193149,1109093,,,,,0,0,0,0
1650442504.4523542,public.usertable,1062682,75366,1322377216,16782,public,usertable,1,0,2827979,2730432,1109476,37266,46794,17252,1062682,75366,1193536,1109476,,,,,0,0,0,0
1650442505.4820766,public.usertable,1063048,75373,1322811392,16782,public,usertable,1,0,2828948,2730495,1109847,37268,46799,17254,1063048,75373,1193914,1109847,,,,,0,0,0,0
1650442506.5134885,public.usertable,1063408,75377,1323245568,16782,public,usertable,1,0,2829859,2730569,1110208,37271,46800,17256,1063408,75377,1194279,1110208,,,,,0,0,0,0
1650442507.5432518,public.usertable,1064027,75378,1323778048,16782,public,usertable,1,0,2831486,2730805,1110830,37272,46803,17257,1064027,75378,1194905,1110830,,,,,0,0,0,0
1650442508.5751617,public.usertable,1064421,75382,1324253184,16782,public,usertable,1,0,2832535,2731055,1111227,37273,46806,17258,1064421,75382,1195306,1111227,,,,,0,0,0,0
1650442509.6036067,public.usertable,1064853,75386,1324777472,16782,public,usertable,1,0,2833679,2731142,1111661,37275,46808,17260,1064853,75386,1195744,1111661,,,,,0,0,0,0
1650442510.633913,public.usertable,1065275,75389,1325301760,16782,public,usertable,1,0,2834961,2731426,1112085,37278,46810,17260,1065275,75389,1196173,1112085,,,,,0,0,0,0
1650442511.6645246,public.usertable,1065735,75393,1325858816,16782,public,usertable,1,0,2836260,2731579,1112547,37280,46812,17260,1065735,75393,1196639,1112547,,,,,0,0,0,0
1650442512.6937902,public.usertable,1066153,75394,1326358528,16782,public,usertable,1,0,2837295,2731804,1112968,37282,46815,17261,1066153,75394,1197065,1112968,,,,,0,0,0,0
1650442513.724414,public.usertable,1066557,75397,1326850048,16782,public,usertable,1,0,2838314,2731961,1113375,37282,46818,17261,1066557,75397,1197475,1113375,,,,,0,0,0,0
1650442514.754273,public.usertable,1066942,75399,1327308800,16782,public,usertable,1,0,2839347,2732159,1113760,37284,46818,17262,1066942,75399,1197862,1113760,,,,,0,0,0,0
1650442515.7842855,public.usertable,1067318,75403,1327759360,16782,public,usertable,1,0,2840341,2732199,1114138,37286,46820,17263,1067318,75403,1198244,1114138,,,,,0,0,0,0
1650442516.8159351,public.usertable,1067694,75410,1328226304,16782,public,usertable,1,0,2841302,2732247,1114520,37287,46826,17263,1067694,75410,1198633,1114520,,,,,0,0,0,0
1650442517.847563,public.usertable,1068105,75411,1328717824,16782,public,usertable,1,0,2842359,2732521,1114933,37289,46828,17265,1068105,75411,1199050,1114933,,,,,0,0,0,0
1650442518.8768642,public.usertable,1068514,75412,1329225728,16782,public,usertable,1,0,2843489,2732687,1115343,37289,46829,17265,1068514,75412,1199461,1115343,,,,,0,0,0,0
1650442519.9074562,public.usertable,1068925,75417,1329717248,16782,public,usertable,1,0,2844671,2732794,1115758,37291,46833,17266,1068925,75417,1199882,1115758,,,,,0,0,0,0
1650442520.9379206,public.usertable,1069343,75420,1330233344,16782,public,usertable,1,0,2845778,2732866,1116178,37292,46835,17267,1069343,75420,1200305,1116178,,,,,0,0,0,0
1650442521.9679627,public.usertable,1069755,75431,1330708480,16782,public,usertable,1,0,2846854,2733234,1116595,37298,46840,17271,1069755,75431,1200733,1116595,,,,,0,0,0,0
1650442522.9963214,public.usertable,1070129,75437,1331183616,16782,public,usertable,1,0,2847850,2733301,1116973,37300,46844,17271,1070129,75437,1201117,1116973,,,,,0,0,0,0
1650442524.0255187,public.usertable,1070543,75444,1331675136,16782,public,usertable,1,0,2848972,2733353,1117391,37303,46848,17272,1070543,75444,1201542,1117391,,,,,0,0,0,0
1650442525.0557544,public.usertable,1070948,75450,1332215808,16782,public,usertable,1,0,2850122,2733404,1117799,37306,46851,17272,1070948,75450,1201956,1117799,,,,,0,0,0,0
1650442526.092518,public.usertable,1071619,75461,1332764672,16782,public,usertable,1,0,2851889,2733614,1118474,37313,46855,17272,1071619,75461,1202642,1118474,,,,,0,0,0,0
1650442527.1236398,public.usertable,1072061,75463,1333297152,16782,public,usertable,1,0,2853118,2733701,1118918,37316,46857,17272,1072061,75463,1203091,1118918,,,,,0,0,0,0
1650442528.1539745,public.usertable,1072481,75472,1333829632,16782,public,usertable,1,0,2854302,2733759,1119346,37319,46865,17275,1072481,75472,1203530,1119346,,,,,0,0,0,0
1650442529.1832507,public.usertable,1072943,75470,1334378496,16782,public,usertable,1,0,2855523,2733923,1119809,37319,46866,17275,1072943,75470,1203994,1119809,,,,,0,0,0,0
1650442530.2149506,public.usertable,1073379,75473,1334910976,16782,public,usertable,1,0,2856632,2733934,1120247,37320,46868,17275,1073379,75473,1204435,1120247,,,,,0,0,0,0
1650442531.2444062,public.usertable,1073827,75471,1335443456,16782,public,usertable,1,0,2857705,2734190,1120699,37323,46872,17277,1073827,75471,1204894,1120699,,,,,0,0,0,0
1650442532.2737913,public.usertable,1074217,75473,1335926784,16782,public,usertable,1,0,2858782,2734334,1121091,37325,46874,17278,1074217,75473,1205290,1121091,,,,,0,0,0,0
1650442533.3031137,public.usertable,1074661,75476,1336459264,16782,public,usertable,1,0,2859947,2734388,1121537,37326,46876,17279,1074661,75476,1205739,1121537,,,,,0,0,0,0
1650442534.3321679,public.usertable,1075090,75479,1336983552,16782,public,usertable,1,0,2861097,2734443,1121968,37328,46878,17279,1075090,75479,1206174,1121968,,,,,0,0,0,0
1650442535.3626847,public.usertable,1075502,75481,1337458688,16782,public,usertable,1,0,2862200,2734616,1122381,37329,46879,17280,1075502,75481,1206589,1122381,,,,,0,0,0,0
1650442536.391467,public.usertable,1075897,75490,1337958400,16782,public,usertable,1,0,2863277,2734875,1122782,37332,46885,17282,1075897,75490,1206999,1122782,,,,,0,0,0,0
1650442537.4246297,public.usertable,1076305,75496,1338466304,16782,public,usertable,1,0,2864526,2735040,1123193,37335,46888,17282,1076305,75496,1207416,1123193,,,,,0,0,0,0
1650442538.4563136,public.usertable,1076737,75501,1338974208,16782,public,usertable,1,0,2865718,2735177,1123627,37338,46890,17283,1076737,75501,1207855,1123627,,,,,0,0,0,0
1650442539.4867442,public.usertable,1077129,75498,1339465728,16782,public,usertable,1,0,2866820,2735367,1124023,37340,46894,17284,1077129,75498,1208257,1124023,,,,,0,0,0,0
1650442540.5185213,public.usertable,1077538,75501,1339957248,16782,public,usertable,1,0,2867819,2735473,1124433,37342,46895,17285,1077538,75501,1208670,1124433,,,,,0,0,0,0
1650442541.5468466,public.usertable,1077941,75506,1340432384,16782,public,usertable,1,0,2868901,2735540,1124840,37343,46899,17286,1077941,75506,1209082,1124840,,,,,0,0,0,0
1650442542.5756857,public.usertable,1078337,75510,1340915712,16782,public,usertable,1,0,2870019,2735840,1125239,37348,46902,17289,1078337,75510,1209489,1125239,,,,,0,0,0,0
1650442543.6048589,public.usertable,1078757,75509,1341440000,16782,public,usertable,1,0,2871244,2735864,1125660,37350,46903,17289,1078757,75509,1209913,1125660,,,,,0,0,0,0
1650442544.6363866,public.usertable,1079384,75514,1341939712,16782,public,usertable,1,0,2873028,2736076,1126289,37353,46905,17290,1079384,75514,1210547,1126289,,,,,0,0,0,0
1650442545.6672509,public.usertable,1079808,75520,1342455808,16782,public,usertable,1,0,2874107,2736198,1126716,37356,46908,17293,1079808,75520,1210980,1126716,,,,,0,0,0,0
1650442546.6960905,public.usertable,1080171,75525,1342898176,16782,public,usertable,1,0,2875124,2736226,1127082,37358,46911,17295,1080171,75525,1211351,1127082,,,,,0,0,0,0
1650442547.7254097,public.usertable,1080574,75527,1343373312,16782,public,usertable,1,0,2876177,2736447,1127487,37358,46913,17295,1080574,75527,1211758,1127487,,,,,0,0,0,0
1650442548.7560608,public.usertable,1080997,75530,1343905792,16782,public,usertable,1,0,2877282,2736600,1127912,37359,46915,17295,1080997,75530,1212186,1127912,,,,,0,0,0,0
1650442549.785578,public.usertable,1081417,75533,1344397312,16782,public,usertable,1,0,2878398,2736727,1128334,37360,46917,17296,1081417,75533,1212611,1128334,,,,,0,0,0,0
1650442550.8155437,public.usertable,1081818,75538,1344897024,16782,public,usertable,1,0,2879465,2736959,1128739,37362,46921,17296,1081818,75538,1213022,1128739,,,,,0,0,0,0
1650442551.8446717,public.usertable,1082209,75540,1345363968,16782,public,usertable,1,0,2880714,2737047,1129132,37363,46923,17296,1082209,75540,1213418,1129132,,,,,0,0,0,0
1650442552.8763921,public.usertable,1082595,75542,1345830912,16782,public,usertable,1,0,2881705,2737073,1129519,37364,46924,17296,1082595,75542,1213807,1129519,,,,,0,0,0,0
1650442553.9087348,public.usertable,1082997,75548,1346330624,16782,public,usertable,1,0,2882797,2737208,1129927,37364,46930,17296,1082997,75548,1214221,1129927,,,,,0,0,0,0
1650442554.9381683,public.usertable,1083415,75554,1346846720,16782,public,usertable,1,0,2883920,2737327,1130349,37366,46934,17296,1083415,75554,1214649,1130349,,,,,0,0,0,0
1650442555.967277,public.usertable,1083868,75557,1347395584,16782,public,usertable,1,0,2885117,2737470,1130803,37368,46935,17297,1083868,75557,1215106,1130803,,,,,0,0,0,0
1650442556.9997592,public.usertable,1084293,75558,1347903488,16782,public,usertable,1,0,2886210,2737612,1131232,37369,46939,17298,1084293,75558,1215540,1131232,,,,,0,0,0,0
1650442558.0303833,public.usertable,1084715,75563,1348427776,16782,public,usertable,1,0,2887337,2737761,1131657,37371,46942,17298,1084715,75563,1215970,1131657,,,,,0,0,0,0
1650442559.060945,public.usertable,1085159,75559,1348976640,16782,public,usertable,1,0,2888565,2737868,1132103,37372,46944,17298,1085159,75559,1216419,1132103,,,,,0,0,0,0
1650442560.0919852,public.usertable,1085602,75560,1349500928,16782,public,usertable,1,0,2889729,2738035,1132547,37372,46945,17298,1085602,75560,1216864,1132547,,,,,0,0,0,0
1650442561.125819,public.usertable,1086045,75566,1350041600,16782,public,usertable,1,0,2890917,2738328,1132997,37373,46952,17299,1086045,75566,1217322,1132997,,,,,0,0,0,0
1650442562.154909,public.usertable,1086694,75567,1350565888,16782,public,usertable,1,0,2892727,2738575,1133650,37374,46956,17300,1086694,75567,1217980,1133650,,,,,0,0,0,0
1650442563.1861122,public.usertable,1087122,75571,1351073792,16782,public,usertable,1,0,2893831,2738659,1134079,37377,46957,17301,1087122,75571,1218413,1134079,,,,,0,0,0,0
1650442564.2151077,public.usertable,1087568,75577,1351622656,16782,public,usertable,1,0,2895002,2738743,1134527,37381,46959,17304,1087568,75577,1218867,1134527,,,,,0,0,0,0
1650442565.2450452,public.usertable,1088037,75581,1352187904,16782,public,usertable,1,0,2896209,2738832,1134998,37383,46961,17305,1088037,75581,1219342,1134998,,,,,0,0,0,0
1650442566.275187,public.usertable,1088474,75585,1352720384,16782,public,usertable,1,0,2897413,2739009,1135436,37386,46962,17308,1088474,75585,1219784,1135436,,,,,0,0,0,0
1650442567.3058465,public.usertable,1088938,75592,1353285632,16782,public,usertable,1,0,2898577,2739153,1135905,37388,46967,17309,1088938,75592,1220260,1135905,,,,,0,0,0,0
1650442568.3350613,public.usertable,1089391,75599,1353850880,16782,public,usertable,1,0,2899752,2739277,1136362,37391,46971,17311,1089391,75599,1220724,1136362,,,,,0,0,0,0
1650442569.3642037,public.usertable,1089853,75605,1354391552,16782,public,usertable,1,0,2900906,2739337,1136827,37394,46974,17312,1089853,75605,1221195,1136827,,,,,0,0,0,0
1650442570.3935418,public.usertable,1090312,75608,1354956800,16782,public,usertable,1,0,2901999,2739468,1137288,37395,46976,17313,1090312,75608,1221659,1137288,,,,,0,0,0,0
1650442571.4233341,public.usertable,1090771,75615,1355513856,16782,public,usertable,1,0,2903185,2739549,1137750,37399,46979,17315,1090771,75615,1222128,1137750,,,,,0,0,0,0
1650442572.4569294,public.usertable,1091217,75619,1356046336,16782,public,usertable,1,0,2904362,2739736,1138200,37399,46983,17315,1091217,75619,1222582,1138200,,,,,0,0,0,0
1650442573.4871619,public.usertable,1091653,75622,1356587008,16782,public,usertable,1,0,2905547,2739880,1138637,37403,46984,17317,1091653,75622,1223024,1138637,,,,,0,0,0,0
1650442574.5171359,public.usertable,1092081,75623,1357070336,16782,public,usertable,1,0,2906682,2739981,1139065,37404,46984,17317,1092081,75623,1223453,1139065,,,,,0,0,0,0
1650442575.5473993,public.usertable,1092455,75628,1357529088,16782,public,usertable,1,0,2907763,2740159,1139444,37405,46989,17318,1092455,75628,1223838,1139444,,,,,0,0,0,0
1650442576.5774615,public.usertable,1092860,75631,1357987840,16782,public,usertable,1,0,2908885,2740303,1139850,37407,46990,17319,1092860,75631,1224247,1139850,,,,,0,0,0,0
1650442577.6050985,public.usertable,1093238,75635,1358487552,16782,public,usertable,1,0,2909933,2740492,1140231,37409,46993,17321,1093238,75635,1224633,1140231,,,,,0,0,0,0
1650442578.6362069,public.usertable,1093647,75637,1358987264,16782,public,usertable,1,0,2911053,2740714,1140642,37410,46995,17322,1093647,75637,1225047,1140642,,,,,0,0,0,0
1650442579.6648161,public.usertable,1094062,75643,1359486976,16782,public,usertable,1,0,2912141,2740896,1141063,37410,47001,17322,1094062,75643,1225474,1141063,,,,,0,0,0,0
1650442580.6934502,public.usertable,1094704,75650,1360011264,16782,public,usertable,1,0,2913819,2741241,1141710,37414,47006,17324,1094704,75650,1226130,1141710,,,,,0,0,0,0
1650442581.7237463,public.usertable,1095111,75653,1360502784,16782,public,usertable,1,0,2914809,2741413,1142120,37414,47009,17324,1095111,75653,1226543,1142120,,,,,0,0,0,0
1650442582.754826,public.usertable,1095515,75654,1360994304,16782,public,usertable,1,0,2915926,2741469,1142525,37414,47010,17324,1095515,75654,1226949,1142525,,,,,0,0,0,0
1650442583.786252,public.usertable,1095917,75659,1361477632,16782,public,usertable,1,0,2916978,2741923,1142928,37418,47011,17328,1095917,75659,1227357,1142928,,,,,0,0,0,0
1650442584.8171306,public.usertable,1096351,75668,1362018304,16782,public,usertable,1,0,2918130,2741976,1143366,37423,47015,17332,1096351,75668,1227804,1143366,,,,,0,0,0,0
1650442585.8470082,public.usertable,1096801,75673,1362550784,16782,public,usertable,1,0,2919255,2742093,1143819,37427,47018,17333,1096801,75673,1228264,1143819,,,,,0,0,0,0
1650442586.8789642,public.usertable,1097232,75681,1363091456,16782,public,usertable,1,0,2920523,2742267,1144253,37432,47021,17336,1097232,75681,1228706,1144253,,,,,0,0,0,0
1650442587.9088612,public.usertable,1097670,75687,1363632128,16782,public,usertable,1,0,2921665,2742322,1144694,37435,47024,17338,1097670,75687,1229153,1144694,,,,,0,0,0,0
1650442588.9377782,public.usertable,1098128,75686,1364172800,16782,public,usertable,1,0,2922950,2742692,1145153,37436,47025,17339,1098128,75686,1229614,1145153,,,,,0,0,0,0
1650442589.9674568,public.usertable,1098554,75688,1364672512,16782,public,usertable,1,0,2924071,2742741,1145581,37436,47027,17339,1098554,75688,1230044,1145581,,,,,0,0,0,0
1650442590.998376,public.usertable,1098975,75692,1365196800,16782,public,usertable,1,0,2925156,2742873,1146004,37438,47029,17339,1098975,75692,1230471,1146004,,,,,0,0,0,0
1650442592.0281599,public.usertable,1099424,75697,1365737472,16782,public,usertable,1,0,2926444,2742975,1146457,37439,47033,17339,1099424,75697,1230929,1146457,,,,,0,0,0,0
1650442593.0577397,public.usertable,1099843,75705,1366261760,16782,public,usertable,1,0,2927513,2743080,1146879,37444,47036,17341,1099843,75705,1231359,1146879,,,,,0,0,0,0
1650442594.0913208,public.usertable,1100281,75712,1366786048,16782,public,usertable,1,0,2928660,2743140,1147321,37447,47040,17342,1100281,75712,1231808,1147321,,,,,0,0,0,0
1650442595.1205022,public.usertable,1100726,75715,1367334912,16782,public,usertable,1,0,2929838,2743318,1147767,37449,47041,17344,1100726,75715,1232257,1147767,,,,,0,0,0,0
1650442596.1536176,public.usertable,1101159,75719,1367867392,16782,public,usertable,1,0,2931055,2743562,1148203,37452,47044,17345,1101159,75719,1232699,1148203,,,,,0,0,0,0
1650442597.183449,public.usertable,1101593,75722,1368391680,16782,public,usertable,1,0,2932206,2743778,1148640,37452,47047,17345,1101593,75722,1233139,1148640,,,,,0,0,0,0
1650442598.212908,public.usertable,1102023,75726,1368891392,16782,public,usertable,1,0,2933365,2743880,1149074,37452,47051,17345,1102023,75726,1233577,1149074,,,,,0,0,0,0
1650442599.2431042,public.usertable,1102659,75731,1369423872,16782,public,usertable,1,0,2935051,2744006,1149712,37455,47053,17345,1102659,75731,1234220,1149712,,,,,0,0,0,0
1650442600.2746694,public.usertable,1103084,75734,1369931776,16782,public,usertable,1,0,2936146,2744237,1150138,37460,47054,17350,1103084,75734,1234652,1150138,,,,,0,0,0,0
1650442601.3078077,public.usertable,1103497,75738,1370431488,16782,public,usertable,1,0,2937229,2744316,1150552,37463,47055,17351,1103497,75738,1235070,1150552,,,,,0,0,0,0
1650442602.3372915,public.usertable,1103894,75741,1370914816,16782,public,usertable,1,0,2938292,2744421,1150951,37464,47057,17351,1103894,75741,1235472,1150951,,,,,0,0,0,0
1650442603.3663573,public.usertable,1104315,75745,1371439104,16782,public,usertable,1,0,2939518,2744635,1151374,37466,47059,17351,1104315,75745,1235899,1151374,,,,,0,0,0,0
1650442604.395851,public.usertable,1104738,75748,1371938816,16782,public,usertable,1,0,2940634,2744708,1151798,37468,47060,17352,1104738,75748,1236326,1151798,,,,,0,0,0,0
1650442605.4272888,public.usertable,1105167,75751,1372463104,16782,public,usertable,1,0,2941767,2744757,1152230,37469,47063,17353,1105167,75751,1236762,1152230,,,,,0,0,0,0
1650442606.4568503,public.usertable,1105583,75756,1372954624,16782,public,usertable,1,0,2942829,2745054,1152649,37471,47066,17353,1105583,75756,1237186,1152649,,,,,0,0,0,0
1650442607.492334,public.usertable,1105990,75755,1373421568,16782,public,usertable,1,0,2943910,2745528,1153056,37473,47066,17354,1105990,75755,1237595,1153056,,,,,0,0,0,0
1650442608.5207877,public.usertable,1106366,75758,1373921280,16782,public,usertable,1,0,2944910,2745607,1153432,37476,47066,17356,1106366,75758,1237974,1153432,,,,,0,0,0,0
1650442609.5523126,public.usertable,1106806,75757,1374437376,16782,public,usertable,1,0,2946133,2745904,1153873,37477,47067,17356,1106806,75757,1238417,1153873,,,,,0,0,0,0
1650442610.580446,public.usertable,1107223,75760,1374953472,16782,public,usertable,1,0,2947345,2746116,1154291,37479,47068,17357,1107223,75760,1238838,1154291,,,,,0,0,0,0
1650442611.6090834,public.usertable,1107639,75762,1375404032,16782,public,usertable,1,0,2948515,2746276,1154708,37480,47069,17357,1107639,75762,1239257,1154708,,,,,0,0,0,0
1650442612.637069,public.usertable,1107910,75766,1375698944,16782,public,usertable,1,0,2949191,2746310,1154981,37482,47071,17358,1107910,75766,1239534,1154981,,,,,0,0,0,0
1650442613.6667821,public.usertable,1108181,75770,1376051200,16782,public,usertable,1,0,2949878,2746445,1155254,37484,47073,17360,1108181,75770,1239811,1155254,,,,,0,0,0,0
1650442614.701234,public.usertable,1108482,75773,1376403456,16782,public,usertable,1,0,2950720,2746535,1155556,37486,47074,17361,1108482,75773,1240116,1155556,,,,,0,0,0,0
1650442615.7329667,public.usertable,1108754,75775,1376690176,16782,public,usertable,1,0,2951355,2746604,1155829,37487,47075,17362,1108754,75775,1240391,1155829,,,,,0,0,0,0
1650442616.7622457,public.usertable,1109006,75776,1377001472,16782,public,usertable,1,0,2952082,2746642,1156081,37488,47075,17362,1109006,75776,1240644,1156081,,,,,0,0,0,0
1650442617.7938156,public.usertable,1109260,75777,1377320960,16782,public,usertable,1,0,2952774,2746660,1156335,37489,47075,17362,1109260,75777,1240899,1156335,,,,,0,0,0,0
1650442618.8248107,public.usertable,1109615,75783,1377599488,16782,public,usertable,1,0,2953672,2746754,1156694,37491,47079,17362,1109615,75783,1241264,1156694,,,,,0,0,0,0
1650442619.8550732,public.usertable,1109841,75786,1377861632,16782,public,usertable,1,0,2954272,2746942,1156920,37494,47079,17363,1109841,75786,1241493,1156920,,,,,0,0,0,0
1650442620.882978,public.usertable,1110087,75791,1378164736,16782,public,usertable,1,0,2954973,2747067,1157170,37495,47083,17364,1110087,75791,1241748,1157170,,,,,0,0,0,0
1650442621.9111757,public.usertable,1110326,75792,1378467840,16782,public,usertable,1,0,2955619,2747124,1157410,37495,47084,17364,1110326,75792,1241989,1157410,,,,,0,0,0,0
1650442622.9393249,public.usertable,1110601,75796,1378795520,16782,public,usertable,1,0,2956391,2747204,1157686,37498,47085,17366,1110601,75796,1242269,1157686,,,,,0,0,0,0
1650442623.9682963,public.usertable,1110995,75795,1379270656,16782,public,usertable,1,0,2957504,2747381,1158083,37499,47088,17367,1110995,75795,1242670,1158083,,,,,0,0,0,0
1650442624.9979906,public.usertable,1111397,75799,1379762176,16782,public,usertable,1,0,2958561,2747460,1158487,37501,47090,17368,1111397,75799,1243078,1158487,,,,,0,0,0,0
1650442626.0273862,public.usertable,1111763,75806,1380204544,16782,public,usertable,1,0,2959561,2747486,1158856,37505,47093,17371,1111763,75806,1243454,1158856,,,,,0,0,0,0
1650442627.0578127,public.usertable,1112195,75811,1380745216,16782,public,usertable,1,0,2960718,2747550,1159293,37505,47098,17371,1112195,75811,1243896,1159293,,,,,0,0,0,0
1650442628.0862186,public.usertable,1112640,75814,1381285888,16782,public,usertable,1,0,2961847,2747622,1159740,37506,47100,17371,1112640,75814,1244346,1159740,,,,,0,0,0,0
1650442629.1170824,public.usertable,1113080,75819,1381810176,16782,public,usertable,1,0,2963003,2747689,1160184,37507,47104,17372,1113080,75819,1244795,1160184,,,,,0,0,0,0
1650442630.1482375,public.usertable,1113515,75823,1382342656,16782,public,usertable,1,0,2964298,2747870,1160621,37509,47106,17374,1113515,75823,1245236,1160621,,,,,0,0,0,0
1650442631.1775117,public.usertable,1113927,75829,1382842368,16782,public,usertable,1,0,2965433,2748019,1161036,37512,47109,17375,1113927,75829,1245657,1161036,,,,,0,0,0,0
1650442632.20854,public.usertable,1114362,75829,1383374848,16782,public,usertable,1,0,2966742,2748172,1161471,37512,47109,17375,1114362,75829,1246092,1161471,,,,,0,0,0,0
1650442633.2392004,public.usertable,1114795,75831,1383882752,16782,public,usertable,1,0,2967821,2748330,1161908,37514,47113,17376,1114795,75831,1246535,1161908,,,,,0,0,0,0
1650442634.2689528,public.usertable,1115212,75833,1384390656,16782,public,usertable,1,0,2969198,2748506,1162330,37515,47118,17376,1115212,75833,1246963,1162330,,,,,0,0,0,0
1650442635.2972043,public.usertable,1115628,75837,1384890368,16782,public,usertable,1,0,2970301,2748657,1162749,37516,47121,17376,1115628,75837,1247386,1162749,,,,,0,0,0,0
1650442636.3294597,public.usertable,1115996,75841,1385340928,16782,public,usertable,1,0,2971331,2748679,1163120,37517,47124,17376,1115996,75841,1247761,1163120,,,,,0,0,0,0
1650442637.361203,public.usertable,1116382,75842,1385799680,16782,public,usertable,1,0,2972361,2748711,1163506,37518,47124,17377,1116382,75842,1248148,1163506,,,,,0,0,0,0
1650442638.3911755,public.usertable,1116768,75842,1386233856,16782,public,usertable,1,0,2973327,2748964,1163892,37518,47124,17377,1116768,75842,1248534,1163892,,,,,0,0,0,0
1650442639.4202807,public.usertable,1117324,75847,1386700800,16782,public,usertable,1,0,2974729,2749064,1164451,37520,47127,17378,1117324,75847,1249098,1164451,,,,,0,0,0,0
1650442640.4564314,public.usertable,1117633,75848,1387077632,16782,public,usertable,1,0,2975563,2749410,1164761,37520,47128,17378,1117633,75848,1249409,1164761,,,,,0,0,0,0
1650442641.4874911,public.usertable,1117895,75849,1387388928,16782,public,usertable,1,0,2976273,2749441,1165024,37520,47129,17378,1117895,75849,1249673,1165024,,,,,0,0,0,0
1650442642.5187955,public.usertable,1118184,75854,1387732992,16782,public,usertable,1,0,2977007,2749463,1165316,37522,47132,17379,1118184,75854,1249970,1165316,,,,,0,0,0,0
1650442643.5518801,public.usertable,1118448,75858,1388060672,16782,public,usertable,1,0,2977611,2749500,1165583,37523,47135,17379,1118448,75858,1250241,1165583,,,,,0,0,0,0
1650442644.583204,public.usertable,1118772,75860,1388445696,16782,public,usertable,1,0,2978468,2749532,1165908,37524,47136,17379,1118772,75860,1250568,1165908,,,,,0,0,0,0
1650442645.6129594,public.usertable,1119096,75861,1388822528,16782,public,usertable,1,0,2979237,2749702,1166233,37524,47137,17379,1119096,75861,1250894,1166233,,,,,0,0,0,0
1650442646.6426322,public.usertable,1119353,75865,1389142016,16782,public,usertable,1,0,2980001,2749756,1166491,37527,47138,17381,1119353,75865,1251156,1166491,,,,,0,0,0,0
1650442647.672068,public.usertable,1119630,75866,1389469696,16782,public,usertable,1,0,2980769,2749923,1166769,37529,47139,17383,1119630,75866,1251437,1166769,,,,,0,0,0,0
1650442648.702932,public.usertable,1119907,75869,1389821952,16782,public,usertable,1,0,2981600,2750057,1167048,37530,47141,17383,1119907,75869,1251719,1167048,,,,,0,0,0,0
1650442649.7348764,public.usertable,1120253,75871,1390297088,16782,public,usertable,1,0,2982606,2750317,1167395,37531,47142,17383,1120253,75871,1252068,1167395,,,,,0,0,0,0
1650442650.7668576,public.usertable,1120694,75874,1390829568,16782,public,usertable,1,0,2983867,2750412,1167838,37532,47144,17383,1120694,75874,1252514,1167838,,,,,0,0,0,0
1650442651.7959638,public.usertable,1121146,75878,1391378432,16782,public,usertable,1,0,2985092,2750512,1168294,37534,47148,17384,1121146,75878,1252976,1168294,,,,,0,0,0,0
1650442652.8251736,public.usertable,1121576,75878,1391886336,16782,public,usertable,1,0,2986288,2750606,1168724,37534,47148,17384,1121576,75878,1253406,1168724,,,,,0,0,0,0
1650442653.8544936,public.usertable,1122005,75880,1392410624,16782,public,usertable,1,0,2987546,2750850,1169154,37538,47149,17384,1122005,75880,1253841,1169154,,,,,0,0,0,0
1650442654.882945,public.usertable,1122428,75891,1392926720,16782,public,usertable,1,0,2988598,2750916,1169583,37543,47155,17386,1122428,75891,1254281,1169583,,,,,0,0,0,0
1650442655.9116383,public.usertable,1122857,75899,1393434624,16782,public,usertable,1,0,2989714,2750948,1170016,37547,47159,17389,1122857,75899,1254722,1170016,,,,,0,0,0,0
1650442656.9407945,public.usertable,1123269,75906,1393967104,16782,public,usertable,1,0,2990988,2750996,1170434,37548,47165,17389,1123269,75906,1255147,1170434,,,,,0,0,0,0
1650442657.9726758,public.usertable,1123915,75907,1394475008,16782,public,usertable,1,0,2992775,2751242,1171082,37549,47167,17389,1123915,75907,1255798,1171082,,,,,0,0,0,0
1650442659.0031016,public.usertable,1124318,75914,1394974720,16782,public,usertable,1,0,2993776,2751411,1171487,37554,47169,17391,1124318,75914,1256210,1171487,,,,,0,0,0,0
1650442660.033832,public.usertable,1124720,75919,1395466240,16782,public,usertable,1,0,2994780,2751439,1171891,37557,47171,17391,1124720,75919,1256619,1171891,,,,,0,0,0,0
1650442661.0653849,public.usertable,1125138,75923,1395965952,16782,public,usertable,1,0,2996014,2751564,1172312,37558,47174,17392,1125138,75923,1257044,1172312,,,,,0,0,0,0
1650442662.0968163,public.usertable,1125547,75932,1396465664,16782,public,usertable,1,0,2997186,2751604,1172726,37562,47179,17394,1125547,75932,1257467,1172726,,,,,0,0,0,0
1650442663.1284175,public.usertable,1125971,75932,1396981760,16782,public,usertable,1,0,2998406,2751778,1173151,37564,47180,17395,1125971,75932,1257895,1173151,,,,,0,0,0,0
1650442664.159257,public.usertable,1126386,75936,1397481472,16782,public,usertable,1,0,2999468,2751866,1173569,37565,47183,17395,1126386,75936,1258317,1173569,,,,,0,0,0,0
1650442665.1895032,public.usertable,1126807,75944,1398005760,16782,public,usertable,1,0,3000643,2751951,1173994,37569,47187,17397,1126807,75944,1258750,1173994,,,,,0,0,0,0
1650442666.2198718,public.usertable,1127244,75944,1398530048,16782,public,usertable,1,0,3001978,2752024,1174432,37570,47188,17397,1127244,75944,1259190,1174432,,,,,0,0,0,0
1650442667.2509243,public.usertable,1127660,75947,1399021568,16782,public,usertable,1,0,3003009,2752061,1174850,37571,47190,17398,1127660,75947,1259611,1174850,,,,,0,0,0,0
1650442668.2803154,public.usertable,1128064,75952,1399513088,16782,public,usertable,1,0,3004116,2752173,1175259,37571,47195,17398,1128064,75952,1260025,1175259,,,,,0,0,0,0
1650442669.3102496,public.usertable,1128456,75955,1400012800,16782,public,usertable,1,0,3005231,2752326,1175654,37573,47198,17399,1128456,75955,1260425,1175654,,,,,0,0,0,0
1650442670.3409297,public.usertable,1128890,75958,1400528896,16782,public,usertable,1,0,3006446,2752417,1176090,37574,47200,17399,1128890,75958,1260864,1176090,,,,,0,0,0,0
1650442671.3734298,public.usertable,1129323,75963,1401069568,16782,public,usertable,1,0,3007668,2752513,1176526,37576,47203,17399,1129323,75963,1261305,1176526,,,,,0,0,0,0
1650442672.4034016,public.usertable,1129753,75970,1401585664,16782,public,usertable,1,0,3008923,2752679,1176960,37579,47207,17402,1129753,75970,1261746,1176960,,,,,0,0,0,0
1650442673.4315882,public.usertable,1130171,75973,1402077184,16782,public,usertable,1,0,3010040,2752761,1177381,37579,47210,17402,1130171,75973,1262170,1177381,,,,,0,0,0,0
1650442674.4626513,public.usertable,1130574,75978,1402552320,16782,public,usertable,1,0,3011217,2752926,1177790,37580,47216,17402,1130574,75978,1262586,1177790,,,,,0,0,0,0
1650442675.491425,public.usertable,1130942,75979,1403002880,16782,public,usertable,1,0,3012272,2753000,1178160,37582,47218,17403,1130942,75979,1262960,1178160,,,,,0,0,0,0
1650442676.5204234,public.usertable,1131519,75988,1403478016,16782,public,usertable,1,0,3013791,2753222,1178744,37584,47225,17405,1131519,75988,1263553,1178744,,,,,0,0,0,0
1650442677.5514405,public.usertable,1131889,75992,1403928576,16782,public,usertable,1,0,3014704,2753363,1179117,37585,47228,17405,1131889,75992,1263930,1179117,,,,,0,0,0,0
1650442678.5804572,public.usertable,1132244,76002,1404379136,16782,public,usertable,1,0,3015636,2753394,1179480,37587,47236,17406,1132244,76002,1264303,1179480,,,,,0,0,0,0
1650442679.6125238,public.usertable,1132636,76006,1404837888,16782,public,usertable,1,0,3016609,2753438,1179874,37589,47238,17406,1132636,76006,1264701,1179874,,,,,0,0,0,0
1650442680.6426134,public.usertable,1133018,76009,1405304832,16782,public,usertable,1,0,3017497,2753695,1180258,37591,47240,17407,1133018,76009,1265089,1180258,,,,,0,0,0,0
1650442681.674546,public.usertable,1133427,76013,1405796352,16782,public,usertable,1,0,3018594,2753838,1180669,37593,47242,17407,1133427,76013,1265504,1180669,,,,,0,0,0,0
1650442682.703296,public.usertable,1133830,76018,1406296064,16782,public,usertable,1,0,3019735,2754030,1181075,37596,47245,17409,1133830,76018,1265916,1181075,,,,,0,0,0,0
1650442683.7337255,public.usertable,1134243,76020,1406795776,16782,public,usertable,1,0,3020831,2754251,1181490,37600,47247,17411,1134243,76020,1266337,1181490,,,,,0,0,0,0
1650442684.762452,public.usertable,1134681,76022,1407320064,16782,public,usertable,1,0,3022046,2754346,1181928,37602,47247,17411,1134681,76022,1266777,1181928,,,,,0,0,0,0
1650442685.790536,public.usertable,1135101,76023,1407795200,16782,public,usertable,1,0,3023126,2754508,1182348,37603,47247,17411,1135101,76023,1267198,1182348,,,,,0,0,0,0
1650442686.8213995,public.usertable,1135503,76032,1408311296,16782,public,usertable,1,0,3024227,2754582,1182756,37606,47253,17413,1135503,76032,1267615,1182756,,,,,0,0,0,0
1650442687.8524718,public.usertable,1135914,76039,1408819200,16782,public,usertable,1,0,3025326,2754652,1183168,37612,47254,17415,1135914,76039,1268034,1183168,,,,,0,0,0,0
1650442688.8819203,public.usertable,1136312,76041,1409310720,16782,public,usertable,1,0,3026340,2754692,1183567,37613,47255,17416,1136312,76041,1268435,1183567,,,,,0,0,0,0
1650442689.9103427,public.usertable,1136721,76038,1409794048,16782,public,usertable,1,0,3027416,2754852,1183979,37614,47258,17416,1136721,76038,1268851,1183979,,,,,0,0,0,0
1650442690.942043,public.usertable,1137132,76042,1410285568,16782,public,usertable,1,0,3028503,2755016,1184394,37614,47262,17416,1137132,76042,1269270,1184394,,,,,0,0,0,0
1650442691.973134,public.usertable,1137512,76045,1410760704,16782,public,usertable,1,0,3029542,2755178,1184774,37617,47262,17416,1137512,76045,1269653,1184774,,,,,0,0,0,0
1650442693.001244,public.usertable,1137946,76054,1411293184,16782,public,usertable,1,0,3030640,2755217,1185212,37622,47266,17419,1137946,76054,1270100,1185212,,,,,0,0,0,0
1650442694.0319917,public.usertable,1138388,76063,1411833856,16782,public,usertable,1,0,3031883,2755241,1185659,37626,47271,17422,1138388,76063,1270556,1185659,,,,,0,0,0,0
1650442695.063582,public.usertable,1139002,76070,1412317184,16782,public,usertable,1,0,3033438,2755335,1186276,37630,47274,17423,1139002,76070,1271180,1186276,,,,,0,0,0,0
1650442696.0937805,public.usertable,1139410,76075,1412816896,16782,public,usertable,1,0,3034519,2755379,1186687,37632,47277,17423,1139410,76075,1271596,1186687,,,,,0,0,0,0
1650442697.123165,public.usertable,1139808,76081,1413300224,16782,public,usertable,1,0,3035597,2755568,1187089,37634,47281,17423,1139808,76081,1272004,1187089,,,,,0,0,0,0
1650442698.1528199,public.usertable,1140185,76084,1413758976,16782,public,usertable,1,0,3036587,2755666,1187468,37635,47283,17423,1140185,76084,1272386,1187468,,,,,0,0,0,0
1650442699.1817513,public.usertable,1140615,76086,1414275072,16782,public,usertable,1,0,3037686,2755791,1187898,37637,47283,17423,1140615,76086,1272818,1187898,,,,,0,0,0,0
1650442700.2117794,public.usertable,1140978,76088,1414725632,16782,public,usertable,1,0,3038602,2755816,1188262,37638,47284,17423,1140978,76088,1273184,1188262,,,,,0,0,0,0
1650442701.2436821,public.usertable,1141388,76090,1415208960,16782,public,usertable,1,0,3039729,2756004,1188673,37639,47285,17424,1141388,76090,1273597,1188673,,,,,0,0,0,0
1650442702.2741156,public.usertable,1141761,76096,1415667712,16782,public,usertable,1,0,3040777,2756084,1189050,37641,47289,17425,1141761,76096,1273980,1189050,,,,,0,0,0,0
1650442703.3037715,public.usertable,1142150,76094,1416142848,16782,public,usertable,1,0,3041782,2756277,1189440,37641,47290,17425,1142150,76094,1274371,1189440,,,,,0,0,0,0
1650442704.3363507,public.usertable,1142530,76098,1416593408,16782,public,usertable,1,0,3042772,2756379,1189821,37644,47291,17426,1142530,76098,1274756,1189821,,,,,0,0,0,0
1650442705.3678904,public.usertable,1142929,76102,1417084928,16782,public,usertable,1,0,3043868,2756540,1190222,37646,47293,17427,1142929,76102,1275161,1190222,,,,,0,0,0,0
1650442706.3989005,public.usertable,1143363,76109,1417625600,16782,public,usertable,1,0,3045075,2756677,1190657,37652,47294,17430,1143363,76109,1275603,1190657,,,,,0,0,0,0
1650442707.4276044,public.usertable,1143810,76111,1418158080,16782,public,usertable,1,0,3046236,2756771,1191106,37653,47296,17430,1143810,76111,1276055,1191106,,,,,0,0,0,0
1650442708.4577725,public.usertable,1144240,76112,1418690560,16782,public,usertable,1,0,3047384,2756845,1191538,37655,47298,17431,1144240,76112,1276491,1191538,,,,,0,0,0,0
1650442709.4878783,public.usertable,1144679,76117,1419223040,16782,public,usertable,1,0,3048619,2756922,1191981,37656,47302,17431,1144679,76117,1276939,1191981,,,,,0,0,0,0
1650442710.5192287,public.usertable,1145123,76113,1419739136,16782,public,usertable,1,0,3049674,2757050,1192426,37656,47303,17431,1145123,76113,1277385,1192426,,,,,0,0,0,0
1650442711.5513153,public.usertable,1145541,76116,1420255232,16782,public,usertable,1,0,3050863,2757255,1192849,37658,47308,17432,1145541,76116,1277815,1192849,,,,,0,0,0,0
1650442712.5811367,public.usertable,1145968,76118,1420787712,16782,public,usertable,1,0,3052059,2757560,1193278,37658,47310,17432,1145968,76118,1278246,1193278,,,,,0,0,0,0
1650442713.6103513,public.usertable,1146616,76122,1421303808,16782,public,usertable,1,0,3053811,2757860,1193929,37662,47313,17435,1146616,76122,1278904,1193929,,,,,0,0,0,0
1650442714.6411126,public.usertable,1147018,76124,1421795328,16782,public,usertable,1,0,3054867,2757898,1194333,37662,47315,17435,1147018,76124,1279310,1194333,,,,,0,0,0,0
1650442715.6733491,public.usertable,1147425,76123,1422286848,16782,public,usertable,1,0,3056075,2758464,1194740,37665,47315,17437,1147425,76123,1279720,1194740,,,,,0,0,0,0
1650442716.7020252,public.usertable,1147839,76128,1422786560,16782,public,usertable,1,0,3057137,2758538,1195158,37666,47319,17437,1147839,76128,1280143,1195158,,,,,0,0,0,0
1650442717.7305338,public.usertable,1148248,76131,1423278080,16782,public,usertable,1,0,3058191,2758589,1195567,37669,47319,17437,1148248,76131,1280555,1195567,,,,,0,0,0,0
1650442718.765475,public.usertable,1148640,76133,1423753216,16782,public,usertable,1,0,3059276,2758749,1195959,37671,47319,17438,1148640,76133,1280949,1195959,,,,,0,0,0,0
1650442719.7949162,public.usertable,1149046,76137,1424244736,16782,public,usertable,1,0,3060293,2758805,1196366,37674,47320,17439,1149046,76137,1281360,1196366,,,,,0,0,0,0
1650442720.8239949,public.usertable,1149441,76138,1424728064,16782,public,usertable,1,0,3061420,2758964,1196763,37675,47322,17439,1149441,76138,1281760,1196763,,,,,0,0,0,0
1650442721.8532891,public.usertable,1149851,76143,1425227776,16782,public,usertable,1,0,3062485,2759065,1197175,37678,47324,17441,1149851,76143,1282177,1197175,,,,,0,0,0,0
1650442722.8842866,public.usertable,1150278,76148,1425752064,16782,public,usertable,1,0,3063712,2759198,1197606,37680,47328,17441,1150278,76148,1282614,1197606,,,,,0,0,0,0
1650442723.914183,public.usertable,1150723,76150,1426292736,16782,public,usertable,1,0,3064905,2759216,1198053,37680,47330,17441,1150723,76150,1283063,1198053,,,,,0,0,0,0
1650442724.9464984,public.usertable,1151150,76154,1426817024,16782,public,usertable,1,0,3066142,2759472,1198483,37681,47333,17441,1151150,76154,1283497,1198483,,,,,0,0,0,0
1650442725.9752438,public.usertable,1151593,76157,1427341312,16782,public,usertable,1,0,3067382,2759489,1198927,37683,47334,17441,1151593,76157,1283944,1198927,,,,,0,0,0,0
1650442727.0070484,public.usertable,1152016,76159,1427857408,16782,public,usertable,1,0,3068521,2759645,1199352,37684,47336,17442,1152016,76159,1284372,1199352,,,,,0,0,0,0
1650442728.0354962,public.usertable,1152422,76166,1428348928,16782,public,usertable,1,0,3069644,2759807,1199763,37686,47341,17442,1152422,76166,1284790,1199763,,,,,0,0,0,0
1650442729.063931,public.usertable,1152824,76170,1428848640,16782,public,usertable,1,0,3070798,2759852,1200166,37689,47342,17444,1152824,76170,1285197,1200166,,,,,0,0,0,0
1650442730.0931678,public.usertable,1153255,76172,1429381120,16782,public,usertable,1,0,3071915,2760066,1200600,37691,47345,17445,1153255,76172,1285636,1200600,,,,,0,0,0,0
1650442731.1219795,public.usertable,1153892,76176,1429880832,16782,public,usertable,1,0,3073607,2760201,1201240,37692,47348,17446,1153892,76176,1286280,1201240,,,,,0,0,0,0
1650442732.1528537,public.usertable,1154340,76176,1430413312,16782,public,usertable,1,0,3074782,2760243,1201689,37695,47349,17447,1154340,76176,1286733,1201689,,,,,0,0,0,0
1650442733.1831777,public.usertable,1154754,76181,1430921216,16782,public,usertable,1,0,3075929,2760394,1202106,37699,47352,17451,1154754,76181,1287157,1202106,,,,,0,0,0,0
1650442734.2151027,public.usertable,1155186,76183,1431445504,16782,public,usertable,1,0,3077207,2760473,1202540,37699,47354,17451,1155186,76183,1287593,1202540,,,,,0,0,0,0
1650442735.2441795,public.usertable,1155624,76191,1431986176,16782,public,usertable,1,0,3078341,2760538,1202980,37705,47356,17454,1155624,76191,1288041,1202980,,,,,0,0,0,0
1650442736.2725985,public.usertable,1156048,76194,1432477696,16782,public,usertable,1,0,3079558,2760804,1203405,37710,47357,17457,1156048,76194,1288472,1203405,,,,,0,0,0,0
1650442737.3011794,public.usertable,1156422,76196,1432911872,16782,public,usertable,1,0,3080661,2760938,1203780,37711,47358,17457,1156422,76196,1288849,1203780,,,,,0,0,0,0
1650442738.3298059,public.usertable,1156688,76205,1433255936,16782,public,usertable,1,0,3081360,2761015,1204052,37714,47364,17457,1156688,76205,1289130,1204052,,,,,0,0,0,0
1650442739.3586736,public.usertable,1156984,76212,1433600000,16782,public,usertable,1,0,3082197,2761132,1204353,37716,47369,17458,1156984,76212,1289438,1204353,,,,,0,0,0,0
1650442740.3871615,public.usertable,1157283,76214,1433976832,16782,public,usertable,1,0,3082948,2761159,1204653,37717,47370,17459,1157283,76214,1289740,1204653,,,,,0,0,0,0
1650442741.4166255,public.usertable,1157583,76217,1434353664,16782,public,usertable,1,0,3083766,2761163,1204956,37717,47373,17459,1157583,76217,1290046,1204956,,,,,0,0,0,0
1650442742.4461212,public.usertable,1157883,76222,1434738688,16782,public,usertable,1,0,3084700,2761186,1205260,37718,47377,17459,1157883,76222,1290355,1205260,,,,,0,0,0,0
1650442743.4768612,public.usertable,1158231,76223,1435131904,16782,public,usertable,1,0,3085578,2761226,1205611,37720,47380,17460,1158231,76223,1290711,1205611,,,,,0,0,0,0
1650442744.5065374,public.usertable,1158513,76226,1435467776,16782,public,usertable,1,0,3086289,2761236,1205895,37721,47382,17461,1158513,76226,1290998,1205895,,,,,0,0,0,0
1650442745.5398917,public.usertable,1158799,76234,1435828224,16782,public,usertable,1,0,3087118,2761309,1206185,37725,47386,17464,1158799,76234,1291296,1206185,,,,,0,0,0,0
1650442746.5692031,public.usertable,1159105,76238,1436237824,16782,public,usertable,1,0,3087959,2761325,1206494,37726,47389,17464,1159105,76238,1291609,1206494,,,,,0,0,0,0
1650442747.6005034,public.usertable,1159481,76244,1436704768,16782,public,usertable,1,0,3089085,2761359,1206872,37730,47391,17465,1159481,76244,1291993,1206872,,,,,0,0,0,0
1650442748.6329958,public.usertable,1159882,76246,1437188096,16782,public,usertable,1,0,3090052,2761422,1207275,37730,47393,17465,1159882,76246,1292398,1207275,,,,,0,0,0,0
1650442749.66371,public.usertable,1160297,76253,1437704192,16782,public,usertable,1,0,3091102,2761452,1207692,37735,47395,17466,1160297,76253,1292822,1207692,,,,,0,0,0,0
1650442750.6953087,public.usertable,1160919,76259,1438203904,16782,public,usertable,1,0,3092863,2761758,1208316,37739,47397,17468,1160919,76259,1293452,1208316,,,,,0,0,0,0
1650442751.723535,public.usertable,1161330,76263,1438703616,16782,public,usertable,1,0,3093997,2761825,1208730,37740,47400,17469,1161330,76263,1293870,1208730,,,,,0,0,0,0
1650442752.7534895,public.usertable,1161740,76262,1439203328,16782,public,usertable,1,0,3094994,2762007,1209142,37742,47402,17469,1161740,76262,1294286,1209142,,,,,0,0,0,0
1650442753.7843673,public.usertable,1162141,76268,1439686656,16782,public,usertable,1,0,3096236,2762192,1209547,37744,47406,17470,1162141,76268,1294697,1209547,,,,,0,0,0,0
1650442754.8142974,public.usertable,1162547,76270,1440178176,16782,public,usertable,1,0,3097352,2762254,1209954,37745,47407,17471,1162547,76270,1295106,1209954,,,,,0,0,0,0
1650442755.8445199,public.usertable,1162928,76272,1440628736,16782,public,usertable,1,0,3098475,2762442,1210337,37745,47409,17471,1162928,76272,1295491,1210337,,,,,0,0,0,0
1650442756.8747954,public.usertable,1163306,76278,1441095680,16782,public,usertable,1,0,3099456,2762481,1210719,37747,47413,17473,1163306,76278,1295879,1210719,,,,,0,0,0,0
1650442757.908133,public.usertable,1163679,76277,1441546240,16782,public,usertable,1,0,3100402,2762612,1211095,37748,47416,17473,1163679,76277,1296259,1211095,,,,,0,0,0,0
1650442758.9390368,public.usertable,1164066,76278,1442029568,16782,public,usertable,1,0,3101552,2763423,1211483,37748,47417,17473,1164066,76278,1296648,1211483,,,,,0,0,0,0
1650442759.969899,public.usertable,1164475,76280,1442521088,16782,public,usertable,1,0,3102611,2763443,1211893,37749,47418,17473,1164475,76280,1297060,1211893,,,,,0,0,0,0
1650442761.0066805,public.usertable,1164903,76280,1443012608,16782,public,usertable,1,0,3103788,2763673,1212323,37750,47420,17473,1164903,76280,1297493,1212323,,,,,0,0,0,0
1650442762.0365489,public.usertable,1165306,76286,1443545088,16782,public,usertable,1,0,3104828,2763842,1212729,37753,47423,17474,1165306,76286,1297905,1212729,,,,,0,0,0,0
1650442763.0647132,public.usertable,1165745,76287,1444077568,16782,public,usertable,1,0,3105974,2763925,1213169,37753,47424,17474,1165745,76287,1298346,1213169,,,,,0,0,0,0
1650442764.0929282,public.usertable,1166193,76284,1444634624,16782,public,usertable,1,0,3107122,2764092,1213619,37755,47426,17476,1166193,76284,1298800,1213619,,,,,0,0,0,0
1650442765.1234536,public.usertable,1166650,76286,1445167104,16782,public,usertable,1,0,3108374,2764305,1214077,37756,47427,17476,1166650,76286,1299260,1214077,,,,,0,0,0,0
1650442766.154646,public.usertable,1167107,76287,1445732352,16782,public,usertable,1,0,3109469,2764403,1214534,37757,47427,17477,1167107,76287,1299718,1214534,,,,,0,0,0,0
1650442767.1860344,public.usertable,1167564,76291,1446273024,16782,public,usertable,1,0,3110811,2764551,1214993,37759,47429,17478,1167564,76291,1300181,1214993,,,,,0,0,0,0
1650442768.2175553,public.usertable,1168231,76296,1446813696,16782,public,usertable,1,0,3112671,2764861,1215662,37762,47431,17479,1168231,76296,1300855,1215662,,,,,0,0,0,0
1650442769.2463417,public.usertable,1168675,76302,1447346176,16782,public,usertable,1,0,3113828,2764950,1216111,37763,47436,17480,1168675,76302,1301310,1216111,,,,,0,0,0,0
1650442770.2762601,public.usertable,1169112,76311,1447878656,16782,public,usertable,1,0,3115058,2765177,1216554,37766,47442,17481,1169112,76311,1301762,1216554,,,,,0,0,0,0
1650442771.3067958,public.usertable,1169564,76314,1448435712,16782,public,usertable,1,0,3116235,2765245,1217008,37767,47444,17482,1169564,76314,1302219,1217008,,,,,0,0,0,0
1650442772.342391,public.usertable,1169992,76320,1448951808,16782,public,usertable,1,0,3117340,2765405,1217438,37771,47446,17486,1169992,76320,1302655,1217438,,,,,0,0,0,0
1650442773.371895,public.usertable,1170420,76322,1449484288,16782,public,usertable,1,0,3118576,2765494,1217867,37772,47447,17487,1170420,76322,1303086,1217867,,,,,0,0,0,0
1650442774.4017854,public.usertable,1170874,76321,1450016768,16782,public,usertable,1,0,3119849,2765678,1218322,37774,47448,17487,1170874,76321,1303544,1218322,,,,,0,0,0,0
1650442775.4320092,public.usertable,1171314,76328,1450565632,16782,public,usertable,1,0,3121058,2765878,1218763,37780,47449,17489,1171314,76328,1303992,1218763,,,,,0,0,0,0
1650442776.4617245,public.usertable,1171766,76332,1451114496,16782,public,usertable,1,0,3122266,2766029,1219218,37781,47452,17490,1171766,76332,1304451,1219218,,,,,0,0,0,0
1650442777.4912102,public.usertable,1172229,76333,1451663360,16782,public,usertable,1,0,3123440,2766167,1219681,37782,47452,17491,1172229,76333,1304915,1219681,,,,,0,0,0,0
1650442778.520126,public.usertable,1172678,76334,1452195840,16782,public,usertable,1,0,3124552,2766243,1220131,37782,47453,17491,1172678,76334,1305366,1220131,,,,,0,0,0,0
1650442779.5501044,public.usertable,1173131,76336,1452752896,16782,public,usertable,1,0,3125713,2766321,1220586,37782,47455,17491,1173131,76336,1305823,1220586,,,,,0,0,0,0
1650442780.5818713,public.usertable,1173563,76339,1453277184,16782,public,usertable,1,0,3126808,2766409,1221020,37783,47457,17492,1173563,76339,1306260,1221020,,,,,0,0,0,0
1650442781.6110346,public.usertable,1174004,76345,1453817856,16782,public,usertable,1,0,3128005,2766570,1221464,37786,47460,17494,1174004,76345,1306710,1221464,,,,,0,0,0,0
1650442782.6407986,public.usertable,1174442,76349,1454342144,16782,public,usertable,1,0,3129116,2766651,1221904,37788,47462,17494,1174442,76349,1307154,1221904,,,,,0,0,0,0
1650442783.6714394,public.usertable,1174892,76351,1454882816,16782,public,usertable,1,0,3130267,2766804,1222355,37789,47463,17495,1174892,76351,1307607,1222355,,,,,0,0,0,0
1650442784.700037,public.usertable,1175314,76356,1455398912,16782,public,usertable,1,0,3131370,2766887,1222780,37791,47466,17495,1175314,76356,1308037,1222780,,,,,0,0,0,0
1650442785.7377944,public.usertable,1175957,76357,1455915008,16782,public,usertable,1,0,3133028,2767086,1223425,37793,47468,17496,1175957,76357,1308686,1223425,,,,,0,0,0,0
1650442786.7657409,public.usertable,1176382,76360,1456422912,16782,public,usertable,1,0,3134087,2767133,1223851,37795,47469,17496,1176382,76360,1309115,1223851,,,,,0,0,0,0
1650442787.798172,public.usertable,1176790,76365,1456922624,16782,public,usertable,1,0,3135250,2767234,1224262,37797,47472,17497,1176790,76365,1309531,1224262,,,,,0,0,0,0
1650442788.8266854,public.usertable,1177195,76363,1457405952,16782,public,usertable,1,0,3136292,2767487,1224668,37797,47473,17497,1177195,76363,1309938,1224668,,,,,0,0,0,0
1650442789.8546987,public.usertable,1177608,76366,1457913856,16782,public,usertable,1,0,3137498,2767540,1225082,37799,47474,17498,1177608,76366,1310355,1225082,,,,,0,0,0,0
1650442790.8874974,public.usertable,1178044,76368,1458438144,16782,public,usertable,1,0,3138661,2767635,1225519,37800,47475,17498,1178044,76368,1310794,1225519,,,,,0,0,0,0
1650442791.9186199,public.usertable,1178442,76372,1458921472,16782,public,usertable,1,0,3139712,2767722,1225920,37801,47478,17498,1178442,76372,1311199,1225920,,,,,0,0,0,0
1650442792.9495323,public.usertable,1178862,76375,1459437568,16782,public,usertable,1,0,3140891,2767800,1226342,37802,47480,17498,1178862,76375,1311624,1226342,,,,,0,0,0,0
1650442793.979591,public.usertable,1179290,76379,1459945472,16782,public,usertable,1,0,3141993,2767887,1226772,37804,47482,17498,1179290,76379,1312058,1226772,,,,,0,0,0,0
1650442795.014527,public.usertable,1179737,76383,1460502528,16782,public,usertable,1,0,3143230,2767988,1227222,37805,47485,17499,1179737,76383,1312512,1227222,,,,,0,0,0,0
1650442796.0485833,public.usertable,1180177,76383,1461026816,16782,public,usertable,1,0,3144366,2768181,1227665,37805,47488,17499,1180177,76383,1312958,1227665,,,,,0,0,0,0
1650442797.0789454,public.usertable,1180596,76387,1461542912,16782,public,usertable,1,0,3145419,2768569,1228086,37807,47490,17500,1180596,76387,1313383,1228086,,,,,0,0,0,0
1650442798.1083298,public.usertable,1181038,76390,1462083584,16782,public,usertable,1,0,3146602,2768783,1228531,37809,47493,17501,1181038,76390,1313833,1228531,,,,,0,0,0,0
1650442799.137893,public.usertable,1181473,76392,1462591488,16782,public,usertable,1,0,3147691,2768851,1228967,37810,47494,17501,1181473,76392,1314271,1228967,,,,,0,0,0,0
1650442800.1675599,public.usertable,1181876,76397,1463091200,16782,public,usertable,1,0,3148845,2768904,1229373,37812,47497,17502,1181876,76397,1314682,1229373,,,,,0,0,0,0
1650442801.196318,public.usertable,1182316,76401,1463631872,16782,public,usertable,1,0,3149907,2769037,1229816,37813,47500,17502,1182316,76401,1315129,1229816,,,,,0,0,0,0
1650442802.2309747,public.usertable,1182744,76405,1464147968,16782,public,usertable,1,0,3151076,2769085,1230244,37817,47500,17503,1182744,76405,1315561,1230244,,,,,0,0,0,0
1650442803.2604752,public.usertable,1183178,76409,1464680448,16782,public,usertable,1,0,3152149,2769170,1230679,37820,47501,17505,1183178,76409,1316000,1230679,,,,,0,0,0,0
1650442804.289099,public.usertable,1183777,76415,1465131008,16782,public,usertable,1,0,3153698,2769214,1231280,37824,47503,17506,1183777,76415,1316607,1231280,,,,,0,0,0,0
1650442805.3178496,public.usertable,1184140,76414,1465565184,16782,public,usertable,1,0,3154577,2769340,1231645,37825,47505,17507,1184140,76414,1316975,1231645,,,,,0,0,0,0
1650442806.3486338,public.usertable,1184525,76421,1466040320,16782,public,usertable,1,0,3155585,2769415,1232034,37828,47509,17509,1184525,76421,1317371,1232034,,,,,0,0,0,0
1650442807.377749,public.usertable,1184912,76421,1466507264,16782,public,usertable,1,0,3156630,2769549,1232422,37830,47510,17510,1184912,76421,1317762,1232422,,,,,0,0,0,0
1650442808.40632,public.usertable,1185275,76423,1466933248,16782,public,usertable,1,0,3157621,2769744,1232786,37831,47511,17511,1185275,76423,1318128,1232786,,,,,0,0,0,0
1650442809.4357283,public.usertable,1185640,76424,1467392000,16782,public,usertable,1,0,3158632,2769817,1233151,37832,47511,17511,1185640,76424,1318494,1233151,,,,,0,0,0,0
1650442810.4652574,public.usertable,1186016,76429,1467858944,16782,public,usertable,1,0,3159689,2769878,1233529,37835,47513,17511,1186016,76429,1318877,1233529,,,,,0,0,0,0
1650442811.4949393,public.usertable,1186448,76429,1468375040,16782,public,usertable,1,0,3160807,2769928,1233961,37835,47513,17511,1186448,76429,1319309,1233961,,,,,0,0,0,0
1650442812.5257714,public.usertable,1186889,76430,1468923904,16782,public,usertable,1,0,3161790,2770017,1234403,37835,47514,17511,1186889,76430,1319752,1234403,,,,,0,0,0,0
1650442813.5565305,public.usertable,1187312,76432,1469423616,16782,public,usertable,1,0,3162988,2770077,1234827,37836,47515,17511,1187312,76432,1320178,1234827,,,,,0,0,0,0
1650442814.5890453,public.usertable,1187714,76433,1469923328,16782,public,usertable,1,0,3164101,2770181,1235232,37838,47518,17512,1187714,76433,1320588,1235232,,,,,0,0,0,0
1650442815.6201363,public.usertable,1188130,76438,1470406656,16782,public,usertable,1,0,3165188,2770323,1235650,37841,47520,17513,1188130,76438,1321011,1235650,,,,,0,0,0,0
1650442816.6489954,public.usertable,1188511,76441,1470865408,16782,public,usertable,1,0,3166344,2770437,1236033,37842,47522,17513,1188511,76441,1321397,1236033,,,,,0,0,0,0
1650442817.678207,public.usertable,1188888,76445,1471332352,16782,public,usertable,1,0,3167402,2770460,1236413,37843,47525,17513,1188888,76445,1321781,1236413,,,,,0,0,0,0
1650442818.7078905,public.usertable,1189307,76449,1471864832,16782,public,usertable,1,0,3168430,2770595,1236834,37845,47527,17513,1189307,76449,1322206,1236834,,,,,0,0,0,0
1650442819.7369254,public.usertable,1189746,76453,1472380928,16782,public,usertable,1,0,3169535,2770730,1237274,37848,47528,17513,1189746,76453,1322650,1237274,,,,,0,0,0,0
1650442820.7668624,public.usertable,1190192,76455,1472946176,16782,public,usertable,1,0,3170645,2771044,1237721,37849,47529,17514,1190192,76455,1323099,1237721,,,,,0,0,0,0
1650442821.795808,public.usertable,1190637,76457,1473445888,16782,public,usertable,1,0,3171789,2771081,1238167,37850,47530,17514,1190637,76457,1323547,1238167,,,,,0,0,0,0
1650442822.824511,public.usertable,1191055,76463,1473921024,16782,public,usertable,1,0,3172897,2771130,1238588,37853,47533,17514,1191055,76463,1323974,1238588,,,,,0,0,0,0
1650442823.85437,public.usertable,1191476,76466,1474437120,16782,public,usertable,1,0,3173989,2771218,1239010,37855,47534,17514,1191476,76466,1324399,1239010,,,,,0,0,0,0
1650442824.8865888,public.usertable,1191923,76469,1474969600,16782,public,usertable,1,0,3175236,2771436,1239457,37858,47534,17517,1191923,76469,1324849,1239457,,,,,0,0,0,0
1650442825.9160516,public.usertable,1192615,76472,1475543040,16782,public,usertable,1,0,3177042,2771674,1240152,37858,47537,17517,1192615,76472,1325547,1240152,,,,,0,0,0,0
1650442826.9463563,public.usertable,1193079,76473,1476108288,16782,public,usertable,1,0,3178244,2772057,1240617,37859,47538,17518,1193079,76473,1326014,1240617,,,,,0,0,0,0
1650442827.9780283,public.usertable,1193517,76472,1476632576,16782,public,usertable,1,0,3179530,2772154,1241055,37860,47538,17518,1193517,76472,1326453,1241055,,,,,0,0,0,0
1650442829.0089579,public.usertable,1193951,76475,1477156864,16782,public,usertable,1,0,3180649,2772279,1241490,37862,47539,17519,1193951,76475,1326891,1241490,,,,,0,0,0,0
1650442830.0377162,public.usertable,1194386,76480,1477681152,16782,public,usertable,1,0,3181829,2772333,1241925,37868,47539,17522,1194386,76480,1327332,1241925,,,,,0,0,0,0
1650442831.0673912,public.usertable,1194820,76481,1478213632,16782,public,usertable,1,0,3182992,2772503,1242360,37868,47540,17522,1194820,76481,1327768,1242360,,,,,0,0,0,0
1650442832.1040537,public.usertable,1195261,76486,1478737920,16782,public,usertable,1,0,3184269,2772605,1242802,37872,47541,17523,1195261,76486,1328215,1242802,,,,,0,0,0,0
1650442833.1346323,public.usertable,1195690,76493,1479262208,16782,public,usertable,1,0,3185506,2772668,1243235,37875,47545,17525,1195690,76493,1328655,1243235,,,,,0,0,0,0
1650442834.1709332,public.usertable,1196109,76498,1479770112,16782,public,usertable,1,0,3186682,2772891,1243655,37879,47546,17527,1196109,76498,1329080,1243655,,,,,0,0,0,0
1650442835.201032,public.usertable,1196476,76499,1480171520,16782,public,usertable,1,0,3187619,2772970,1244022,37881,47546,17529,1196476,76499,1329449,1244022,,,,,0,0,0,0
1650442836.2332041,public.usertable,1196769,76500,1480507392,16782,public,usertable,1,0,3188357,2773121,1244316,37881,47547,17529,1196769,76500,1329744,1244316,,,,,0,0,0,0
1650442837.2642183,public.usertable,1197007,76503,1480810496,16782,public,usertable,1,0,3188941,2773138,1244554,37884,47547,17529,1197007,76503,1329985,1244554,,,,,0,0,0,0
1650442838.2956367,public.usertable,1197236,76506,1481072640,16782,public,usertable,1,0,3189573,2773228,1244783,37887,47547,17530,1197236,76506,1330217,1244783,,,,,0,0,0,0
1650442839.32496,public.usertable,1197452,76506,1481293824,16782,public,usertable,1,0,3190161,2773305,1244999,37887,47547,17530,1197452,76506,1330433,1244999,,,,,0,0,0,0
1650442840.3551168,public.usertable,1197662,76506,1481605120,16782,public,usertable,1,0,3190722,2773319,1245209,37887,47547,17530,1197662,76506,1330643,1245209,,,,,0,0,0,0
1650442841.387402,public.usertable,1197933,76507,1481924608,16782,public,usertable,1,0,3191396,2773321,1245481,37887,47548,17530,1197933,76507,1330916,1245481,,,,,0,0,0,0
1650442842.4177425,public.usertable,1198251,76511,1482366976,16782,public,usertable,1,0,3192321,2773378,1245802,37888,47551,17531,1198251,76511,1331241,1245802,,,,,0,0,0,0
1650442843.4460616,public.usertable,1198648,76516,1482825728,16782,public,usertable,1,0,3193418,2773492,1246201,37891,47553,17532,1198648,76516,1331645,1246201,,,,,0,0,0,0
1650442844.475618,public.usertable,1198971,76517,1483210752,16782,public,usertable,1,0,3194341,2773576,1246529,37892,47558,17532,1198971,76517,1331979,1246529,,,,,0,0,0,0
1650442845.5063446,public.usertable,1199525,76522,1483677696,16782,public,usertable,1,0,3195849,2773752,1247085,37895,47560,17533,1199525,76522,1332540,1247085,,,,,0,0,0,0
1650442846.538548,public.usertable,1199905,76525,1484136448,16782,public,usertable,1,0,3196869,2773792,1247466,37897,47561,17533,1199905,76525,1332924,1247466,,,,,0,0,0,0
1650442847.5673835,public.usertable,1200320,76527,1484644352,16782,public,usertable,1,0,3197921,2773841,1247881,37899,47561,17534,1200320,76527,1333341,1247881,,,,,0,0,0,0
1650442848.5952504,public.usertable,1200744,76531,1485160448,16782,public,usertable,1,0,3198931,2774085,1248306,37902,47562,17535,1200744,76531,1333770,1248306,,,,,0,0,0,0
1650442849.6242359,public.usertable,1201163,76537,1485668352,16782,public,usertable,1,0,3199984,2774230,1248729,37904,47566,17536,1201163,76537,1334199,1248729,,,,,0,0,0,0
1650442850.6547666,public.usertable,1201560,76540,1486143488,16782,public,usertable,1,0,3201090,2774305,1249127,37906,47567,17537,1201560,76540,1334600,1249127,,,,,0,0,0,0
1650442851.6840987,public.usertable,1201978,76543,1486643200,16782,public,usertable,1,0,3202209,2774490,1249545,37909,47567,17539,1201978,76543,1335021,1249545,,,,,0,0,0,0
1650442852.7135575,public.usertable,1202390,76550,1487151104,16782,public,usertable,1,0,3203409,2774672,1249960,37913,47570,17540,1202390,76550,1335443,1249960,,,,,0,0,0,0
1650442853.7430198,public.usertable,1202813,76551,1487618048,16782,public,usertable,1,0,3204515,2774750,1250384,37913,47571,17540,1202813,76551,1335868,1250384,,,,,0,0,0,0
1650442854.7734215,public.usertable,1203212,76554,1488109568,16782,public,usertable,1,0,3205634,2774770,1250785,37914,47573,17540,1203212,76554,1336272,1250785,,,,,0,0,0,0
1650442855.8030338,public.usertable,1203633,76562,1488625664,16782,public,usertable,1,0,3206772,2774934,1251214,37916,47581,17541,1203633,76562,1336711,1251214,,,,,0,0,0,0
1650442856.8304288,public.usertable,1204062,76565,1489149952,16782,public,usertable,1,0,3207816,2775062,1251645,37919,47583,17542,1204062,76565,1337147,1251645,,,,,0,0,0,0
1650442857.8598025,public.usertable,1204461,76568,1489616896,16782,public,usertable,1,0,3208966,2775234,1252045,37921,47584,17543,1204461,76568,1337550,1252045,,,,,0,0,0,0
1650442858.888067,public.usertable,1204867,76571,1490116608,16782,public,usertable,1,0,3210087,2775439,1252452,37923,47585,17543,1204867,76571,1337960,1252452,,,,,0,0,0,0
1650442859.9161887,public.usertable,1205261,76576,1490599936,16782,public,usertable,1,0,3211152,2775504,1252848,37926,47587,17544,1205261,76576,1338361,1252848,,,,,0,0,0,0
1650442860.9451766,public.usertable,1205686,76575,1491107840,16782,public,usertable,1,0,3212143,2775595,1253274,37926,47588,17544,1205686,76575,1338788,1253274,,,,,0,0,0,0
1650442861.974756,public.usertable,1206112,76576,1491615744,16782,public,usertable,1,0,3213164,2775666,1253700,37927,47588,17545,1206112,76576,1339215,1253700,,,,,0,0,0,0
1650442863.0038176,public.usertable,1206524,76578,1492115456,16782,public,usertable,1,0,3214218,2775824,1254116,37928,47592,17546,1206524,76578,1339636,1254116,,,,,0,0,0,0
1650442864.0325956,public.usertable,1206930,76582,1492606976,16782,public,usertable,1,0,3215297,2775857,1254524,37930,47594,17547,1206930,76582,1340048,1254524,,,,,0,0,0,0
1650442865.0613081,public.usertable,1207327,76589,1493098496,16782,public,usertable,1,0,3216492,2775981,1254925,37933,47598,17547,1207327,76589,1340456,1254925,,,,,0,0,0,0
1650442866.0905037,public.usertable,1207755,76593,1493639168,16782,public,usertable,1,0,3217581,2776185,1255354,37936,47599,17550,1207755,76593,1340889,1255354,,,,,0,0,0,0
1650442867.12091,public.usertable,1208416,76596,1494163456,16782,public,usertable,1,0,3219322,2776269,1256016,37938,47600,17552,1208416,76596,1341554,1256016,,,,,0,0,0,0
1650442868.1492639,public.usertable,1208823,76601,1494654976,16782,public,usertable,1,0,3220487,2776353,1256427,37939,47604,17552,1208823,76601,1341970,1256427,,,,,0,0,0,0
1650442869.1824965,public.usertable,1209257,76605,1495187456,16782,public,usertable,1,0,3221656,2776536,1256862,37942,47605,17553,1209257,76605,1342409,1256862,,,,,0,0,0,0
1650442870.2115376,public.usertable,1209688,76605,1495703552,16782,public,usertable,1,0,3222993,2776654,1257295,37944,47607,17553,1209688,76605,1342846,1257295,,,,,0,0,0,0
1650442871.2407994,public.usertable,1210137,76610,1496244224,16782,public,usertable,1,0,3224216,2776806,1257746,37947,47609,17555,1210137,76610,1343302,1257746,,,,,0,0,0,0
1650442872.270797,public.usertable,1210543,76615,1496735744,16782,public,usertable,1,0,3225359,2776953,1258155,37949,47612,17557,1210543,76615,1343716,1258155,,,,,0,0,0,0
1650442873.3012152,public.usertable,1210968,76618,1497243648,16782,public,usertable,1,0,3226501,2777071,1258584,37950,47616,17557,1210968,76618,1344150,1258584,,,,,0,0,0,0
1650442874.3318367,public.usertable,1211393,76621,1497776128,16782,public,usertable,1,0,3227686,2777154,1259011,37951,47618,17557,1211393,76621,1344580,1259011,,,,,0,0,0,0
1650442875.3618581,public.usertable,1211822,76623,1498284032,16782,public,usertable,1,0,3228786,2777240,1259442,37951,47620,17557,1211822,76623,1345013,1259442,,,,,0,0,0,0
1650442876.3907359,public.usertable,1212218,76629,1498767360,16782,public,usertable,1,0,3229852,2777530,1259843,37952,47625,17557,1212218,76629,1345420,1259843,,,,,0,0,0,0
1650442877.4202383,public.usertable,1212625,76636,1499250688,16782,public,usertable,1,0,3230970,2777638,1260253,37956,47628,17560,1212625,76636,1345837,1260253,,,,,0,0,0,0
1650442878.4519236,public.usertable,1213028,76636,1499742208,16782,public,usertable,1,0,3232090,2777772,1260656,37956,47628,17560,1213028,76636,1346240,1260656,,,,,0,0,0,0
1650442879.4811993,public.usertable,1213441,76643,1500241920,16782,public,usertable,1,0,3233181,2777819,1261071,37961,47630,17562,1213441,76643,1346662,1261071,,,,,0,0,0,0
1650442880.5103931,public.usertable,1213852,76640,1500766208,16782,public,usertable,1,0,3234316,2778040,1261485,37961,47633,17562,1213852,76640,1347079,1261485,,,,,0,0,0,0
1650442881.5408888,public.usertable,1214288,76647,1501306880,16782,public,usertable,1,0,3235485,2778074,1261925,37964,47637,17563,1214288,76647,1347526,1261925,,,,,0,0,0,0
1650442882.5705736,public.usertable,1214740,76651,1501847552,16782,public,usertable,1,0,3236630,2778126,1262378,37967,47638,17564,1214740,76651,1347983,1262378,,,,,0,0,0,0
1650442883.6024354,public.usertable,1215186,76652,1502380032,16782,public,usertable,1,0,3237763,2778392,1262826,37968,47640,17564,1215186,76652,1348434,1262826,,,,,0,0,0,0
1650442884.6316774,public.usertable,1215574,76657,1502863360,16782,public,usertable,1,0,3238888,2778595,1263215,37972,47641,17565,1215574,76657,1348828,1263215,,,,,0,0,0,0
1650442885.6606805,public.usertable,1216016,76661,1503395840,16782,public,usertable,1,0,3240030,2778718,1263659,37974,47643,17566,1216016,76661,1349276,1263659,,,,,0,0,0,0
1650442886.690328,public.usertable,1216701,76668,1503961088,16782,public,usertable,1,0,3241789,2778975,1264350,37976,47649,17567,1216701,76668,1349975,1264350,,,,,0,0,0,0
1650442887.7192564,public.usertable,1217125,76673,1504477184,16782,public,usertable,1,0,3242954,2779056,1264778,37977,47653,17567,1217125,76673,1350408,1264778,,,,,0,0,0,0
1650442888.749749,public.usertable,1217567,76672,1505009664,16782,public,usertable,1,0,3244211,2779182,1265221,37977,47654,17567,1217567,76672,1350852,1265221,,,,,0,0,0,0
1650442889.7809968,public.usertable,1217998,76677,1505517568,16782,public,usertable,1,0,3245326,2779332,1265657,37977,47659,17567,1217998,76677,1351293,1265657,,,,,0,0,0,0
1650442890.809883,public.usertable,1218414,76677,1506041856,16782,public,usertable,1,0,3246389,2779465,1266074,37979,47660,17567,1218414,76677,1351713,1266074,,,,,0,0,0,0
1650442891.840197,public.usertable,1218857,76679,1506574336,16782,public,usertable,1,0,3247587,2779634,1266517,37981,47660,17569,1218857,76679,1352158,1266517,,,,,0,0,0,0
1650442892.867985,public.usertable,1219295,76679,1507098624,16782,public,usertable,1,0,3248810,2779690,1266955,37981,47660,17569,1219295,76679,1352596,1266955,,,,,0,0,0,0
1650442893.897542,public.usertable,1219749,76681,1507639296,16782,public,usertable,1,0,3249943,2779874,1267411,37983,47662,17571,1219749,76681,1353056,1267411,,,,,0,0,0,0
1650442894.9264755,public.usertable,1220177,76685,1508147200,16782,public,usertable,1,0,3251132,2780005,1267842,37984,47665,17572,1220177,76685,1353491,1267842,,,,,0,0,0,0
1650442895.955438,public.usertable,1220577,76687,1508638720,16782,public,usertable,1,0,3252277,2780051,1268242,37986,47665,17572,1220577,76687,1353893,1268242,,,,,0,0,0,0
1650442896.9860413,public.usertable,1221007,76688,1509154816,16782,public,usertable,1,0,3253383,2780066,1268673,37986,47666,17572,1221007,76688,1354325,1268673,,,,,0,0,0,0
1650442898.0163476,public.usertable,1221411,76691,1509629952,16782,public,usertable,1,0,3254439,2780220,1269079,37987,47668,17572,1221411,76691,1354734,1269079,,,,,0,0,0,0
1650442899.0471795,public.usertable,1221726,76694,1509990400,16782,public,usertable,1,0,3255320,2780241,1269396,37988,47670,17573,1221726,76694,1355054,1269396,,,,,0,0,0,0
1650442900.0770369,public.usertable,1222045,76694,1510350848,16782,public,usertable,1,0,3256218,2780293,1269715,37988,47670,17573,1222045,76694,1355373,1269715,,,,,0,0,0,0
1650442901.1046896,public.usertable,1222355,76699,1510776832,16782,public,usertable,1,0,3257038,2780300,1270028,37990,47673,17574,1222355,76699,1355691,1270028,,,,,0,0,0,0
1650442902.1365702,public.usertable,1222723,76701,1511186432,16782,public,usertable,1,0,3258059,2780351,1270398,37990,47675,17574,1222723,76701,1356063,1270398,,,,,0,0,0,0
1650442903.16574,public.usertable,1223058,76705,1511628800,16782,public,usertable,1,0,3258991,2780500,1270733,37994,47675,17575,1223058,76705,1356402,1270733,,,,,0,0,0,0
1650442904.1941793,public.usertable,1223416,76703,1512038400,16782,public,usertable,1,0,3259957,2780699,1271092,37995,47676,17576,1223416,76703,1356763,1271092,,,,,0,0,0,0
1650442905.2247307,public.usertable,1223953,76706,1512488960,16782,public,usertable,1,0,3261417,2780790,1271631,37996,47678,17576,1223953,76706,1357305,1271631,,,,,0,0,0,0
1650442906.2538495,public.usertable,1224304,76707,1512898560,16782,public,usertable,1,0,3262256,2780894,1271983,37996,47679,17576,1224304,76707,1357658,1271983,,,,,0,0,0,0
1650442907.2857256,public.usertable,1224631,76708,1513308160,16782,public,usertable,1,0,3263205,2781098,1272311,37996,47680,17576,1224631,76708,1357987,1272311,,,,,0,0,0,0
1650442908.3177426,public.usertable,1224998,76711,1513750528,16782,public,usertable,1,0,3264244,2781129,1272680,37997,47682,17576,1224998,76711,1358359,1272680,,,,,0,0,0,0
1650442909.348952,public.usertable,1225338,76711,1514168320,16782,public,usertable,1,0,3265200,2781245,1273020,37997,47682,17576,1225338,76711,1358699,1273020,,,,,0,0,0,0
1650442910.3795469,public.usertable,1225643,76713,1514512384,16782,public,usertable,1,0,3266017,2781251,1273327,37997,47684,17576,1225643,76713,1359008,1273327,,,,,0,0,0,0
1650442911.4097786,public.usertable,1225973,76715,1514938368,16782,public,usertable,1,0,3266875,2781380,1273658,37998,47685,17577,1225973,76715,1359341,1273658,,,,,0,0,0,0
1650442912.4403796,public.usertable,1226345,76717,1515388928,16782,public,usertable,1,0,3267848,2781439,1274030,38000,47685,17578,1226345,76717,1359715,1274030,,,,,0,0,0,0
1650442913.4716246,public.usertable,1226784,76720,1515929600,16782,public,usertable,1,0,3268944,2781507,1274469,38003,47685,17580,1226784,76720,1360157,1274469,,,,,0,0,0,0
1650442914.5017502,public.usertable,1227243,76725,1516453888,16782,public,usertable,1,0,3270062,2781602,1274930,38006,47687,17581,1227243,76725,1360623,1274930,,,,,0,0,0,0
1650442915.5352793,public.usertable,1227636,76730,1516969984,16782,public,usertable,1,0,3271094,2781743,1275327,38007,47691,17581,1227636,76730,1361025,1275327,,,,,0,0,0,0
1650442916.5642774,public.usertable,1228076,76734,1517502464,16782,public,usertable,1,0,3272276,2781791,1275771,38007,47695,17581,1228076,76734,1361473,1275771,,,,,0,0,0,0
1650442917.5932767,public.usertable,1228492,76739,1517993984,16782,public,usertable,1,0,3273404,2781818,1276191,38008,47699,17581,1228492,76739,1361898,1276191,,,,,0,0,0,0
1650442918.6223943,public.usertable,1228922,76741,1518534656,16782,public,usertable,1,0,3274530,2781922,1276622,38009,47700,17581,1228922,76741,1362331,1276622,,,,,0,0,0,0
1650442919.6535723,public.usertable,1229367,76745,1519067136,16782,public,usertable,1,0,3275746,2782154,1277068,38012,47701,17583,1229367,76745,1362781,1277068,,,,,0,0,0,0
1650442920.684882,public.usertable,1229814,76747,1519616000,16782,public,usertable,1,0,3276873,2782246,1277515,38014,47701,17583,1229814,76747,1363230,1277515,,,,,0,0,0,0
1650442921.7138093,public.usertable,1230257,76752,1520140288,16782,public,usertable,1,0,3277970,2782264,1277961,38016,47704,17585,1230257,76752,1363681,1277961,,,,,0,0,0,0
1650442922.7429018,public.usertable,1230689,76756,1520664576,16782,public,usertable,1,0,3279131,2782322,1278396,38018,47707,17587,1230689,76756,1364121,1278396,,,,,0,0,0,0
1650442923.7717874,public.usertable,1231329,76765,1521180672,16782,public,usertable,1,0,3280853,2782577,1279041,38022,47712,17590,1231329,76765,1364775,1279041,,,,,0,0,0,0
1650442924.8014789,public.usertable,1231766,76769,1521704960,16782,public,usertable,1,0,3282032,2782813,1279481,38023,47715,17590,1231766,76769,1365219,1279481,,,,,0,0,0,0
1650442925.8309927,public.usertable,1232222,76773,1522262016,16782,public,usertable,1,0,3283271,2782994,1279941,38023,47719,17590,1232222,76773,1365683,1279941,,,,,0,0,0,0
1650442926.861372,public.usertable,1232657,76778,1522786304,16782,public,usertable,1,0,3284477,2783133,1280381,38026,47724,17592,1232657,76778,1366131,1280381,,,,,0,0,0,0
1650442927.893968,public.usertable,1233069,76785,1523294208,16782,public,usertable,1,0,3285558,2783253,1280799,38027,47730,17592,1233069,76785,1366556,1280799,,,,,0,0,0,0
1650442928.9226716,public.usertable,1233486,76787,1523793920,16782,public,usertable,1,0,3286533,2783275,1281216,38029,47730,17594,1233486,76787,1366975,1281216,,,,,0,0,0,0
1650442929.9512398,public.usertable,1233910,76789,1524318208,16782,public,usertable,1,0,3287651,2783305,1281642,38029,47732,17594,1233910,76789,1367403,1281642,,,,,0,0,0,0
1650442930.9816062,public.usertable,1234351,76791,1524842496,16782,public,usertable,1,0,3288710,2783472,1282083,38031,47732,17595,1234351,76791,1367846,1282083,,,,,0,0,0,0
1650442932.0113065,public.usertable,1234761,76794,1525334016,16782,public,usertable,1,0,3289914,2783576,1282496,38031,47735,17595,1234761,76794,1368262,1282496,,,,,0,0,0,0
1650442933.0414078,public.usertable,1235176,76803,1525850112,16782,public,usertable,1,0,3291102,2783693,1282916,38035,47740,17599,1235176,76803,1368691,1282916,,,,,0,0,0,0
1650442934.0713077,public.usertable,1235638,76807,1526398976,16782,public,usertable,1,0,3292212,2783829,1283379,38038,47741,17600,1235638,76807,1369158,1283379,,,,,0,0,0,0
1650442935.101599,public.usertable,1236071,76810,1526931456,16782,public,usertable,1,0,3293587,2783984,1283814,38039,47743,17600,1236071,76810,1369596,1283814,,,,,0,0,0,0
1650442936.1349714,public.usertable,1236480,76812,1527406592,16782,public,usertable,1,0,3294573,2784047,1284224,38040,47744,17601,1236480,76812,1370008,1284224,,,,,0,0,0,0
1650442937.1635904,public.usertable,1236886,76815,1527881728,16782,public,usertable,1,0,3295683,2784157,1284632,38041,47746,17601,1236886,76815,1370419,1284632,,,,,0,0,0,0
1650442938.1936414,public.usertable,1237290,76818,1528397824,16782,public,usertable,1,0,3296726,2784289,1285036,38044,47746,17602,1237290,76818,1370826,1285036,,,,,0,0,0,0
1650442939.2221792,public.usertable,1237724,76823,1528905728,16782,public,usertable,1,0,3297871,2784409,1285473,38046,47749,17602,1237724,76823,1371268,1285473,,,,,0,0,0,0
1650442940.250175,public.usertable,1238130,76824,1529397248,16782,public,usertable,1,0,3298970,2784533,1285879,38047,47749,17603,1238130,76824,1371675,1285879,,,,,0,0,0,0
1650442941.2789476,public.usertable,1238551,76824,1529937920,16782,public,usertable,1,0,3300045,2784575,1286300,38049,47749,17604,1238551,76824,1372098,1286300,,,,,0,0,0,0
1650442942.3092098,public.usertable,1239202,76828,1530454016,16782,public,usertable,1,0,3301666,2784688,1286952,38052,47750,17606,1239202,76828,1372754,1286952,,,,,0,0,0,0
1650442943.3380487,public.usertable,1239657,76829,1531002880,16782,public,usertable,1,0,3302828,2784699,1287407,38053,47750,17606,1239657,76829,1373210,1287407,,,,,0,0,0,0
1650442944.3671787,public.usertable,1240035,76830,1531461632,16782,public,usertable,1,0,3303899,2784887,1287786,38053,47751,17606,1240035,76830,1373590,1287786,,,,,0,0,0,0
1650442945.397774,public.usertable,1240443,76828,1531944960,16782,public,usertable,1,0,3305067,2785080,1288195,38054,47752,17607,1240443,76828,1374001,1288195,,,,,0,0,0,0
1650442946.4295561,public.usertable,1240817,76832,1532411904,16782,public,usertable,1,0,3306024,2785199,1288572,38055,47755,17607,1240817,76832,1374382,1288572,,,,,0,0,0,0
1650442947.4585483,public.usertable,1241254,76836,1532919808,16782,public,usertable,1,0,3307149,2785491,1289012,38056,47758,17608,1241254,76836,1374826,1289012,,,,,0,0,0,0
1650442948.4879982,public.usertable,1241572,76838,1533313024,16782,public,usertable,1,0,3308144,2785538,1289331,38057,47759,17608,1241572,76838,1375147,1289331,,,,,0,0,0,0
1650442949.5203571,public.usertable,1241865,76839,1533648896,16782,public,usertable,1,0,3308960,2785625,1289625,38057,47760,17608,1241865,76839,1375442,1289625,,,,,0,0,0,0
1650442950.5497546,public.usertable,1242164,76843,1533992960,16782,public,usertable,1,0,3309854,2785652,1289927,38058,47763,17609,1242164,76843,1375748,1289927,,,,,0,0,0,0
1650442951.5794156,public.usertable,1242452,76845,1534386176,16782,public,usertable,1,0,3310643,2785682,1290216,38059,47764,17609,1242452,76845,1376039,1290216,,,,,0,0,0,0
1650442952.6091483,public.usertable,1242891,76847,1534935040,16782,public,usertable,1,0,3311883,2785757,1290656,38060,47765,17609,1242891,76847,1376481,1290656,,,,,0,0,0,0
1650442953.6395428,public.usertable,1243365,76850,1535508480,16782,public,usertable,1,0,3313096,2785973,1291132,38061,47767,17610,1243365,76850,1376960,1291132,,,,,0,0,0,0
1650442954.6695476,public.usertable,1243808,76854,1536016384,16782,public,usertable,1,0,3314301,2786007,1291578,38062,47770,17610,1243808,76854,1377410,1291578,,,,,0,0,0,0
1650442955.6989634,public.usertable,1244230,76856,1536540672,16782,public,usertable,1,0,3315437,2786097,1292002,38063,47772,17611,1244230,76856,1377837,1292002,,,,,0,0,0,0
1650442956.7293184,public.usertable,1244651,76858,1537048576,16782,public,usertable,1,0,3316639,2786135,1292423,38065,47772,17612,1244651,76858,1378260,1292423,,,,,0,0,0,0
1650442957.7581615,public.usertable,1245057,76866,1537523712,16782,public,usertable,1,0,3317785,2786364,1292833,38069,47776,17613,1245057,76866,1378678,1292833,,,,,0,0,0,0
1650442958.7901154,public.usertable,1245425,76870,1537966080,16782,public,usertable,1,0,3318703,2786434,1293203,38071,47778,17614,1245425,76870,1379052,1293203,,,,,0,0,0,0
1650442959.8234036,public.usertable,1245807,76874,1538433024,16782,public,usertable,1,0,3319763,2786535,1293588,38072,47781,17614,1245807,76874,1379441,1293588,,,,,0,0,0,0
1650442960.8530247,public.usertable,1246154,76872,1538859008,16782,public,usertable,1,0,3320655,2786734,1293936,38072,47782,17614,1246154,76872,1379790,1293936,,,,,0,0,0,0
1650442961.8874292,public.usertable,1246716,76872,1539301376,16782,public,usertable,1,0,3321962,2786763,1294498,38072,47782,17614,1246716,76872,1380352,1294498,,,,,0,0,0,0
1650442962.915599,public.usertable,1247075,76874,1539735552,16782,public,usertable,1,0,3322895,2786941,1294857,38074,47782,17614,1247075,76874,1380713,1294857,,,,,0,0,0,0
1650442963.9466457,public.usertable,1247436,76879,1540169728,16782,public,usertable,1,0,3324011,2787055,1295220,38077,47784,17616,1247436,76879,1381081,1295220,,,,,0,0,0,0
1650442964.976119,public.usertable,1247816,76881,1540644864,16782,public,usertable,1,0,3324926,2787302,1295602,38077,47786,17616,1247816,76881,1381465,1295602,,,,,0,0,0,0
1650442966.0116377,public.usertable,1248134,76881,1541013504,16782,public,usertable,1,0,3325791,2787438,1295920,38077,47786,17616,1248134,76881,1381783,1295920,,,,,0,0,0,0
1650442967.0411558,public.usertable,1248532,76883,1541513216,16782,public,usertable,1,0,3326834,2787950,1296318,38079,47786,17617,1248532,76883,1382183,1296318,,,,,0,0,0,0
1650442968.0722919,public.usertable,1248934,76881,1541988352,16782,public,usertable,1,0,3327812,2788214,1296721,38080,47787,17617,1248934,76881,1382588,1296721,,,,,0,0,0,0
1650442969.1014137,public.usertable,1249358,76883,1542512640,16782,public,usertable,1,0,3328931,2788240,1297145,38082,47787,17617,1249358,76883,1383014,1297145,,,,,0,0,0,0
1650442970.1297472,public.usertable,1249787,76888,1543028736,16782,public,usertable,1,0,3330176,2788290,1297578,38083,47791,17618,1249787,76888,1383452,1297578,,,,,0,0,0,0
1650442971.1599443,public.usertable,1250233,76890,1543569408,16782,public,usertable,1,0,3331394,2788340,1298026,38083,47793,17618,1250233,76890,1383902,1298026,,,,,0,0,0,0
1650442972.1896563,public.usertable,1250678,76892,1544101888,16782,public,usertable,1,0,3332512,2788380,1298471,38085,47793,17618,1250678,76892,1384349,1298471,,,,,0,0,0,0
1650442973.2196343,public.usertable,1251114,76892,1544626176,16782,public,usertable,1,0,3333768,2788474,1298909,38087,47795,17619,1251114,76892,1384791,1298909,,,,,0,0,0,0
1650442974.2487643,public.usertable,1251554,76894,1545175040,16782,public,usertable,1,0,3334995,2788535,1299351,38087,47797,17619,1251554,76894,1385235,1299351,,,,,0,0,0,0
1650442975.2799022,public.usertable,1251962,76897,1545650176,16782,public,usertable,1,0,3336118,2788707,1299761,38088,47799,17619,1251962,76897,1385648,1299761,,,,,0,0,0,0
1650442976.3095036,public.usertable,1252373,76900,1546092544,16782,public,usertable,1,0,3337233,2788754,1300173,38090,47800,17620,1252373,76900,1386063,1300173,,,,,0,0,0,0
1650442977.3401754,public.usertable,1252720,76905,1546584064,16782,public,usertable,1,0,3338164,2788976,1300524,38091,47804,17620,1252720,76905,1386419,1300524,,,,,0,0,0,0
1650442978.3701203,public.usertable,1253164,76908,1547108352,16782,public,usertable,1,0,3339278,2789158,1300970,38092,47806,17621,1253164,76908,1386868,1300970,,,,,0,0,0,0
1650442979.4006207,public.usertable,1253578,76909,1547608064,16782,public,usertable,1,0,3340349,2789323,1301384,38093,47806,17621,1253578,76909,1387283,1301384,,,,,0,0,0,0
1650442980.4339206,public.usertable,1254219,76914,1548132352,16782,public,usertable,1,0,3341963,2789488,1302029,38094,47810,17622,1254219,76914,1387933,1302029,,,,,0,0,0,0
1650442981.4650238,public.usertable,1254596,76916,1548591104,16782,public,usertable,1,0,3343095,2789520,1302408,38094,47812,17622,1254596,76916,1388314,1302408,,,,,0,0,0,0
1650442982.496069,public.usertable,1255008,76918,1549090816,16782,public,usertable,1,0,3344175,2789588,1302820,38096,47812,17622,1255008,76918,1388728,1302820,,,,,0,0,0,0
1650442983.528087,public.usertable,1255416,76923,1549590528,16782,public,usertable,1,0,3345272,2789658,1303229,38100,47813,17624,1255416,76923,1389142,1303229,,,,,0,0,0,0
1650442984.5570521,public.usertable,1255819,76928,1550082048,16782,public,usertable,1,0,3346288,2789856,1303636,38101,47817,17625,1255819,76928,1389554,1303636,,,,,0,0,0,0
1650442985.5870216,public.usertable,1256216,76928,1550540800,16782,public,usertable,1,0,3347224,2789906,1304033,38101,47817,17625,1256216,76928,1389951,1304033,,,,,0,0,0,0
1650442986.616265,public.usertable,1256618,76930,1551024128,16782,public,usertable,1,0,3348282,2789973,1304437,38101,47819,17625,1256618,76930,1390357,1304437,,,,,0,0,0,0
1650442987.6447518,public.usertable,1257022,76929,1551515648,16782,public,usertable,1,0,3349378,2790049,1304841,38103,47819,17625,1257022,76929,1390763,1304841,,,,,0,0,0,0
1650442988.6761725,public.usertable,1257401,76932,1551990784,16782,public,usertable,1,0,3350403,2790074,1305221,38105,47820,17627,1257401,76932,1391146,1305221,,,,,0,0,0,0
1650442989.704759,public.usertable,1257836,76935,1552498688,16782,public,usertable,1,0,3351624,2790309,1305657,38107,47821,17627,1257836,76935,1391585,1305657,,,,,0,0,0,0
1650442990.7369368,public.usertable,1258250,76937,1553006592,16782,public,usertable,1,0,3352720,2790483,1306071,38109,47821,17628,1258250,76937,1392001,1306071,,,,,0,0,0,0
1650442991.7659338,public.usertable,1258668,76941,1553539072,16782,public,usertable,1,0,3353904,2790525,1306489,38113,47821,17630,1258668,76941,1392423,1306489,,,,,0,0,0,0
1650442992.7937481,public.usertable,1259130,76941,1554079744,16782,public,usertable,1,0,3355105,2790650,1306952,38114,47822,17630,1259130,76941,1392888,1306952,,,,,0,0,0,0
1650442993.823164,public.usertable,1259547,76943,1554554880,16782,public,usertable,1,0,3356260,2790758,1307371,38114,47824,17630,1259547,76943,1393309,1307371,,,,,0,0,0,0
1650442994.8522453,public.usertable,1259941,76943,1555054592,16782,public,usertable,1,0,3357388,2790960,1307766,38117,47825,17631,1259941,76943,1393708,1307766,,,,,0,0,0,0
1650442995.881081,public.usertable,1260343,76946,1555529728,16782,public,usertable,1,0,3358514,2791011,1308170,38118,47827,17631,1260343,76946,1394115,1308170,,,,,0,0,0,0
1650442996.912201,public.usertable,1260749,76947,1556021248,16782,public,usertable,1,0,3359516,2791179,1308577,38118,47828,17631,1260749,76947,1394523,1308577,,,,,0,0,0,0
1650442997.9419096,public.usertable,1261149,76950,1556488192,16782,public,usertable,1,0,3360596,2791233,1308978,38120,47829,17632,1261149,76950,1394927,1308978,,,,,0,0,0,0
1650442998.971837,public.usertable,1261641,76946,1556856832,16782,public,usertable,1,0,3361889,2791372,1309470,38121,47829,17633,1261641,76946,1395420,1309470,,,,,0,0,0,0
1650443000.003392,public.usertable,1261948,76948,1557225472,16782,public,usertable,1,0,3362761,2791469,1309778,38122,47830,17634,1261948,76948,1395730,1309778,,,,,0,0,0,0
1650443001.0332513,public.usertable,1262370,76952,1557741568,16782,public,usertable,1,0,3363918,2791794,1310202,38124,47832,17635,1262370,76952,1396158,1310202,,,,,0,0,0,0
1650443002.0641384,public.usertable,1262804,76954,1558274048,16782,public,usertable,1,0,3365023,2791903,1310639,38125,47835,17636,1262804,76954,1396599,1310639,,,,,0,0,0,0
1650443003.093244,public.usertable,1263255,76956,1558814720,16782,public,usertable,1,0,3366068,2792043,1311090,38127,47835,17637,1263255,76956,1397052,1311090,,,,,0,0,0,0
1650443004.1225383,public.usertable,1263707,76959,1559347200,16782,public,usertable,1,0,3367250,2792055,1311543,38129,47836,17637,1263707,76959,1397508,1311543,,,,,0,0,0,0
1650443005.152544,public.usertable,1264133,76961,1559863296,16782,public,usertable,1,0,3368449,2792072,1311971,38129,47838,17637,1264133,76961,1397938,1311971,,,,,0,0,0,0
1650443006.1809444,public.usertable,1264573,76965,1560420352,16782,public,usertable,1,0,3369653,2792162,1312415,38129,47842,17637,1264573,76965,1398386,1312415,,,,,0,0,0,0
1650443007.2113287,public.usertable,1264993,76964,1560903680,16782,public,usertable,1,0,3370727,2792371,1312837,38130,47844,17637,1264993,76964,1398811,1312837,,,,,0,0,0,0
1650443008.2430546,public.usertable,1265416,76968,1561411584,16782,public,usertable,1,0,3371873,2792403,1313260,38134,47844,17639,1265416,76968,1399238,1313260,,,,,0,0,0,0
1650443009.2714858,public.usertable,1265846,76970,1561927680,16782,public,usertable,1,0,3372971,2792468,1313692,38134,47846,17639,1265846,76970,1399672,1313692,,,,,0,0,0,0
1650443010.3003595,public.usertable,1266239,76974,1562402816,16782,public,usertable,1,0,3374060,2792517,1314089,38134,47850,17639,1266239,76974,1400073,1314089,,,,,0,0,0,0
1650443011.3318477,public.usertable,1266572,76975,1562812416,16782,public,usertable,1,0,3374934,2792581,1314423,38134,47851,17639,1266572,76975,1400408,1314423,,,,,0,0,0,0
1650443012.3606915,public.usertable,1266951,76980,1563262976,16782,public,usertable,1,0,3375980,2792839,1314804,38137,47853,17639,1266951,76980,1400794,1314804,,,,,0,0,0,0
1650443013.3922443,public.usertable,1267331,76985,1563738112,16782,public,usertable,1,0,3376939,2793042,1315186,38140,47855,17641,1267331,76985,1401181,1315186,,,,,0,0,0,0
1650443014.422893,public.usertable,1267743,76982,1564205056,16782,public,usertable,1,0,3377994,2793272,1315598,38142,47855,17642,1267743,76982,1401595,1315598,,,,,0,0,0,0
1650443015.4548867,public.usertable,1268076,76982,1564639232,16782,public,usertable,1,0,3378923,2793443,1315931,38142,47855,17642,1268076,76982,1401928,1315931,,,,,0,0,0,0
1650443016.4883974,public.usertable,1268455,76986,1565089792,16782,public,usertable,1,0,3379947,2793691,1316311,38145,47856,17643,1268455,76986,1402312,1316311,,,,,0,0,0,0
1650443017.516482,public.usertable,1269008,76990,1565523968,16782,public,usertable,1,0,3381444,2793882,1316865,38148,47857,17644,1269008,76990,1402870,1316865,,,,,0,0,0,0
1650443018.547144,public.usertable,1269363,76991,1565949952,16782,public,usertable,1,0,3382336,2793897,1317221,38148,47858,17644,1269363,76991,1403227,1317221,,,,,0,0,0,0
1650443019.5767639,public.usertable,1269721,76994,1566375936,16782,public,usertable,1,0,3383440,2793920,1317580,38150,47859,17646,1269721,76994,1403589,1317580,,,,,0,0,0,0
1650443020.6069841,public.usertable,1270056,76998,1566793728,16782,public,usertable,1,0,3384287,2794042,1317917,38152,47861,17647,1270056,76998,1403930,1317917,,,,,0,0,0,0
1650443021.63579,public.usertable,1270368,77001,1567162368,16782,public,usertable,1,0,3385060,2794079,1318230,38154,47862,17649,1270368,77001,1404246,1318230,,,,,0,0,0,0
1650443022.671031,public.usertable,1270657,77003,1567514624,16782,public,usertable,1,0,3385788,2794100,1318521,38154,47864,17649,1270657,77003,1404539,1318521,,,,,0,0,0,0
1650443023.7034152,public.usertable,1270936,77006,1567866880,16782,public,usertable,1,0,3386485,2794149,1318802,38155,47866,17649,1270936,77006,1404823,1318802,,,,,0,0,0,0
1650443024.7325437,public.usertable,1271212,77008,1568161792,16782,public,usertable,1,0,3387224,2794159,1319080,38155,47868,17649,1271212,77008,1405103,1319080,,,,,0,0,0,0
1650443025.7613933,public.usertable,1271511,77011,1568571392,16782,public,usertable,1,0,3388064,2794206,1319379,38158,47868,17650,1271511,77011,1405405,1319379,,,,,0,0,0,0
1650443026.7897656,public.usertable,1271910,77015,1569038336,16782,public,usertable,1,0,3389189,2794240,1319779,38161,47869,17653,1271910,77015,1405809,1319779,,,,,0,0,0,0
1650443027.8223383,public.usertable,1272266,77018,1569480704,16782,public,usertable,1,0,3390190,2794506,1320136,38163,47870,17653,1272266,77018,1406169,1320136,,,,,0,0,0,0
1650443028.8529713,public.usertable,1272659,77023,1569955840,16782,public,usertable,1,0,3391292,2794672,1320531,38167,47872,17655,1272659,77023,1406570,1320531,,,,,0,0,0,0
1650443029.8827195,public.usertable,1273040,77024,1570365440,16782,public,usertable,1,0,3392197,2794698,1320912,38168,47872,17655,1273040,77024,1406952,1320912,,,,,0,0,0,0
1650443030.9123087,public.usertable,1273317,77027,1570725888,16782,public,usertable,1,0,3392826,2794848,1321192,38168,47875,17655,1273317,77027,1407235,1321192,,,,,0,0,0,0
1650443031.9425728,public.usertable,1273624,77032,1571143680,16782,public,usertable,1,0,3393704,2794877,1321501,38171,47877,17655,1273624,77032,1407549,1321501,,,,,0,0,0,0
1650443032.9748504,public.usertable,1274052,77035,1571659776,16782,public,usertable,1,0,3394889,2795017,1321930,38173,47878,17655,1274052,77035,1407981,1321930,,,,,0,0,0,0
1650443034.0035257,public.usertable,1274402,77035,1572044800,16782,public,usertable,1,0,3395881,2795022,1322280,38173,47878,17655,1274402,77035,1408331,1322280,,,,,0,0,0,0
1650443035.0330346,public.usertable,1274803,77040,1572585472,16782,public,usertable,1,0,3397001,2795040,1322683,38176,47880,17657,1274803,77040,1408739,1322683,,,,,0,0,0,0
1650443036.0622902,public.usertable,1275244,77043,1573109760,16782,public,usertable,1,0,3398184,2795050,1323125,38178,47881,17658,1275244,77043,1409184,1323125,,,,,0,0,0,0
1650443037.093194,public.usertable,1275662,77044,1573625856,16782,public,usertable,1,0,3399286,2795174,1323545,38180,47883,17658,1275662,77044,1409608,1323545,,,,,0,0,0,0
1650443038.1297975,public.usertable,1276286,77045,1574117376,16782,public,usertable,1,0,3400772,2795254,1324172,38181,47886,17658,1276286,77045,1410239,1324172,,,,,0,0,0,0
1650443039.1613271,public.usertable,1276722,77049,1574641664,16782,public,usertable,1,0,3401934,2795345,1324610,38184,47888,17660,1276722,77049,1410682,1324610,,,,,0,0,0,0
1650443040.1910098,public.usertable,1277153,77050,1575174144,16782,public,usertable,1,0,3403147,2795349,1325042,38184,47889,17660,1277153,77050,1411115,1325042,,,,,0,0,0,0
1650443041.2237396,public.usertable,1277615,77054,1575723008,16782,public,usertable,1,0,3404377,2795430,1325504,38188,47889,17663,1277615,77054,1411581,1325504,,,,,0,0,0,0
1650443042.2519934,public.usertable,1278035,77055,1576222720,16782,public,usertable,1,0,3405451,2795464,1325925,38188,47890,17663,1278035,77055,1412003,1325925,,,,,0,0,0,0
1650443043.282023,public.usertable,1278441,77056,1576714240,16782,public,usertable,1,0,3406532,2795608,1326331,38189,47890,17664,1278441,77056,1412410,1326331,,,,,0,0,0,0
1650443044.3117943,public.usertable,1278842,77060,1577205760,16782,public,usertable,1,0,3407653,2795682,1326735,38190,47893,17665,1278842,77060,1412818,1326735,,,,,0,0,0,0
1650443045.3429399,public.usertable,1279233,77065,1577672704,16782,public,usertable,1,0,3408638,2795731,1327129,38192,47896,17666,1279233,77065,1413217,1327129,,,,,0,0,0,0
1650443046.3720164,public.usertable,1279648,77068,1578172416,16782,public,usertable,1,0,3409801,2795864,1327547,38192,47899,17666,1279648,77068,1413638,1327547,,,,,0,0,0,0
1650443047.4005218,public.usertable,1280006,77070,1578508288,16782,public,usertable,1,0,3410661,2795932,1327906,38193,47900,17666,1280006,77070,1413999,1327906,,,,,0,0,0,0
1650443048.4335058,public.usertable,1280297,77071,1578860544,16782,public,usertable,1,0,3411518,2795953,1328197,38194,47900,17667,1280297,77071,1414291,1328197,,,,,0,0,0,0
1650443049.463385,public.usertable,1280537,77072,1579106304,16782,public,usertable,1,0,3412115,2795984,1328437,38195,47900,17667,1280537,77072,1414532,1328437,,,,,0,0,0,0
1650443050.4922502,public.usertable,1280845,77080,1579499520,16782,public,usertable,1,0,3412909,2796036,1328750,38198,47905,17667,1280845,77080,1414853,1328750,,,,,0,0,0,0
1650443051.5220833,public.usertable,1281243,77079,1579982848,16782,public,usertable,1,0,3413887,2796124,1329150,38199,47907,17667,1281243,77079,1415256,1329150,,,,,0,0,0,0
1650443052.552718,public.usertable,1281566,77079,1580359680,16782,public,usertable,1,0,3414803,2796186,1329473,38199,47907,17667,1281566,77079,1415579,1329473,,,,,0,0,0,0
1650443053.58345,public.usertable,1281872,77081,1580736512,16782,public,usertable,1,0,3415580,2796269,1329781,38199,47909,17667,1281872,77081,1415889,1329781,,,,,0,0,0,0
1650443054.6117096,public.usertable,1282225,77082,1581170688,16782,public,usertable,1,0,3416523,2796390,1330135,38199,47910,17667,1282225,77082,1416244,1330135,,,,,0,0,0,0
1650443055.6408594,public.usertable,1282655,77086,1581711360,16782,public,usertable,1,0,3417666,2796422,1330568,38200,47913,17667,1282655,77086,1416681,1330568,,,,,0,0,0,0
1650443056.6706347,public.usertable,1283061,77088,1582186496,16782,public,usertable,1,0,3418748,2796439,1330975,38201,47914,17667,1283061,77088,1417090,1330975,,,,,0,0,0,0
1650443057.6989038,public.usertable,1283459,77093,1582669824,16782,public,usertable,1,0,3419934,2796526,1331375,38204,47916,17668,1283459,77093,1417495,1331375,,,,,0,0,0,0
1650443058.7310488,public.usertable,1283852,77096,1583136768,16782,public,usertable,1,0,3420989,2796651,1331769,38206,47917,17668,1283852,77096,1417892,1331769,,,,,0,0,0,0
1650443059.7601936,public.usertable,1284241,77096,1583603712,16782,public,usertable,1,0,3422090,2796807,1332161,38207,47920,17669,1284241,77096,1418288,1332161,,,,,0,0,0,0
1650443060.790024,public.usertable,1284654,77101,1584095232,16782,public,usertable,1,0,3423200,2796846,1332578,38208,47924,17669,1284654,77101,1418710,1332578,,,,,0,0,0,0
1650443061.8197367,public.usertable,1285053,77103,1584586752,16782,public,usertable,1,0,3424335,2796851,1332979,38208,47926,17669,1285053,77103,1419113,1332979,,,,,0,0,0,0
1650443062.8477263,public.usertable,1285478,77106,1585102848,16782,public,usertable,1,0,3425388,2796908,1333406,38209,47928,17669,1285478,77106,1419543,1333406,,,,,0,0,0,0
1650443063.8778794,public.usertable,1285883,77111,1585586176,16782,public,usertable,1,0,3426366,2797001,1333815,38210,47932,17670,1285883,77111,1419957,1333815,,,,,0,0,0,0
1650443064.906807,public.usertable,1286260,77113,1586044928,16782,public,usertable,1,0,3427350,2797066,1334192,38212,47932,17672,1286260,77113,1420336,1334192,,,,,0,0,0,0
1650443065.9370506,public.usertable,1286653,77112,1586544640,16782,public,usertable,1,0,3428432,2797324,1334586,38213,47933,17672,1286653,77112,1420732,1334586,,,,,0,0,0,0
1650443066.967727,public.usertable,1287094,77112,1587085312,16782,public,usertable,1,0,3429627,2797407,1335027,38213,47933,17672,1287094,77112,1421173,1335027,,,,,0,0,0,0
1650443067.9974139,public.usertable,1287732,77115,1587585024,16782,public,usertable,1,0,3431358,2797543,1335667,38214,47935,17673,1287732,77115,1421816,1335667,,,,,0,0,0,0
1650443069.027497,public.usertable,1288115,77116,1588043776,16782,public,usertable,1,0,3432284,2797676,1336051,38214,47936,17673,1288115,77116,1422201,1336051,,,,,0,0,0,0
1650443070.0560381,public.usertable,1288539,77121,1588559872,16782,public,usertable,1,0,3433319,2797769,1336478,38216,47939,17673,1288539,77121,1422633,1336478,,,,,0,0,0,0
1650443071.0948167,public.usertable,1288961,77123,1589067776,16782,public,usertable,1,0,3434530,2797971,1336901,38217,47940,17673,1288961,77123,1423058,1336901,,,,,0,0,0,0
1650443072.1228828,public.usertable,1289324,77124,1589493760,16782,public,usertable,1,0,3435590,2798128,1337265,38217,47941,17673,1289324,77124,1423423,1337265,,,,,0,0,0,0
1650443073.1511397,public.usertable,1289673,77128,1589870592,16782,public,usertable,1,0,3436495,2798187,1337614,38221,47941,17673,1289673,77128,1423776,1337614,,,,,0,0,0,0
1650443074.179918,public.usertable,1290098,77131,1590394880,16782,public,usertable,1,0,3437731,2798406,1338042,38222,47944,17673,1290098,77131,1424208,1338042,,,,,0,0,0,0
1650443075.2105017,public.usertable,1290529,77130,1590910976,16782,public,usertable,1,0,3439016,2798535,1338473,38222,47944,17673,1290529,77130,1424639,1338473,,,,,0,0,0,0
1650443076.2448082,public.usertable,1290937,77132,1591394304,16782,public,usertable,1,0,3440080,2798612,1338882,38223,47945,17674,1290937,77132,1425050,1338882,,,,,0,0,0,0
1650443077.27535,public.usertable,1291346,77135,1591894016,16782,public,usertable,1,0,3441173,2798719,1339292,38225,47946,17675,1291346,77135,1425463,1339292,,,,,0,0,0,0
1650443078.3057463,public.usertable,1291745,77130,1592377344,16782,public,usertable,1,0,3442258,2798803,1339691,38225,47946,17675,1291745,77130,1425862,1339691,,,,,0,0,0,0
1650443079.3360348,public.usertable,1292174,77131,1592901632,16782,public,usertable,1,0,3443434,2798919,1340123,38225,47949,17675,1292174,77131,1426297,1340123,,,,,0,0,0,0
1650443080.3684478,public.usertable,1292576,77135,1593393152,16782,public,usertable,1,0,3444593,2799019,1340528,38226,47952,17676,1292576,77135,1426706,1340528,,,,,0,0,0,0
1650443081.3971949,public.usertable,1293004,77137,1593901056,16782,public,usertable,1,0,3445841,2799124,1340958,38226,47954,17676,1293004,77137,1427138,1340958,,,,,0,0,0,0
1650443082.4253461,public.usertable,1293444,77138,1594433536,16782,public,usertable,1,0,3446818,2799199,1341398,38227,47954,17677,1293444,77138,1427579,1341398,,,,,0,0,0,0
1650443083.4585264,public.usertable,1293880,77143,1594966016,16782,public,usertable,1,0,3447897,2799238,1341835,38231,47955,17678,1293880,77143,1428021,1341835,,,,,0,0,0,0
1650443084.4886675,public.usertable,1294308,77136,1595465728,16782,public,usertable,1,0,3449002,2799385,1342263,38231,47955,17678,1294308,77136,1428449,1342263,,,,,0,0,0,0
1650443085.5183609,public.usertable,1294712,77138,1595965440,16782,public,usertable,1,0,3450118,2799532,1342669,38231,47957,17678,1294712,77138,1428857,1342669,,,,,0,0,0,0
1650443086.5490131,public.usertable,1295141,77142,1596497920,16782,public,usertable,1,0,3451318,2799713,1343100,38233,47959,17678,1295141,77142,1429292,1343100,,,,,0,0,0,0
1650443087.578881,public.usertable,1295549,77148,1596973056,16782,public,usertable,1,0,3452448,2799812,1343512,38235,47963,17678,1295549,77148,1429710,1343512,,,,,0,0,0,0
1650443088.6095204,public.usertable,1295968,77150,1597472768,16782,public,usertable,1,0,3453504,2799881,1343933,38235,47965,17678,1295968,77150,1430133,1343933,,,,,0,0,0,0
1650443089.6381028,public.usertable,1296354,77147,1597972480,16782,public,usertable,1,0,3454501,2799981,1344321,38235,47967,17678,1296354,77147,1430523,1344321,,,,,0,0,0,0
1650443090.6678023,public.usertable,1296964,77151,1598447616,16782,public,usertable,1,0,3456224,2800136,1344933,38237,47969,17680,1296964,77151,1431139,1344933,,,,,0,0,0,0
1650443091.6990542,public.usertable,1297370,77154,1598930944,16782,public,usertable,1,0,3457300,2800250,1345341,38238,47971,17681,1297370,77154,1431550,1345341,,,,,0,0,0,0
1650443092.7291021,public.usertable,1297801,77157,1599455232,16782,public,usertable,1,0,3458540,2800393,1345774,38239,47973,17682,1297801,77157,1431986,1345774,,,,,0,0,0,0
1650443093.7578068,public.usertable,1298233,77158,1599979520,16782,public,usertable,1,0,3459669,2800636,1346206,38240,47973,17682,1298233,77158,1432419,1346206,,,,,0,0,0,0
1650443094.7867568,public.usertable,1298660,77164,1600503808,16782,public,usertable,1,0,3460861,2800837,1346635,38244,47975,17682,1298660,77164,1432854,1346635,,,,,0,0,0,0
1650443095.8177423,public.usertable,1299094,77167,1601036288,16782,public,usertable,1,0,3462093,2801064,1347071,38245,47977,17682,1299094,77167,1433293,1347071,,,,,0,0,0,0
1650443096.846675,public.usertable,1299507,77169,1601527808,16782,public,usertable,1,0,3463223,2801135,1347486,38245,47979,17682,1299507,77169,1433710,1347486,,,,,0,0,0,0
1650443097.879431,public.usertable,1299912,77171,1602019328,16782,public,usertable,1,0,3464371,2801208,1347893,38245,47981,17682,1299912,77171,1434119,1347893,,,,,0,0,0,0
1650443098.9102862,public.usertable,1300330,77173,1602469888,16782,public,usertable,1,0,3465519,2801239,1348313,38245,47983,17682,1300330,77173,1434541,1348313,,,,,0,0,0,0
1650443099.9400468,public.usertable,1300704,77174,1602961408,16782,public,usertable,1,0,3466431,2801283,1348687,38246,47983,17682,1300704,77174,1434916,1348687,,,,,0,0,0,0
1650443100.9704003,public.usertable,1301061,77175,1603387392,16782,public,usertable,1,0,3467435,2801505,1349045,38246,47984,17682,1301061,77175,1435275,1349045,,,,,0,0,0,0
1650443102.001167,public.usertable,1301400,77177,1603805184,16782,public,usertable,1,0,3468363,2801556,1349385,38247,47985,17683,1301400,77177,1435617,1349385,,,,,0,0,0,0
1650443103.0301414,public.usertable,1301756,77180,1604206592,16782,public,usertable,1,0,3469311,2801603,1349742,38249,47986,17684,1301756,77180,1435977,1349742,,,,,0,0,0,0
1650443104.0597353,public.usertable,1302087,77181,1604632576,16782,public,usertable,1,0,3470237,2801797,1350073,38250,47986,17684,1302087,77181,1436309,1350073,,,,,0,0,0,0
1650443105.0880485,public.usertable,1302494,77182,1605091328,16782,public,usertable,1,0,3471335,2801821,1350480,38251,47986,17684,1302494,77182,1436717,1350480,,,,,0,0,0,0
1650443106.116486,public.usertable,1302804,77185,1605500928,16782,public,usertable,1,0,3472186,2801860,1350793,38251,47989,17684,1302804,77185,1437033,1350793,,,,,0,0,0,0
1650443107.1459303,public.usertable,1303159,77185,1605935104,16782,public,usertable,1,0,3473193,2802028,1351148,38251,47989,17684,1303159,77185,1437388,1351148,,,,,0,0,0,0
1650443108.1763215,public.usertable,1303505,77192,1606320128,16782,public,usertable,1,0,3474159,2802091,1351500,38252,47995,17684,1303505,77192,1437747,1351500,,,,,0,0,0,0
1650443109.2052922,public.usertable,1304015,77195,1606746112,16782,public,usertable,1,0,3475613,2802203,1352013,38252,47998,17684,1304015,77195,1438263,1352013,,,,,0,0,0,0
1650443110.2366834,public.usertable,1304453,77199,1607278592,16782,public,usertable,1,0,3476692,2802251,1352453,38254,48000,17684,1304453,77199,1438707,1352453,,,,,0,0,0,0
1650443111.2657309,public.usertable,1304870,77204,1607786496,16782,public,usertable,1,0,3477759,2802315,1352871,38258,48001,17687,1304870,77204,1439130,1352871,,,,,0,0,0,0
1650443112.2946856,public.usertable,1305268,77204,1608261632,16782,public,usertable,1,0,3478985,2802373,1353269,38258,48001,17687,1305268,77204,1439528,1353269,,,,,0,0,0,0
1650443113.3252902,public.usertable,1305680,77209,1608753152,16782,public,usertable,1,0,3480072,2802390,1353684,38260,48004,17689,1305680,77209,1439948,1353684,,,,,0,0,0,0
1650443114.3539016,public.usertable,1306082,77211,1609252864,16782,public,usertable,1,0,3481245,2802526,1354088,38260,48006,17689,1306082,77211,1440354,1354088,,,,,0,0,0,0
1650443115.385694,public.usertable,1306496,77211,1609752576,16782,public,usertable,1,0,3482393,2802561,1354502,38260,48006,17689,1306496,77211,1440768,1354502,,,,,0,0,0,0
1650443116.41783,public.usertable,1306903,77210,1610235904,16782,public,usertable,1,0,3483582,2802686,1354911,38260,48008,17689,1306903,77210,1441179,1354911,,,,,0,0,0,0
1650443117.4468324,public.usertable,1307272,77212,1610686464,16782,public,usertable,1,0,3484668,2802703,1355281,38261,48009,17689,1307272,77212,1441551,1355281,,,,,0,0,0,0
1650443118.4759421,public.usertable,1307687,77213,1611194368,16782,public,usertable,1,0,3485655,2802716,1355696,38262,48009,17690,1307687,77213,1441967,1355696,,,,,0,0,0,0
1650443119.505152,public.usertable,1308106,77216,1611694080,16782,public,usertable,1,0,3486821,2802844,1356118,38262,48012,17690,1308106,77216,1442392,1356118,,,,,0,0,0,0
1650443120.5356853,public.usertable,1308540,77219,1612234752,16782,public,usertable,1,0,3488078,2802887,1356554,38263,48014,17690,1308540,77219,1442831,1356554,,,,,0,0,0,0
1650443121.564401,public.usertable,1308969,77224,1612726272,16782,public,usertable,1,0,3489278,2803011,1356983,38268,48014,17691,1308969,77224,1443265,1356983,,,,,0,0,0,0
1650443122.5932767,public.usertable,1309388,77233,1613266944,16782,public,usertable,1,0,3490383,2803157,1357407,38272,48019,17693,1309388,77233,1443698,1357407,,,,,0,0,0,0
1650443123.6220117,public.usertable,1309839,77234,1613807616,16782,public,usertable,1,0,3491530,2803237,1357860,38273,48021,17694,1309839,77234,1444154,1357860,,,,,0,0,0,0
1650443124.6516497,public.usertable,1310284,77238,1614331904,16782,public,usertable,1,0,3492682,2803322,1358307,38275,48023,17695,1310284,77238,1444605,1358307,,,,,0,0,0,0
1650443125.681736,public.usertable,1310732,77240,1614905344,16782,public,usertable,1,0,3493830,2803400,1358755,38277,48023,17695,1310732,77240,1445055,1358755,,,,,0,0,0,0
1650443126.7117207,public.usertable,1311197,77243,1615470592,16782,public,usertable,1,0,3495074,2803618,1359223,38277,48026,17695,1311197,77243,1445526,1359223,,,,,0,0,0,0
1650443127.7423759,public.usertable,1311864,77251,1615994880,16782,public,usertable,1,0,3496879,2803804,1359896,38279,48032,17696,1311864,77251,1446207,1359896,,,,,0,0,0,0
1650443128.7723565,public.usertable,1312310,77254,1616535552,16782,public,usertable,1,0,3498083,2803938,1360343,38281,48033,17696,1312310,77254,1446657,1360343,,,,,0,0,0,0
1650443129.805652,public.usertable,1312697,77257,1617002496,16782,public,usertable,1,0,3499247,2804085,1360731,38283,48034,17697,1312697,77257,1447048,1360731,,,,,0,0,0,0
1650443130.8354936,public.usertable,1313129,77262,1617526784,16782,public,usertable,1,0,3500294,2804108,1361164,38287,48035,17698,1313129,77262,1447486,1361164,,,,,0,0,0,0
1650443131.8642538,public.usertable,1313553,77265,1618042880,16782,public,usertable,1,0,3501563,2804216,1361592,38289,48039,17700,1313553,77265,1447920,1361592,,,,,0,0,0,0
1650443132.8936002,public.usertable,1313947,77263,1618518016,16782,public,usertable,1,0,3502633,2804400,1361986,38290,48039,17701,1313947,77263,1448315,1361986,,,,,0,0,0,0
1650443133.9274204,public.usertable,1314355,77265,1619009536,16782,public,usertable,1,0,3503709,2804657,1362395,38291,48040,17701,1314355,77265,1448726,1362395,,,,,0,0,0,0
1650443134.9589145,public.usertable,1314774,77265,1619501056,16782,public,usertable,1,0,3504873,2804694,1362814,38291,48040,17701,1314774,77265,1449145,1362814,,,,,0,0,0,0
1650443135.9912908,public.usertable,1315147,77267,1619951616,16782,public,usertable,1,0,3505925,2804730,1363189,38291,48042,17701,1315147,77267,1449522,1363189,,,,,0,0,0,0
1650443137.0252306,public.usertable,1315538,77268,1620418560,16782,public,usertable,1,0,3506921,2804781,1363580,38292,48042,17701,1315538,77268,1449914,1363580,,,,,0,0,0,0
1650443138.0567422,public.usertable,1315882,77272,1620860928,16782,public,usertable,1,0,3507981,2804938,1363927,38293,48045,17701,1315882,77272,1450265,1363927,,,,,0,0,0,0
1650443139.085801,public.usertable,1316287,77277,1621360640,16782,public,usertable,1,0,3508975,2804987,1364335,38295,48048,17702,1316287,77277,1450678,1364335,,,,,0,0,0,0
1650443140.1154711,public.usertable,1316686,77281,1621819392,16782,public,usertable,1,0,3510065,2805100,1364736,38297,48050,17704,1316686,77281,1451083,1364736,,,,,0,0,0,0
1650443141.1461415,public.usertable,1317070,77283,1622294528,16782,public,usertable,1,0,3511103,2805191,1365121,38298,48051,17704,1317070,77283,1451470,1365121,,,,,0,0,0,0
1650443142.1754613,public.usertable,1317470,77288,1622777856,16782,public,usertable,1,0,3512079,2805212,1365525,38299,48055,17704,1317470,77288,1451879,1365525,,,,,0,0,0,0
1650443143.206482,public.usertable,1317861,77291,1623277568,16782,public,usertable,1,0,3513095,2805250,1365919,38299,48058,17704,1317861,77291,1452276,1365919,,,,,0,0,0,0
1650443144.2361906,public.usertable,1318311,77295,1623810048,16782,public,usertable,1,0,3514348,2805284,1366370,38302,48059,17705,1318311,77295,1452731,1366370,,,,,0,0,0,0
1650443145.2644575,public.usertable,1318719,77296,1624317952,16782,public,usertable,1,0,3515415,2805362,1366779,38304,48060,17705,1318719,77296,1453143,1366779,,,,,0,0,0,0
1650443146.2932117,public.usertable,1319323,77295,1624784896,16782,public,usertable,1,0,3517048,2805413,1367384,38306,48061,17705,1319323,77295,1453751,1367384,,,,,0,0,0,0
1650443147.3230648,public.usertable,1319674,77296,1625210880,16782,public,usertable,1,0,3517924,2805435,1367736,38306,48062,17705,1319674,77296,1454104,1367736,,,,,0,0,0,0
1650443148.3529632,public.usertable,1320047,77297,1625661440,16782,public,usertable,1,0,3518864,2805629,1368110,38306,48063,17705,1320047,77297,1454479,1368110,,,,,0,0,0,0
1650443149.3835518,public.usertable,1320436,77300,1626128384,16782,public,usertable,1,0,3519857,2805645,1368500,38308,48064,17705,1320436,77300,1454872,1368500,,,,,0,0,0,0
1650443150.4137642,public.usertable,1320841,77302,1626628096,16782,public,usertable,1,0,3520904,2805748,1368906,38309,48065,17705,1320841,77302,1455280,1368906,,,,,0,0,0,0
1650443151.447061,public.usertable,1321246,77302,1627111424,16782,public,usertable,1,0,3522013,2805832,1369311,38309,48065,17705,1321246,77302,1455685,1369311,,,,,0,0,0,0
1650443152.4761965,public.usertable,1321649,77303,1627594752,16782,public,usertable,1,0,3523126,2805988,1369715,38309,48066,17705,1321649,77303,1456090,1369715,,,,,0,0,0,0
1650443153.5057335,public.usertable,1322076,77305,1628127232,16782,public,usertable,1,0,3524353,2806046,1370143,38310,48067,17705,1322076,77305,1456520,1370143,,,,,0,0,0,0
1650443154.5356717,public.usertable,1322502,77307,1628618752,16782,public,usertable,1,0,3525508,2806119,1370571,38310,48069,17705,1322502,77307,1456950,1370571,,,,,0,0,0,0
1650443155.5640848,public.usertable,1322894,77308,1629110272,16782,public,usertable,1,0,3526561,2806368,1370964,38310,48070,17705,1322894,77308,1457344,1370964,,,,,0,0,0,0
1650443156.5934527,public.usertable,1323324,77315,1629618176,16782,public,usertable,1,0,3527830,2806452,1371397,38314,48073,17706,1323324,77315,1457784,1371397,,,,,0,0,0,0
1650443157.6242745,public.usertable,1323725,77318,1630101504,16782,public,usertable,1,0,3529090,2806529,1371798,38317,48073,17707,1323725,77318,1458188,1371798,,,,,0,0,0,0
1650443158.6542914,public.usertable,1324113,77318,1630584832,16782,public,usertable,1,0,3530045,2806552,1372186,38317,48073,17707,1324113,77318,1458576,1372186,,,,,0,0,0,0
1650443159.684564,public.usertable,1324539,77322,1631092736,16782,public,usertable,1,0,3531142,2806681,1372614,38319,48075,17708,1324539,77322,1459008,1372614,,,,,0,0,0,0
1650443160.7142446,public.usertable,1324903,77328,1631526912,16782,public,usertable,1,0,3532063,2806722,1372982,38321,48079,17709,1324903,77328,1459382,1372982,,,,,0,0,0,0
1650443161.7428193,public.usertable,1325295,77329,1632002048,16782,public,usertable,1,0,3533149,2806782,1373378,38322,48083,17709,1325295,77329,1459783,1373378,,,,,0,0,0,0
1650443162.7744346,public.usertable,1325692,77332,1632518144,16782,public,usertable,1,0,3534334,2806829,1373776,38324,48084,17710,1325692,77332,1460184,1373776,,,,,0,0,0,0
1650443163.806815,public.usertable,1326130,77333,1633042432,16782,public,usertable,1,0,3535551,2806914,1374215,38324,48085,17710,1326130,77333,1460624,1374215,,,,,0,0,0,0
1650443164.8359163,public.usertable,1326708,77338,1633476608,16782,public,usertable,1,0,3537139,2807003,1374796,38326,48088,17710,1326708,77338,1461210,1374796,,,,,0,0,0,0
1650443165.867269,public.usertable,1326991,77340,1633828864,16782,public,usertable,1,0,3537909,2807030,1375080,38327,48089,17710,1326991,77340,1461496,1375080,,,,,0,0,0,0
1650443166.8956165,public.usertable,1327330,77343,1634230272,16782,public,usertable,1,0,3538833,2807133,1375420,38329,48090,17711,1327330,77343,1461839,1375420,,,,,0,0,0,0
1650443167.925203,public.usertable,1327625,77344,1634590720,16782,public,usertable,1,0,3539651,2807218,1375715,38330,48090,17711,1327625,77344,1462135,1375715,,,,,0,0,0,0
1650443168.9549193,public.usertable,1327934,77345,1634942976,16782,public,usertable,1,0,3540475,2807321,1376025,38330,48091,17711,1327934,77345,1462446,1376025,,,,,0,0,0,0
1650443169.983238,public.usertable,1328197,77347,1635270656,16782,public,usertable,1,0,3541147,2807358,1376290,38330,48093,17711,1328197,77347,1462713,1376290,,,,,0,0,0,0
1650443171.0167043,public.usertable,1328503,77349,1635639296,16782,public,usertable,1,0,3541957,2807427,1376596,38332,48093,17711,1328503,77349,1463021,1376596,,,,,0,0,0,0
1650443172.045609,public.usertable,1328788,77351,1635983360,16782,public,usertable,1,0,3542881,2807436,1376882,38333,48094,17711,1328788,77351,1463309,1376882,,,,,0,0,0,0
1650443173.074218,public.usertable,1329105,77355,1636401152,16782,public,usertable,1,0,3543658,2807524,1377202,38334,48097,17712,1329105,77355,1463633,1377202,,,,,0,0,0,0
1650443174.103646,public.usertable,1329509,77357,1636884480,16782,public,usertable,1,0,3544702,2807560,1377608,38334,48099,17712,1329509,77357,1464041,1377608,,,,,0,0,0,0
1650443175.1337557,public.usertable,1329935,77358,1637392384,16782,public,usertable,1,0,3545793,2807668,1378034,38335,48099,17712,1329935,77358,1464468,1378034,,,,,0,0,0,0
1650443176.1632357,public.usertable,1330330,77363,1637883904,16782,public,usertable,1,0,3546853,2807775,1378434,38335,48104,17712,1330330,77363,1464873,1378434,,,,,0,0,0,0
1650443177.1919744,public.usertable,1330754,77368,1638391808,16782,public,usertable,1,0,3548005,2807793,1378861,38337,48107,17713,1330754,77368,1465305,1378861,,,,,0,0,0,0
1650443178.2248101,public.usertable,1331142,77373,1638875136,16782,public,usertable,1,0,3549119,2807864,1379252,38339,48110,17715,1331142,77373,1465701,1379252,,,,,0,0,0,0
1650443179.2534325,public.usertable,1331562,77374,1639374848,16782,public,usertable,1,0,3550148,2807875,1379673,38339,48111,17715,1331562,77374,1466123,1379673,,,,,0,0,0,0
1650443180.2843297,public.usertable,1331976,77377,1639874560,16782,public,usertable,1,0,3551349,2807887,1380089,38340,48113,17716,1331976,77377,1466542,1380089,,,,,0,0,0,0
1650443181.3155897,public.usertable,1332408,77379,1640415232,16782,public,usertable,1,0,3552454,2807969,1380521,38342,48113,17718,1332408,77379,1466976,1380521,,,,,0,0,0,0
1650443182.346451,public.usertable,1332847,77377,1640939520,16782,public,usertable,1,0,3553591,2808038,1380962,38343,48115,17718,1332847,77377,1467420,1380962,,,,,0,0,0,0
1650443183.3771083,public.usertable,1333497,77383,1641472000,16782,public,usertable,1,0,3555296,2808112,1381617,38344,48120,17718,1333497,77383,1468081,1381617,,,,,0,0,0,0
1650443184.4075232,public.usertable,1333933,77386,1641996288,16782,public,usertable,1,0,3556415,2808138,1382053,38347,48120,17720,1333933,77386,1468520,1382053,,,,,0,0,0,0
1650443185.4369097,public.usertable,1334366,77390,1642512384,16782,public,usertable,1,0,3557658,2808153,1382491,38347,48125,17720,1334366,77390,1468963,1382491,,,,,0,0,0,0
1650443186.4649117,public.usertable,1334802,77391,1643053056,16782,public,usertable,1,0,3558866,2808244,1382930,38347,48128,17720,1334802,77391,1469405,1382930,,,,,0,0,0,0
1650443187.4935052,public.usertable,1335268,77397,1643618304,16782,public,usertable,1,0,3560007,2808286,1383398,38351,48130,17722,1335268,77397,1469879,1383398,,,,,0,0,0,0
1650443188.5247319,public.usertable,1335711,77399,1644150784,16782,public,usertable,1,0,3561190,2808312,1383843,38351,48132,17722,1335711,77399,1470326,1383843,,,,,0,0,0,0
1650443189.5525835,public.usertable,1336153,77399,1644683264,16782,public,usertable,1,0,3562297,2808411,1384285,38351,48132,17722,1336153,77399,1470768,1384285,,,,,0,0,0,0
1650443190.5822065,public.usertable,1336565,77402,1645174784,16782,public,usertable,1,0,3563495,2808424,1384698,38353,48133,17722,1336565,77402,1471184,1384698,,,,,0,0,0,0
1650443191.6121314,public.usertable,1336967,77400,1645666304,16782,public,usertable,1,0,3564570,2808574,1385100,38353,48133,17722,1336967,77400,1471586,1385100,,,,,0,0,0,0
1650443192.6412735,public.usertable,1337394,77404,1646174208,16782,public,usertable,1,0,3565725,2808630,1385531,38353,48137,17722,1337394,77404,1472021,1385531,,,,,0,0,0,0
1650443193.6726382,public.usertable,1337790,77405,1646657536,16782,public,usertable,1,0,3566835,2808640,1385928,38353,48138,17722,1337790,77405,1472419,1385928,,,,,0,0,0,0
1650443194.7011943,public.usertable,1338184,77405,1647099904,16782,public,usertable,1,0,3567865,2808666,1386322,38353,48138,17722,1338184,77405,1472813,1386322,,,,,0,0,0,0
1650443195.730095,public.usertable,1338586,77406,1647591424,16782,public,usertable,1,0,3568930,2808696,1386724,38354,48138,17723,1338586,77406,1473216,1386724,,,,,0,0,0,0
1650443196.7580109,public.usertable,1338976,77407,1648082944,16782,public,usertable,1,0,3570016,2808822,1387114,38355,48138,17723,1338976,77407,1473607,1387114,,,,,0,0,0,0
1650443197.7885258,public.usertable,1339379,77412,1648574464,16782,public,usertable,1,0,3571087,2808886,1387519,38358,48140,17724,1339379,77412,1474017,1387519,,,,,0,0,0,0
1650443198.8182266,public.usertable,1339771,77414,1649041408,16782,public,usertable,1,0,3572069,2808912,1387913,38358,48142,17724,1339771,77414,1474413,1387913,,,,,0,0,0,0
1650443199.8504508,public.usertable,1340183,77415,1649541120,16782,public,usertable,1,0,3573089,2808968,1388326,38358,48143,17724,1340183,77415,1474827,1388326,,,,,0,0,0,0
1650443200.8816035,public.usertable,1340592,77420,1650049024,16782,public,usertable,1,0,3574184,2808986,1388737,38361,48145,17725,1340592,77420,1475243,1388737,,,,,0,0,0,0
1650443201.91165,public.usertable,1341200,77424,1650532352,16782,public,usertable,1,0,3575882,2809101,1389349,38361,48149,17725,1341200,77424,1475859,1389349,,,,,0,0,0,0
1650443202.9395802,public.usertable,1341597,77419,1651015680,16782,public,usertable,1,0,3576946,2809208,1389746,38362,48149,17725,1341597,77419,1476257,1389746,,,,,0,0,0,0
1650443203.9688835,public.usertable,1342033,77422,1651531776,16782,public,usertable,1,0,3578011,2809270,1390185,38362,48152,17725,1342033,77422,1476699,1390185,,,,,0,0,0,0
1650443204.9977188,public.usertable,1342452,77424,1652047872,16782,public,usertable,1,0,3579047,2809297,1390605,38363,48153,17725,1342452,77424,1477121,1390605,,,,,0,0,0,0
1650443206.0266316,public.usertable,1342887,77425,1652563968,16782,public,usertable,1,0,3580180,2809427,1391041,38363,48154,17725,1342887,77425,1477558,1391041,,,,,0,0,0,0
1650443207.0579028,public.usertable,1343297,77426,1653055488,16782,public,usertable,1,0,3581327,2809468,1391451,38364,48154,17725,1343297,77426,1477969,1391451,,,,,0,0,0,0
1650443208.0876167,public.usertable,1343677,77427,1653514240,16782,public,usertable,1,0,3582397,2809588,1391831,38365,48154,17726,1343677,77427,1478350,1391831,,,,,0,0,0,0
1650443209.1175985,public.usertable,1344067,77428,1653981184,16782,public,usertable,1,0,3583331,2809664,1392221,38366,48154,17726,1344067,77428,1478741,1392221,,,,,0,0,0,0
1650443210.146608,public.usertable,1344489,77429,1654489088,16782,public,usertable,1,0,3584403,2809682,1392644,38366,48155,17726,1344489,77429,1479165,1392644,,,,,0,0,0,0
1650443211.176006,public.usertable,1344917,77429,1655021568,16782,public,usertable,1,0,3585483,2809826,1393072,38366,48155,17726,1344917,77429,1479593,1393072,,,,,0,0,0,0
1650443212.2053354,public.usertable,1345365,77432,1655554048,16782,public,usertable,1,0,3586616,2810093,1393522,38367,48157,17727,1345365,77432,1480046,1393522,,,,,0,0,0,0
1650443213.2397718,public.usertable,1345780,77431,1656061952,16782,public,usertable,1,0,3587708,2810162,1393937,38367,48157,17727,1345780,77431,1480461,1393937,,,,,0,0,0,0
1650443214.2685442,public.usertable,1346231,77437,1656610816,16782,public,usertable,1,0,3588869,2810322,1394391,38370,48160,17728,1346231,77437,1480921,1394391,,,,,0,0,0,0
1650443215.297744,public.usertable,1346673,77438,1657151488,16782,public,usertable,1,0,3589885,2810400,1394834,38374,48161,17730,1346673,77438,1481369,1394834,,,,,0,0,0,0
1650443216.3268087,public.usertable,1347112,77438,1657675776,16782,public,usertable,1,0,3591161,2810502,1395275,38375,48163,17731,1347112,77438,1481813,1395275,,,,,0,0,0,0
1650443217.3587995,public.usertable,1347544,77441,1658183680,16782,public,usertable,1,0,3592314,2810552,1395708,38377,48164,17733,1347544,77441,1482249,1395708,,,,,0,0,0,0
1650443218.3884168,public.usertable,1347960,77444,1658691584,16782,public,usertable,1,0,3593433,2810576,1396124,38380,48164,17734,1347960,77444,1482668,1396124,,,,,0,0,0,0
1650443219.4175608,public.usertable,1348396,77445,1659232256,16782,public,usertable,1,0,3594567,2810605,1396561,38380,48165,17734,1348396,77445,1483106,1396561,,,,,0,0,0,0
1650443220.4462888,public.usertable,1348835,77447,1659756544,16782,public,usertable,1,0,3595824,2810752,1397001,38381,48166,17735,1348835,77447,1483548,1397001,,,,,0,0,0,0
1650443221.4745126,public.usertable,1349501,77451,1660297216,16782,public,usertable,1,0,3597569,2810887,1397669,38383,48168,17736,1349501,77451,1484220,1397669,,,,,0,0,0,0
1650443222.5033703,public.usertable,1349914,77450,1660796928,16782,public,usertable,1,0,3598735,2810976,1398083,38384,48169,17737,1349914,77450,1484636,1398083,,,,,0,0,0,0
1650443223.5331829,public.usertable,1350368,77452,1661337600,16782,public,usertable,1,0,3599882,2811131,1398539,38384,48171,17737,1350368,77452,1485094,1398539,,,,,0,0,0,0
1650443224.5645933,public.usertable,1350803,77457,1661870080,16782,public,usertable,1,0,3601027,2811170,1398977,38386,48174,17739,1350803,77457,1485537,1398977,,,,,0,0,0,0
1650443225.5959923,public.usertable,1351216,77462,1662377984,16782,public,usertable,1,0,3602195,2811215,1399394,38387,48178,17739,1351216,77462,1485959,1399394,,,,,0,0,0,0
1650443226.6272552,public.usertable,1351650,77469,1662910464,16782,public,usertable,1,0,3603322,2811272,1399832,38390,48182,17740,1351650,77469,1486404,1399832,,,,,0,0,0,0
1650443227.6588535,public.usertable,1352088,77470,1663426560,16782,public,usertable,1,0,3604453,2811518,1400270,38391,48182,17741,1352088,77470,1486843,1400270,,,,,0,0,0,0
1650443228.688061,public.usertable,1352468,77472,1663893504,16782,public,usertable,1,0,3605540,2811543,1400652,38391,48184,17741,1352468,77472,1487227,1400652,,,,,0,0,0,0
1650443229.7162747,public.usertable,1352911,77473,1664425984,16782,public,usertable,1,0,3606627,2811608,1401096,38391,48185,17741,1352911,77473,1487672,1401096,,,,,0,0,0,0
1650443230.7469022,public.usertable,1353364,77477,1664966656,16782,public,usertable,1,0,3607759,2811648,1401552,38392,48188,17742,1353364,77477,1488132,1401552,,,,,0,0,0,0
1650443231.7831028,public.usertable,1353767,77478,1665441792,16782,public,usertable,1,0,3608923,2811666,1401955,38393,48188,17743,1353767,77478,1488536,1401955,,,,,0,0,0,0
1650443232.814702,public.usertable,1354163,77480,1665925120,16782,public,usertable,1,0,3609906,2811781,1402353,38393,48190,17743,1354163,77480,1488936,1402353,,,,,0,0,0,0
1650443233.844247,public.usertable,1354571,77481,1666433024,16782,public,usertable,1,0,3610939,2811835,1402762,38393,48191,17743,1354571,77481,1489346,1402762,,,,,0,0,0,0
1650443234.8730814,public.usertable,1355000,77485,1666949120,16782,public,usertable,1,0,3612137,2812016,1403194,38394,48194,17744,1355000,77485,1489782,1403194,,,,,0,0,0,0
1650443235.9019144,public.usertable,1355436,77488,1667465216,16782,public,usertable,1,0,3613245,2812057,1403632,38395,48196,17744,1355436,77488,1490223,1403632,,,,,0,0,0,0
1650443236.9301455,public.usertable,1355841,77490,1667973120,16782,public,usertable,1,0,3614465,2812138,1404038,38396,48197,17744,1355841,77490,1490631,1404038,,,,,0,0,0,0
1650443237.95857,public.usertable,1356251,77494,1668472832,16782,public,usertable,1,0,3615549,2812165,1404449,38399,48198,17746,1356251,77494,1491046,1404449,,,,,0,0,0,0
1650443238.9877985,public.usertable,1356900,77501,1668997120,16782,public,usertable,1,0,3617232,2812304,1405102,38403,48202,17748,1356900,77501,1491707,1405102,,,,,0,0,0,0
1650443240.016593,public.usertable,1357329,77501,1669513216,16782,public,usertable,1,0,3618399,2812308,1405531,38403,48202,17748,1357329,77501,1492136,1405531,,,,,0,0,0,0
1650443241.0452425,public.usertable,1357736,77503,1670004736,16782,public,usertable,1,0,3619475,2812366,1405939,38404,48203,17748,1357736,77503,1492546,1405939,,,,,0,0,0,0
1650443242.0740075,public.usertable,1358185,77505,1670545408,16782,public,usertable,1,0,3620604,2812392,1406388,38406,48203,17748,1358185,77505,1492997,1406388,,,,,0,0,0,0
1650443243.1034508,public.usertable,1358621,77508,1671077888,16782,public,usertable,1,0,3621829,2812416,1406826,38407,48205,17748,1358621,77508,1493438,1406826,,,,,0,0,0,0
1650443244.133002,public.usertable,1359050,77511,1671553024,16782,public,usertable,1,0,3622996,2812524,1407257,38408,48207,17749,1359050,77511,1493872,1407257,,,,,0,0,0,0
1650443245.1646419,public.usertable,1359453,77514,1672077312,16782,public,usertable,1,0,3623962,2812553,1407662,38409,48209,17750,1359453,77514,1494280,1407662,,,,,0,0,0,0
1650443246.1929345,public.usertable,1359879,77518,1672593408,16782,public,usertable,1,0,3625178,2812688,1408090,38411,48211,17750,1359879,77518,1494712,1408090,,,,,0,0,0,0
1650443247.2233124,public.usertable,1360303,77520,1673101312,16782,public,usertable,1,0,3626327,2812821,1408515,38412,48212,17750,1360303,77520,1495139,1408515,,,,,0,0,0,0
1650443248.2526386,public.usertable,1360632,77522,1673502720,16782,public,usertable,1,0,3627212,2812972,1408845,38413,48213,17751,1360632,77522,1495471,1408845,,,,,0,0,0,0
1650443249.2822835,public.usertable,1360943,77528,1673846784,16782,public,usertable,1,0,3628116,2813028,1409157,38418,48214,17753,1360943,77528,1495789,1409157,,,,,0,0,0,0
1650443250.311141,public.usertable,1361286,77533,1674297344,16782,public,usertable,1,0,3629068,2813109,1409504,38419,48218,17753,1361286,77533,1496141,1409504,,,,,0,0,0,0
1650443251.3408203,public.usertable,1361658,77534,1674747904,16782,public,usertable,1,0,3629984,2813138,1409877,38419,48219,17753,1361658,77534,1496515,1409877,,,,,0,0,0,0
1650443252.3698823,public.usertable,1362051,77535,1675239424,16782,public,usertable,1,0,3631035,2813160,1410270,38420,48219,17753,1362051,77535,1496909,1410270,,,,,0,0,0,0
1650443253.3992467,public.usertable,1362494,77536,1675763712,16782,public,usertable,1,0,3632222,2813194,1410714,38420,48220,17753,1362494,77536,1497354,1410714,,,,,0,0,0,0
1650443254.4286182,public.usertable,1362931,77539,1676296192,16782,public,usertable,1,0,3633424,2813259,1411153,38421,48222,17753,1362931,77539,1497796,1411153,,,,,0,0,0,0
1650443255.4603853,public.usertable,1363345,77543,1676795904,16782,public,usertable,1,0,3634578,2813296,1411568,38424,48223,17754,1363345,77543,1498215,1411568,,,,,0,0,0,0
1650443256.491342,public.usertable,1363761,77543,1677279232,16782,public,usertable,1,0,3635786,2813397,1411984,38424,48223,17754,1363761,77543,1498631,1411984,,,,,0,0,0,0
1650443257.521223,public.usertable,1364155,77546,1677754368,16782,public,usertable,1,0,3636735,2813449,1412381,38424,48226,17754,1364155,77546,1499031,1412381,,,,,0,0,0,0
1650443258.5518606,public.usertable,1364743,77548,1678237696,16782,public,usertable,1,0,3638271,2813491,1412971,38424,48228,17754,1364743,77548,1499623,1412971,,,,,0,0,0,0
1650443259.5806777,public.usertable,1365139,77550,1678712832,16782,public,usertable,1,0,3639271,2813646,1413370,38426,48231,17755,1365139,77550,1500027,1413370,,,,,0,0,0,0
1650443260.6091845,public.usertable,1365554,77551,1679212544,16782,public,usertable,1,0,3640358,2813793,1413785,38427,48231,17756,1365554,77551,1500443,1413785,,,,,0,0,0,0
1650443261.6401858,public.usertable,1365957,77557,1679712256,16782,public,usertable,1,0,3641466,2813810,1414193,38428,48236,17756,1365957,77557,1500857,1414193,,,,,0,0,0,0
1650443262.6692586,public.usertable,1366362,77560,1680187392,16782,public,usertable,1,0,3642542,2813923,1414599,38430,48237,17758,1366362,77560,1501266,1414599,,,,,0,0,0,0
1650443263.6991863,public.usertable,1366758,77556,1680678912,16782,public,usertable,1,0,3643684,2814065,1414995,38431,48237,17758,1366758,77556,1501663,1414995,,,,,0,0,0,0
1650443264.7292492,public.usertable,1367179,77559,1681186816,16782,public,usertable,1,0,3644978,2814213,1415418,38432,48239,17758,1367179,77559,1502089,1415418,,,,,0,0,0,0
1650443265.7630758,public.usertable,1367588,77559,1681678336,16782,public,usertable,1,0,3645997,2814277,1415827,38432,48239,17758,1367588,77559,1502498,1415827,,,,,0,0,0,0
1650443266.7938364,public.usertable,1367998,77559,1682161664,16782,public,usertable,1,0,3647074,2814310,1416237,38433,48239,17759,1367998,77559,1502909,1416237,,,,,0,0,0,0
1650443267.8245504,public.usertable,1368399,77560,1682653184,16782,public,usertable,1,0,3648157,2814413,1416639,38434,48240,17760,1368399,77560,1503313,1416639,,,,,0,0,0,0
1650443268.8554342,public.usertable,1368798,77565,1683128320,16782,public,usertable,1,0,3649267,2814441,1417041,38436,48243,17762,1368798,77565,1503720,1417041,,,,,0,0,0,0
1650443269.8847535,public.usertable,1369223,77567,1683644416,16782,public,usertable,1,0,3650428,2814538,1417466,38438,48243,17764,1369223,77567,1504147,1417466,,,,,0,0,0,0
1650443270.9138157,public.usertable,1369648,77573,1684176896,16782,public,usertable,1,0,3651560,2814664,1417894,38441,48246,17765,1369648,77573,1504581,1417894,,,,,0,0,0,0
1650443271.9466007,public.usertable,1370068,77576,1684684800,16782,public,usertable,1,0,3652705,2814780,1418317,38443,48249,17767,1370068,77576,1505009,1418317,,,,,0,0,0,0
1650443272.97517,public.usertable,1370497,77580,1685200896,16782,public,usertable,1,0,3653829,2815022,1418748,38445,48251,17769,1370497,77580,1505444,1418748,,,,,0,0,0,0
1650443274.0054955,public.usertable,1370936,77578,1685725184,16782,public,usertable,1,0,3654943,2815210,1419188,38445,48252,17769,1370936,77578,1505885,1419188,,,,,0,0,0,0
1650443275.0384696,public.usertable,1371368,77579,1686233088,16782,public,usertable,1,0,3656133,2815304,1419621,38445,48253,17769,1371368,77579,1506319,1419621,,,,,0,0,0,0
1650443276.0697556,public.usertable,1371992,77583,1686749184,16782,public,usertable,1,0,3657821,2815358,1420246,38448,48254,17769,1371992,77583,1506948,1420246,,,,,0,0,0,0
1650443277.0990756,public.usertable,1372371,77589,1687216128,16782,public,usertable,1,0,3658883,2815367,1420629,38450,48258,17770,1372371,77589,1507337,1420629,,,,,0,0,0,0
1650443278.1297698,public.usertable,1372728,77589,1687642112,16782,public,usertable,1,0,3659835,2815407,1420986,38450,48258,17770,1372728,77589,1507694,1420986,,,,,0,0,0,0
1650443279.1592894,public.usertable,1373122,77592,1688125440,16782,public,usertable,1,0,3660952,2815424,1421382,38451,48260,17771,1373122,77592,1508093,1421382,,,,,0,0,0,0
1650443280.1889527,public.usertable,1373513,77594,1688584192,16782,public,usertable,1,0,3661953,2815435,1421774,38452,48261,17771,1373513,77594,1508487,1421774,,,,,0,0,0,0
1650443281.2188797,public.usertable,1373930,77595,1689083904,16782,public,usertable,1,0,3663000,2815558,1422191,38453,48261,17771,1373930,77595,1508905,1422191,,,,,0,0,0,0
1650443282.2478046,public.usertable,1374040,77596,1689149440,16782,public,usertable,1,0,3663274,2815566,1422302,38453,48262,17771,1374040,77596,1509017,1422302,,,,,0,0,0,0
1650443283.269829,public.usertable,1374040,77596,1689149440,16782,public,usertable,1,0,3663274,2815566,1422302,38453,48262,17771,1374040,77596,1509017,1422302,,,,,0,0,0,0
1650443284.3008738,public.usertable,1374040,77596,1689149440,16782,public,usertable,1,0,3663274,2815566,1422302,38453,48262,17771,1374040,77596,1509017,1422302,,,,,0,0,0,0
1650443285.331074,public.usertable,1374040,77596,1689149440,16782,public,usertable,1,0,3663274,2815566,1422302,38453,48262,17771,1374040,77596,1509017,1422302,,,,,0,0,0,0
1650443286.3601873,public.usertable,1374040,77596,1689149440,16782,public,usertable,1,0,3663274,2815566,1422302,38453,48262,17771,1374040,77596,1509017,1422302,,,,,0,0,0,0
1650443287.391957,public.usertable,1374040,77596,1689149440,16782,public,usertable,1,0,3663274,2815566,1422302,38453,48262,17771,1374040,77596,1509017,1422302,,,,,0,0,0,0
1650443288.4213524,public.usertable,1374040,77596,1689149440,16782,public,usertable,1,0,3663274,2815566,1422302,38453,48262,17771,1374040,77596,1509017,1422302,,,,,0,0,0,0
1650443289.4519877,public.usertable,1374040,77596,1689149440,16782,public,usertable,1,0,3663274,2815566,1422302,38453,48262,17771,1374040,77596,1509017,1422302,,,,,0,0,0,0
1650443290.4854887,public.usertable,1374040,77596,1689149440,16782,public,usertable,1,0,3663274,2815566,1422302,38453,48262,17771,1374040,77596,1509017,1422302,,,,,0,0,0,0
1650443291.5158496,public.usertable,1374040,77596,1689149440,16782,public,usertable,1,0,3663274,2815566,1422302,38453,48262,17771,1374040,77596,1509017,1422302,,,,,0,0,0,0
1650443292.5496044,public.usertable,1374040,77596,1689149440,16782,public,usertable,1,0,3663274,2815566,1422302,38453,48262,17771,1374040,77596,1509017,1422302,,,,,0,0,0,0
1650443293.578443,public.usertable,1374040,77596,1689149440,16782,public,usertable,1,0,3663274,2815566,1422302,38453,48262,17771,1374040,77596,1509017,1422302,,,,,0,0,0,0
1650443294.609646,public.usertable,1374040,77596,1689149440,16782,public,usertable,1,0,3663274,2815566,1422302,38453,48262,17771,1374040,77596,1509017,1422302,,,,,0,0,0,0
1650443295.639466,public.usertable,1374040,77596,1689149440,16782,public,usertable,1,0,3663274,2815566,1422302,38453,48262,17771,1374040,77596,1509017,1422302,,,,,0,0,0,0
1650443296.6712701,public.usertable,1374040,77596,1689149440,16782,public,usertable,1,0,3663274,2815566,1422302,38453,48262,17771,1374040,77596,1509017,1422302,,,,,0,0,0,0
1650443297.6992157,public.usertable,1374040,77596,1689149440,16782,public,usertable,1,0,3663274,2815566,1422302,38453,48262,17771,1374040,77596,1509017,1422302,,,,,0,0,0,0
1650443298.731135,public.usertable,1374040,77596,1689149440,16782,public,usertable,1,0,3663274,2815566,1422302,38453,48262,17771,1374040,77596,1509017,1422302,,,,,0,0,0,0
1650443299.7608004,public.usertable,1374040,77596,1689149440,16782,public,usertable,1,0,3663274,2815566,1422302,38453,48262,17771,1374040,77596,1509017,1422302,,,,,0,0,0,0
1650443300.7897816,public.usertable,1374040,77596,1689149440,16782,public,usertable,1,0,3663274,2815566,1422302,38453,48262,17771,1374040,77596,1509017,1422302,,,,,0,0,0,0
1650443301.81904,public.usertable,1374040,77596,1689149440,16782,public,usertable,1,0,3663274,2815566,1422302,38453,48262,17771,1374040,77596,1509017,1422302,,,,,0,0,0,0
1650443302.8497605,public.usertable,1374040,77596,1689149440,16782,public,usertable,1,0,3663274,2815566,1422302,38453,48262,17771,1374040,77596,1509017,1422302,,,,,0,0,0,0
1650443303.878731,public.usertable,1374040,77596,1689149440,16782,public,usertable,1,0,3663274,2815566,1422302,38453,48262,17771,1374040,77596,1509017,1422302,,,,,0,0,0,0
1650443304.9072158,public.usertable,1374040,77596,1689149440,16782,public,usertable,1,0,3663274,2815566,1422302,38453,48262,17771,1374040,77596,1509017,1422302,,,,,0,0,0,0
1650443305.937401,public.usertable,1374040,77596,1689149440,16782,public,usertable,1,0,3663274,2815566,1422302,38453,48262,17771,1374040,77596,1509017,1422302,,,,,0,0,0,0
1650443306.9655163,public.usertable,1374040,77596,1689149440,16782,public,usertable,1,0,3663274,2815566,1422302,38453,48262,17771,1374040,77596,1509017,1422302,,,,,0,0,0,0
