ds,table_name,pg_stat_get_live_tuples,pg_stat_get_dead_tuples,pg_table_size,relid,schemaname,relname,seq_scan,seq_tup_read,idx_scan,idx_tup_fetch,n_tup_ins,n_tup_upd,n_tup_del,n_tup_hot_upd,n_live_tup,n_dead_tup,n_mod_since_analyze,n_ins_since_vacuum,last_vacuum,last_autovacuum,last_analyze,last_autoanalyze,vacuum_count,autovacuum_count,analyze_count,autoanalyze_count
1650436421.1081533,public.usertable,100000,0,117088256,16671,public,usertable,1,0,0,0,100000,0,0,0,100000,0,100000,100000,,,,,0,0,0,0
1650436422.1257224,public.usertable,100000,0,117178368,16671,public,usertable,1,0,1,1,100000,0,0,0,100000,0,100000,100000,,,,,0,0,0,0
1650436423.1538198,public.usertable,100054,195,117506048,16671,public,usertable,1,0,461,5955,100170,83,116,12,100054,195,100369,100170,,,,,0,0,0,0
1650436424.187278,public.usertable,100134,391,117841920,16671,public,usertable,1,0,1003,13184,100365,170,231,24,100134,391,100766,100365,,,,,0,0,0,0
1650436425.2165608,public.usertable,100243,590,118202368,16671,public,usertable,1,0,1602,21401,100590,260,347,37,100243,590,101197,100590,,,,,0,0,0,0
1650436426.2449086,public.usertable,100369,785,118579200,16671,public,usertable,1,0,2245,29915,100824,352,455,49,100369,785,101631,100824,,,,,0,0,0,0
1650436427.2735555,public.usertable,100468,1013,118947840,16671,public,usertable,1,0,2940,36749,101051,455,583,68,100468,1013,102089,101051,,,,,0,0,0,0
1650436428.3048975,public.usertable,100650,1297,119316480,16671,public,usertable,1,0,3924,49961,101400,578,750,90,100650,1297,102728,101400,,,,,0,0,0,0
1650436429.3364723,public.usertable,100801,1478,119701504,16671,public,usertable,1,0,4495,57568,101662,650,861,102,100801,1478,103173,101662,,,,,0,0,0,0
1650436430.3678591,public.usertable,100937,1656,120061952,16671,public,usertable,1,0,5133,65602,101905,728,968,114,100937,1656,103601,101905,,,,,0,0,0,0
1650436431.3990679,public.usertable,101093,1838,120446976,16671,public,usertable,1,0,5766,72889,102165,807,1072,135,101093,1838,104044,102165,,,,,0,0,0,0
1650436432.4298317,public.usertable,101211,2045,120815616,16671,public,usertable,1,0,6490,79570,102400,899,1189,152,101211,2045,104488,102400,,,,,0,0,0,0
1650436433.4583828,public.usertable,101334,2228,121167872,16671,public,usertable,1,0,7160,88419,102635,971,1301,165,101334,2228,104907,102635,,,,,0,0,0,0
1650436434.4883776,public.usertable,101478,2402,121536512,16671,public,usertable,1,0,7830,95116,102872,1056,1394,180,101478,2402,105322,102872,,,,,0,0,0,0
1650436435.5177968,public.usertable,101633,2584,121937920,16671,public,usertable,1,0,8527,102372,103143,1133,1510,194,101633,2584,105786,103143,,,,,0,0,0,0
1650436436.5474677,public.usertable,101799,2756,122347520,16671,public,usertable,1,0,9209,108526,103402,1215,1603,210,101799,2756,106220,103402,,,,,0,0,0,0
1650436437.575518,public.usertable,101977,2931,122748928,16671,public,usertable,1,0,9875,117184,103668,1307,1691,229,101977,2931,106666,103668,,,,,0,0,0,0
1650436438.6053786,public.usertable,102159,3101,123150336,16671,public,usertable,1,0,10576,128633,103945,1383,1786,244,102159,3101,107114,103945,,,,,0,0,0,0
1650436439.633729,public.usertable,102332,3258,123510784,16671,public,usertable,1,0,11285,136213,104204,1458,1872,258,102332,3258,107534,104204,,,,,0,0,0,0
1650436440.662066,public.usertable,102490,3418,123904000,16671,public,usertable,1,0,11916,140818,104466,1515,1976,270,102490,3418,107957,104466,,,,,0,0,0,0
1650436441.691237,public.usertable,102641,3595,124280832,16671,public,usertable,1,0,12678,145078,104719,1594,2078,288,102641,3595,108391,104719,,,,,0,0,0,0
1650436442.721546,public.usertable,102810,3747,124657664,16671,public,usertable,1,0,13352,153934,104980,1660,2170,305,102810,3747,108810,104980,,,,,0,0,0,0
1650436443.751051,public.usertable,102966,3916,125034496,16671,public,usertable,1,0,14043,158643,105233,1738,2267,319,102966,3916,109238,105233,,,,,0,0,0,0
1650436444.779948,public.usertable,103136,4095,125435904,16671,public,usertable,1,0,14787,162541,105508,1816,2372,339,103136,4095,109696,105508,,,,,0,0,0,0
1650436445.8122232,public.usertable,103292,4279,125853696,16671,public,usertable,1,0,15608,168240,105767,1905,2475,361,103292,4279,110147,105767,,,,,0,0,0,0
1650436446.840635,public.usertable,103498,4427,126255104,16671,public,usertable,1,0,16321,174189,106060,1979,2562,382,103498,4427,110601,106060,,,,,0,0,0,0
1650436447.8719778,public.usertable,103784,4674,126681088,16671,public,usertable,1,0,17506,183922,106485,2091,2701,396,103784,4674,111277,106485,,,,,0,0,0,0
1650436448.9017658,public.usertable,103979,4831,127082496,16671,public,usertable,1,0,18195,193815,106767,2165,2788,423,103979,4831,111720,106767,,,,,0,0,0,0
1650436449.9323528,public.usertable,104069,4918,127393792,16671,public,usertable,1,0,18647,195701,106911,2205,2842,432,104069,4918,111958,106911,,,,,0,0,0,0
1650436450.9628851,public.usertable,104155,4975,127549440,16671,public,usertable,1,0,18908,197454,107034,2227,2879,436,104155,4975,112140,107034,,,,,0,0,0,0
1650436451.9939375,public.usertable,104350,5154,127959040,16671,public,usertable,1,0,19728,201474,107329,2307,2979,455,104350,5154,112615,107329,,,,,0,0,0,0
1650436453.0245507,public.usertable,104533,5318,128385024,16671,public,usertable,1,0,20516,208021,107614,2376,3081,471,104533,5318,113071,107614,,,,,0,0,0,0
1650436454.0561368,public.usertable,104740,5466,128778240,16671,public,usertable,1,0,21237,214044,107907,2439,3167,482,104740,5466,113513,107907,,,,,0,0,0,0
1650436455.0880475,public.usertable,104902,5634,129179648,16671,public,usertable,1,0,21968,222269,108175,2509,3273,498,104902,5634,113957,108175,,,,,0,0,0,0
1650436456.1178267,public.usertable,105118,5782,129597440,16671,public,usertable,1,0,22713,225746,108467,2581,3349,512,105118,5782,114397,108467,,,,,0,0,0,0
1650436457.1472979,public.usertable,105279,5959,129974272,16671,public,usertable,1,0,23532,232100,108723,2670,3444,537,105279,5959,114837,108723,,,,,0,0,0,0
1650436458.1763232,public.usertable,105475,6107,130375680,16671,public,usertable,1,0,24250,236369,108991,2757,3516,555,105475,6107,115264,108991,,,,,0,0,0,0
1650436459.2058566,public.usertable,105778,6327,130801664,16671,public,usertable,1,0,25415,243594,109428,2853,3650,571,105778,6327,115931,109428,,,,,0,0,0,0
1650436460.2342408,public.usertable,105959,6479,131178496,16671,public,usertable,1,0,26204,249076,109692,2927,3733,591,105959,6479,116352,109692,,,,,0,0,0,0
1650436461.264072,public.usertable,106138,6625,131563520,16671,public,usertable,1,0,26889,254717,109953,2994,3815,606,106138,6625,116762,109953,,,,,0,0,0,0
1650436462.2935982,public.usertable,106321,6785,131956736,16671,public,usertable,1,0,27666,259935,110224,3067,3903,623,106321,6785,117194,110224,,,,,0,0,0,0
1650436463.3232527,public.usertable,106532,6922,132358144,16671,public,usertable,1,0,28420,264544,110507,3140,3975,646,106532,6922,117622,110507,,,,,0,0,0,0
1650436464.3549066,public.usertable,106785,7050,132784128,16671,public,usertable,1,0,29158,271315,110824,3209,4039,666,106785,7050,118072,110824,,,,,0,0,0,0
1650436465.3869505,public.usertable,106988,7192,133210112,16671,public,usertable,1,0,29908,278881,111105,3281,4117,683,106988,7192,118503,111105,,,,,0,0,0,0
1650436466.4161882,public.usertable,107194,7375,133668864,16671,public,usertable,1,0,30695,285884,111410,3367,4216,701,107194,7375,118993,111410,,,,,0,0,0,0
1650436467.4451895,public.usertable,107412,7561,134111232,16671,public,usertable,1,0,31577,291301,111729,3458,4317,733,107412,7561,119504,111729,,,,,0,0,0,0
1650436468.4741025,public.usertable,107606,7722,134512640,16671,public,usertable,1,0,32271,296638,112008,3535,4402,759,107606,7722,119945,112008,,,,,0,0,0,0
1650436469.5040932,public.usertable,107819,7882,134938624,16671,public,usertable,1,0,33026,301218,112315,3608,4496,780,107819,7882,120419,112315,,,,,0,0,0,0
1650436470.5365853,public.usertable,108018,8046,135372800,16671,public,usertable,1,0,33896,307920,112614,3680,4596,796,108018,8046,120890,112614,,,,,0,0,0,0
1650436471.5670538,public.usertable,108231,8183,135790592,16671,public,usertable,1,0,34696,314978,112898,3759,4667,817,108231,8183,121324,112898,,,,,0,0,0,0
1650436472.5985315,public.usertable,108478,8318,136224768,16671,public,usertable,1,0,35435,319623,113226,3820,4748,832,108478,8318,121794,113226,,,,,0,0,0,0
1650436473.6282384,public.usertable,108686,8474,136634368,16671,public,usertable,1,0,36195,324338,113515,3901,4829,859,108686,8474,122245,113515,,,,,0,0,0,0
1650436474.6643374,public.usertable,108905,8626,137052160,16671,public,usertable,1,0,36956,333537,113809,3978,4904,881,108905,8626,122691,113809,,,,,0,0,0,0
1650436475.6952171,public.usertable,109072,8789,137445376,16671,public,usertable,1,0,37774,338733,114073,4049,5001,899,109072,8789,123123,114073,,,,,0,0,0,0
1650436476.723914,public.usertable,109284,8949,137879552,16671,public,usertable,1,0,38652,344441,114375,4129,5091,918,109284,8949,123595,114375,,,,,0,0,0,0
1650436477.7539043,public.usertable,109623,9176,138330112,16671,public,usertable,1,0,39880,350523,114840,4243,5217,946,109623,9176,124300,114840,,,,,0,0,0,0
1650436478.785065,public.usertable,109866,9305,138764288,16671,public,usertable,1,0,40652,354855,115162,4299,5296,965,109866,9305,124757,115162,,,,,0,0,0,0
1650436479.8178134,public.usertable,110077,9455,139198464,16671,public,usertable,1,0,41454,359921,115466,4366,5389,984,110077,9455,125221,115466,,,,,0,0,0,0
1650436480.8511386,public.usertable,110304,9610,139624448,16671,public,usertable,1,0,42290,364103,115771,4443,5467,1006,110304,9610,125681,115771,,,,,0,0,0,0
1650436481.8798692,public.usertable,110492,9741,140001280,16671,public,usertable,1,0,42992,371408,116037,4503,5545,1020,110492,9741,126085,116037,,,,,0,0,0,0
1650436482.908624,public.usertable,110750,9870,140435456,16671,public,usertable,1,0,43800,378832,116370,4563,5620,1042,110750,9870,126553,116370,,,,,0,0,0,0
1650436483.9385319,public.usertable,110955,10027,140853248,16671,public,usertable,1,0,44636,383300,116679,4617,5724,1060,110955,10027,127020,116679,,,,,0,0,0,0
1650436484.9686599,public.usertable,111170,10181,141287424,16671,public,usertable,1,0,45420,386096,116984,4687,5814,1080,111170,10181,127485,116984,,,,,0,0,0,0
1650436485.997274,public.usertable,111380,10332,141721600,16671,public,usertable,1,0,46267,390942,117286,4760,5906,1103,111380,10332,127952,117286,,,,,0,0,0,0
1650436487.0271862,public.usertable,111643,10456,142163968,16671,public,usertable,1,0,47123,396355,117618,4821,5975,1120,111643,10456,128414,117618,,,,,0,0,0,0
1650436488.0585265,public.usertable,111864,10609,142598144,16671,public,usertable,1,0,48006,398598,117925,4893,6061,1139,111864,10609,128879,117925,,,,,0,0,0,0
1650436489.0886943,public.usertable,112099,10733,143015936,16671,public,usertable,1,0,48783,402535,118229,4953,6130,1156,112099,10733,129312,118229,,,,,0,0,0,0
1650436490.1218452,public.usertable,112318,10885,143425536,16671,public,usertable,1,0,49554,406313,118540,5022,6222,1182,112318,10885,129784,118540,,,,,0,0,0,0
1650436491.152727,public.usertable,112502,11038,143818752,16671,public,usertable,1,0,50412,412737,118823,5086,6321,1203,112502,11038,130230,118823,,,,,0,0,0,0
1650436492.1826682,public.usertable,112706,11166,144220160,16671,public,usertable,1,0,51138,417789,119101,5145,6395,1218,112706,11166,130641,119101,,,,,0,0,0,0
1650436493.2120721,public.usertable,112957,11281,144646144,16671,public,usertable,1,0,51849,424876,119420,5199,6463,1238,112957,11281,131082,119420,,,,,0,0,0,0
1650436494.2445016,public.usertable,113165,11411,145014784,16671,public,usertable,1,0,52604,428897,119701,5262,6536,1253,113165,11411,131499,119701,,,,,0,0,0,0
1650436495.2729142,public.usertable,113331,11534,145326080,16671,public,usertable,1,0,53358,433335,119939,5319,6608,1272,113331,11534,131866,119939,,,,,0,0,0,0
1650436496.3017466,public.usertable,113579,11677,145620992,16671,public,usertable,1,0,54178,441627,120264,5391,6685,1295,113579,11677,132340,120264,,,,,0,0,0,0
1650436497.3318183,public.usertable,113708,11762,145858560,16671,public,usertable,1,0,54668,445033,120445,5426,6737,1303,113708,11762,132608,120445,,,,,0,0,0,0
1650436498.3602962,public.usertable,113844,11857,146128896,16671,public,usertable,1,0,55234,447856,120640,5466,6796,1312,113844,11857,132902,120640,,,,,0,0,0,0
1650436499.3903008,public.usertable,113983,11965,146415616,16671,public,usertable,1,0,55797,451459,120844,5510,6861,1326,113983,11965,133215,120844,,,,,0,0,0,0
1650436500.4189665,public.usertable,114141,12045,146702336,16671,public,usertable,1,0,56347,456363,121051,5550,6910,1338,114141,12045,133511,121051,,,,,0,0,0,0
1650436501.4473994,public.usertable,114298,12141,146989056,16671,public,usertable,1,0,56901,458397,121266,5592,6968,1351,114298,12141,133826,121266,,,,,0,0,0,0
1650436502.4781437,public.usertable,114484,12236,147300352,16671,public,usertable,1,0,57500,462432,121501,5642,7017,1367,114484,12236,134160,121501,,,,,0,0,0,0
1650436503.5075252,public.usertable,114643,12334,147603456,16671,public,usertable,1,0,58135,465767,121708,5700,7065,1390,114643,12334,134473,121708,,,,,0,0,0,0
1650436504.537917,public.usertable,114845,12441,147996672,16671,public,usertable,1,0,58822,468508,121968,5752,7123,1404,114845,12441,134843,121968,,,,,0,0,0,0
1650436505.5666237,public.usertable,115103,12574,148430848,16671,public,usertable,1,0,59627,470370,122297,5814,7194,1428,115103,12574,135305,122297,,,,,0,0,0,0
1650436506.5960572,public.usertable,115337,12712,148848640,16671,public,usertable,1,0,60483,474011,122603,5886,7266,1452,115337,12712,135755,122603,,,,,0,0,0,0
1650436507.6279755,public.usertable,115583,12831,149299200,16671,public,usertable,1,0,61291,478384,122920,5942,7337,1473,115583,12831,136199,122920,,,,,0,0,0,0
1650436508.6594145,public.usertable,115838,12953,149733376,16671,public,usertable,1,0,62102,482806,123246,6004,7408,1492,115838,12953,136658,123246,,,,,0,0,0,0
1650436509.6904395,public.usertable,116078,13103,150183936,16671,public,usertable,1,0,62930,488760,123574,6072,7496,1509,116078,13103,137142,123574,,,,,0,0,0,0
1650436510.722039,public.usertable,116305,13234,150601728,16671,public,usertable,1,0,63748,493564,123882,6128,7577,1520,116305,13234,137587,123882,,,,,0,0,0,0
1650436511.7518175,public.usertable,116538,13362,151003136,16671,public,usertable,1,0,64566,498448,124188,6185,7650,1540,116538,13362,138023,124188,,,,,0,0,0,0
1650436512.7831776,public.usertable,116762,13492,151445504,16671,public,usertable,1,0,65357,504818,124480,6251,7718,1557,116762,13492,138449,124480,,,,,0,0,0,0
1650436513.8151362,public.usertable,116988,13618,151781376,16671,public,usertable,1,0,66230,508554,124789,6296,7801,1574,116988,13618,138886,124789,,,,,0,0,0,0
1650436514.8440325,public.usertable,117158,13750,152158208,16671,public,usertable,1,0,66919,510824,125036,6352,7878,1593,117158,13750,139266,125036,,,,,0,0,0,0
1650436515.874093,public.usertable,117447,13925,152510464,16671,public,usertable,1,0,67999,518476,125438,6423,7991,1615,117447,13925,139852,125438,,,,,0,0,0,0
1650436516.9017959,public.usertable,117652,14036,152879104,16671,public,usertable,1,0,68667,521340,125710,6468,8058,1629,117652,14036,140236,125710,,,,,0,0,0,0
1650436517.9312801,public.usertable,117867,14146,153247744,16671,public,usertable,1,0,69426,524894,125996,6513,8129,1645,117867,14146,140638,125996,,,,,0,0,0,0
1650436518.9614878,public.usertable,118053,14237,153559040,16671,public,usertable,1,0,70057,527887,126238,6548,8185,1653,118053,14237,140971,126238,,,,,0,0,0,0
1650436519.993587,public.usertable,118219,14321,153886720,16671,public,usertable,1,0,70588,531258,126459,6582,8240,1662,118219,14321,141281,126459,,,,,0,0,0,0
1650436521.0251682,public.usertable,118431,14397,154189824,16671,public,usertable,1,0,71224,536939,126718,6621,8287,1676,118431,14397,141626,126718,,,,,0,0,0,0
1650436522.0571234,public.usertable,118586,14469,154484736,16671,public,usertable,1,0,71787,543812,126916,6659,8330,1689,118586,14469,141905,126916,,,,,0,0,0,0
1650436523.0875416,public.usertable,118813,14595,154910720,16671,public,usertable,1,0,72684,548553,127221,6716,8408,1711,118813,14595,142345,127221,,,,,0,0,0,0
1650436524.116375,public.usertable,119035,14732,155320320,16671,public,usertable,1,0,73559,552559,127531,6767,8496,1733,119035,14732,142794,127531,,,,,0,0,0,0
1650436525.1450334,public.usertable,119279,14877,155770880,16671,public,usertable,1,0,74435,556475,127861,6829,8582,1752,119279,14877,143272,127861,,,,,0,0,0,0
1650436526.174502,public.usertable,119542,15005,156229632,16671,public,usertable,1,0,75260,560989,128208,6874,8666,1768,119542,15005,143748,128208,,,,,0,0,0,0
1650436527.2041862,public.usertable,119773,15150,156647424,16671,public,usertable,1,0,76183,565650,128525,6938,8752,1787,119773,15150,144215,128525,,,,,0,0,0,0
1650436528.2351153,public.usertable,120032,15268,157081600,16671,public,usertable,1,0,76937,569342,128848,6997,8816,1806,120032,15268,144661,128848,,,,,0,0,0,0
1650436529.2658594,public.usertable,120286,15392,157532160,16671,public,usertable,1,0,77774,573753,129178,7052,8892,1825,120286,15392,145122,129178,,,,,0,0,0,0
1650436530.2962017,public.usertable,120543,15506,157958144,16671,public,usertable,1,0,78540,578640,129498,7106,8955,1840,120543,15506,145559,129498,,,,,0,0,0,0
1650436531.3251061,public.usertable,120798,15623,158375936,16671,public,usertable,1,0,79344,582591,129813,7169,9015,1864,120798,15623,145997,129813,,,,,0,0,0,0
1650436532.3556473,public.usertable,121039,15743,158769152,16671,public,usertable,1,0,80156,586066,130124,7223,9085,1897,121039,15743,146432,130124,,,,,0,0,0,0
1650436533.3848896,public.usertable,121281,15873,159203328,16671,public,usertable,1,0,81016,587579,130431,7289,9150,1925,121281,15873,146870,130431,,,,,0,0,0,0
1650436534.4136004,public.usertable,121655,16033,159621120,16671,public,usertable,1,0,82324,595022,130911,7364,9256,1949,121655,16033,147531,130911,,,,,0,0,0,0
1650436535.4434888,public.usertable,121891,16175,160063488,16671,public,usertable,1,0,83213,598260,131231,7426,9340,1971,121891,16175,147997,131231,,,,,0,0,0,0
1650436536.4752524,public.usertable,122159,16285,160497664,16671,public,usertable,1,0,84038,605238,131565,7481,9406,1987,122159,16285,148452,131565,,,,,0,0,0,0
1650436537.506322,public.usertable,122393,16414,160915456,16671,public,usertable,1,0,84816,607685,131877,7534,9484,2005,122393,16414,148895,131877,,,,,0,0,0,0
1650436538.5355241,public.usertable,122635,16529,161341440,16671,public,usertable,1,0,85584,611847,132189,7587,9554,2022,122635,16529,149330,132189,,,,,0,0,0,0
1650436539.5644042,public.usertable,122916,16645,161808384,16671,public,usertable,1,0,86404,615926,132534,7642,9618,2045,122916,16645,149794,132534,,,,,0,0,0,0
1650436540.5926669,public.usertable,123206,16754,162250752,16671,public,usertable,1,0,87217,619192,132881,7696,9675,2064,123206,16754,150252,132881,,,,,0,0,0,0
1650436541.6235774,public.usertable,123443,16885,162668544,16671,public,usertable,1,0,88026,622225,133203,7747,9760,2086,123443,16885,150710,133203,,,,,0,0,0,0
1650436542.654214,public.usertable,123662,17014,163061760,16671,public,usertable,1,0,88829,625355,133498,7802,9836,2105,123662,17014,151136,133498,,,,,0,0,0,0
1650436543.6832922,public.usertable,123902,17132,163495936,16671,public,usertable,1,0,89665,631658,133806,7860,9904,2124,123902,17132,151570,133806,,,,,0,0,0,0
1650436544.713551,public.usertable,124179,17243,163946496,16671,public,usertable,1,0,90564,636385,134144,7917,9965,2141,124179,17243,152026,134144,,,,,0,0,0,0
1650436545.7426374,public.usertable,124434,17367,164380672,16671,public,usertable,1,0,91590,640790,134474,7973,10040,2159,124434,17367,152487,134474,,,,,0,0,0,0
1650436546.7729182,public.usertable,124674,17499,164806656,16671,public,usertable,1,0,92509,644697,134796,8032,10122,2182,124674,17499,152950,134796,,,,,0,0,0,0
1650436547.8024697,public.usertable,124938,17617,165232640,16671,public,usertable,1,0,93407,647936,135134,8084,10196,2206,124938,17617,153414,135134,,,,,0,0,0,0
1650436548.8321116,public.usertable,125145,17759,165666816,16671,public,usertable,1,0,94210,653184,135429,8145,10284,2231,125145,17759,153858,135429,,,,,0,0,0,0
1650436549.8626268,public.usertable,125386,17889,166060032,16671,public,usertable,1,0,95086,656578,135748,8201,10362,2250,125386,17889,154311,135748,,,,,0,0,0,0
1650436550.8914695,public.usertable,125611,18018,166461440,16671,public,usertable,1,0,95927,661134,136043,8265,10432,2275,125611,18018,154740,136043,,,,,0,0,0,0
1650436551.9227297,public.usertable,125847,18136,166895616,16671,public,usertable,1,0,96706,665062,136350,8327,10503,2298,125847,18136,155180,136350,,,,,0,0,0,0
1650436552.95257,public.usertable,126086,18255,167313408,16671,public,usertable,1,0,97501,668002,136649,8388,10563,2318,126086,18255,155600,136649,,,,,0,0,0,0
1650436553.9811218,public.usertable,126482,18424,167747584,16671,public,usertable,1,0,98837,674151,137140,8470,10658,2345,126482,18424,156268,137140,,,,,0,0,0,0
1650436555.0115623,public.usertable,126720,18541,168157184,16671,public,usertable,1,0,99697,678698,137450,8524,10730,2368,126720,18541,156704,137450,,,,,0,0,0,0
1650436556.0439482,public.usertable,126965,18639,168583168,16671,public,usertable,1,0,100480,683361,137758,8577,10793,2383,126965,18639,157128,137758,,,,,0,0,0,0
1650436557.0761302,public.usertable,127219,18762,169009152,16671,public,usertable,1,0,101288,686516,138076,8641,10857,2407,127219,18762,157574,138076,,,,,0,0,0,0
1650436558.106176,public.usertable,127437,18892,169410560,16671,public,usertable,1,0,102110,689390,138368,8700,10931,2427,127437,18892,157999,138368,,,,,0,0,0,0
1650436559.1383452,public.usertable,127694,19000,169836544,16671,public,usertable,1,0,102912,693628,138689,8750,10995,2449,127694,19000,158434,138689,,,,,0,0,0,0
1650436560.170557,public.usertable,127928,19109,170229760,16671,public,usertable,1,0,103786,697181,138997,8794,11069,2468,127928,19109,158860,138997,,,,,0,0,0,0
1650436561.19958,public.usertable,128185,19204,170655744,16671,public,usertable,1,0,104580,701135,139305,8847,11120,2487,128185,19204,159272,139305,,,,,0,0,0,0
1650436562.2287874,public.usertable,128454,19302,171065344,16671,public,usertable,1,0,105382,703063,139631,8890,11177,2502,128454,19302,159698,139631,,,,,0,0,0,0
1650436563.259055,public.usertable,128690,19424,171499520,16671,public,usertable,1,0,106283,706322,139945,8943,11255,2517,128690,19424,160143,139945,,,,,0,0,0,0
1650436564.288212,public.usertable,128926,19563,171909120,16671,public,usertable,1,0,107154,710248,140260,9006,11334,2546,128926,19563,160600,140260,,,,,0,0,0,0
1650436565.3190696,public.usertable,129150,19641,172195840,16671,public,usertable,1,0,107813,713322,140528,9043,11378,2557,129150,19641,160949,140528,,,,,0,0,0,0
1650436566.3493912,public.usertable,129329,19702,172507136,16671,public,usertable,1,0,108431,717526,140736,9078,11407,2568,129329,19702,161221,140736,,,,,0,0,0,0
1650436567.37967,public.usertable,129498,19782,172769280,16671,public,usertable,1,0,108973,720603,140953,9112,11455,2582,129498,19782,161520,140953,,,,,0,0,0,0
1650436568.4087696,public.usertable,129637,19864,173031424,16671,public,usertable,1,0,109541,722154,141140,9146,11503,2595,129637,19864,161789,141140,,,,,0,0,0,0
1650436569.440103,public.usertable,129822,19921,173318144,16671,public,usertable,1,0,110047,723689,141356,9180,11534,2605,129822,19921,162070,141356,,,,,0,0,0,0
1650436570.4751666,public.usertable,129976,20007,173588480,16671,public,usertable,1,0,110629,727073,141569,9210,11593,2616,129976,20007,162372,141569,,,,,0,0,0,0
1650436571.5054107,public.usertable,130106,20101,173834240,16671,public,usertable,1,0,111170,729539,141750,9258,11644,2636,130106,20101,162652,141750,,,,,0,0,0,0
1650436572.5361688,public.usertable,130256,20173,174112768,16671,public,usertable,1,0,111637,731375,141936,9298,11680,2651,130256,20173,162914,141936,,,,,0,0,0,0
1650436573.5680304,public.usertable,130506,20299,174399488,16671,public,usertable,1,0,112521,735709,142252,9364,11746,2674,130506,20299,163362,142252,,,,,0,0,0,0
1650436574.5985873,public.usertable,130684,20379,174678016,16671,public,usertable,1,0,113170,739624,142473,9405,11789,2690,130684,20379,163667,142473,,,,,0,0,0,0
1650436575.6264508,public.usertable,130859,20462,174981120,16671,public,usertable,1,0,113720,743670,142705,9433,11846,2706,130859,20462,163984,142705,,,,,0,0,0,0
1650436576.657805,public.usertable,131058,20547,175316992,16671,public,usertable,1,0,114380,745200,142949,9473,11891,2720,131058,20547,164313,142949,,,,,0,0,0,0
1650436577.6897702,public.usertable,131310,20622,175685632,16671,public,usertable,1,0,115083,746814,143243,9512,11933,2735,131310,20622,164688,143243,,,,,0,0,0,0
1650436578.7189891,public.usertable,131554,20718,176087040,16671,public,usertable,1,0,115888,749974,143539,9560,11985,2752,131554,20718,165084,143539,,,,,0,0,0,0
1650436579.748928,public.usertable,131785,20803,176455680,16671,public,usertable,1,0,116553,753856,143815,9610,12030,2773,131785,20803,165455,143815,,,,,0,0,0,0
1650436580.7823112,public.usertable,131994,20914,176816128,16671,public,usertable,1,0,117235,756495,144086,9665,12092,2792,131994,20914,165843,144086,,,,,0,0,0,0
1650436581.813815,public.usertable,132222,21033,177225728,16671,public,usertable,1,0,118075,758768,144377,9725,12155,2810,132222,21033,166257,144377,,,,,0,0,0,0
1650436582.8461862,public.usertable,132470,21144,177643520,16671,public,usertable,1,0,118847,761763,144683,9784,12213,2828,132470,21144,166680,144683,,,,,0,0,0,0
1650436583.8750665,public.usertable,132719,21248,178061312,16671,public,usertable,1,0,119706,767404,144988,9838,12269,2848,132719,21248,167095,144988,,,,,0,0,0,0
1650436584.9077578,public.usertable,132973,21361,178479104,16671,public,usertable,1,0,120578,772384,145303,9896,12330,2870,132973,21361,167529,145303,,,,,0,0,0,0
1650436585.9366503,public.usertable,133234,21470,178937856,16671,public,usertable,1,0,121463,775919,145626,9955,12392,2889,133234,21470,167973,145626,,,,,0,0,0,0
1650436586.9648757,public.usertable,133513,21588,179372032,16671,public,usertable,1,0,122300,779238,145981,10002,12468,2914,133513,21588,168451,145981,,,,,0,0,0,0
1650436587.993771,public.usertable,133752,21707,179781632,16671,public,usertable,1,0,123070,782313,146286,10063,12534,2932,133752,21707,168883,146286,,,,,0,0,0,0
1650436589.0231504,public.usertable,133977,21810,180166656,16671,public,usertable,1,0,123820,787699,146577,10109,12600,2952,133977,21810,169286,146577,,,,,0,0,0,0
1650436590.055476,public.usertable,134237,21914,180600832,16671,public,usertable,1,0,124639,792020,146886,10170,12649,2982,134237,21914,169705,146886,,,,,0,0,0,0
1650436591.0904183,public.usertable,134490,22024,181002240,16671,public,usertable,1,0,125507,795247,147202,10226,12712,3000,134490,22024,170140,147202,,,,,0,0,0,0
1650436592.1210167,public.usertable,134872,22182,181428224,16671,public,usertable,1,0,126771,800460,147668,10308,12796,3026,134872,22182,170772,147668,,,,,0,0,0,0
1650436593.152372,public.usertable,135126,22305,181870592,16671,public,usertable,1,0,127615,802634,147995,10359,12869,3041,135126,22305,171223,147995,,,,,0,0,0,0
1650436594.1833124,public.usertable,135363,22432,182288384,16671,public,usertable,1,0,128541,805125,148307,10419,12944,3062,135363,22432,171670,148307,,,,,0,0,0,0
1650436595.2123978,public.usertable,135598,22555,182706176,16671,public,usertable,1,0,129463,810384,148618,10477,13020,3083,135598,22555,172115,148618,,,,,0,0,0,0
1650436596.2475066,public.usertable,135858,22680,183164928,16671,public,usertable,1,0,130456,813333,148951,10533,13093,3101,135858,22680,172577,148951,,,,,0,0,0,0
1650436597.276726,public.usertable,136140,22800,183640064,16671,public,usertable,1,0,131390,819730,149304,10592,13164,3117,136140,22800,173060,149304,,,,,0,0,0,0
1650436598.3064275,public.usertable,136393,22919,184074240,16671,public,usertable,1,0,132264,822842,149638,10638,13245,3133,136393,22919,173521,149638,,,,,0,0,0,0
1650436599.336027,public.usertable,136657,23033,184508416,16671,public,usertable,1,0,133195,825918,149969,10689,13312,3152,136657,23033,173970,149969,,,,,0,0,0,0
1650436600.3644733,public.usertable,136943,23131,184958976,16671,public,usertable,1,0,134075,830433,150311,10739,13368,3172,136943,23131,174418,150311,,,,,0,0,0,0
1650436601.3972218,public.usertable,137223,23241,185417728,16671,public,usertable,1,0,134988,834273,150640,10805,13417,3192,137223,23241,174862,150640,,,,,0,0,0,0
1650436602.4290252,public.usertable,137477,23370,185860096,16671,public,usertable,1,0,135970,837811,150969,10866,13492,3213,137477,23370,175327,150969,,,,,0,0,0,0
1650436603.4582996,public.usertable,137762,23489,186318848,16671,public,usertable,1,0,136910,841369,151313,10928,13551,3238,137762,23489,175792,151313,,,,,0,0,0,0
1650436604.4874742,public.usertable,138015,23583,186712064,16671,public,usertable,1,0,137654,844355,151625,10970,13610,3254,138015,23583,176205,151625,,,,,0,0,0,0
1650436605.5161257,public.usertable,138275,23678,187162624,16671,public,usertable,1,0,138483,849033,151948,11018,13673,3273,138275,23678,176639,151948,,,,,0,0,0,0
1650436606.5449317,public.usertable,138541,23797,187588608,16671,public,usertable,1,0,139322,850851,152272,11083,13731,3295,138541,23797,177086,152272,,,,,0,0,0,0
1650436607.5748782,public.usertable,138822,23892,188030976,16671,public,usertable,1,0,140286,855436,152611,11132,13789,3316,138822,23892,177532,152611,,,,,0,0,0,0
1650436608.604832,public.usertable,139098,23992,188456960,16671,public,usertable,1,0,141105,859971,152952,11170,13854,3327,139098,23992,177976,152952,,,,,0,0,0,0
1650436609.6353214,public.usertable,139483,24160,188882944,16671,public,usertable,1,0,142368,863998,153436,11245,13953,3361,139483,24160,178634,153436,,,,,0,0,0,0
1650436610.6659591,public.usertable,139720,24291,189300736,16671,public,usertable,1,0,143167,865544,153749,11301,14029,3379,139720,24291,179079,153749,,,,,0,0,0,0
1650436611.6958992,public.usertable,139979,24410,189743104,16671,public,usertable,1,0,144069,868253,154079,11354,14100,3397,139979,24410,179533,154079,,,,,0,0,0,0
1650436612.7251441,public.usertable,140252,24511,190160896,16671,public,usertable,1,0,144973,870420,154402,11408,14150,3419,140252,24511,179960,154402,,,,,0,0,0,0
1650436613.755422,public.usertable,140509,24631,190595072,16671,public,usertable,1,0,145804,872107,154729,11460,14220,3439,140509,24631,180409,154729,,,,,0,0,0,0
1650436614.7838128,public.usertable,140782,24727,191037440,16671,public,usertable,1,0,146682,875461,155058,11507,14276,3454,140782,24727,180841,155058,,,,,0,0,0,0
1650436615.8132093,public.usertable,141048,24837,191471616,16671,public,usertable,1,0,147610,880415,155385,11567,14337,3474,141048,24837,181289,155385,,,,,0,0,0,0
1650436616.8459127,public.usertable,141305,24948,191905792,16671,public,usertable,1,0,148530,884719,155707,11624,14402,3493,141305,24948,181733,155707,,,,,0,0,0,0
1650436617.8754714,public.usertable,141574,25054,192348160,16671,public,usertable,1,0,149460,887611,156046,11664,14472,3508,141574,25054,182182,156046,,,,,0,0,0,0
1650436618.9092996,public.usertable,141836,25156,192765952,16671,public,usertable,1,0,150369,890443,156368,11714,14532,3528,141836,25156,182614,156368,,,,,0,0,0,0
1650436619.9419994,public.usertable,142095,25254,193191936,16671,public,usertable,1,0,151231,892963,156680,11771,14585,3549,142095,25254,183036,156680,,,,,0,0,0,0
1650436620.9711363,public.usertable,142365,25339,193617920,16671,public,usertable,1,0,152032,897648,157010,11818,14645,3567,142365,25339,183473,157010,,,,,0,0,0,0
1650436622.002103,public.usertable,142632,25434,194052096,16671,public,usertable,1,0,152811,903129,157334,11860,14702,3580,142632,25434,183896,157334,,,,,0,0,0,0
1650436623.0315986,public.usertable,142912,25524,194494464,16671,public,usertable,1,0,153737,908696,157658,11914,14746,3594,142912,25524,184318,157658,,,,,0,0,0,0
1650436624.0657833,public.usertable,143189,25644,194945024,16671,public,usertable,1,0,154662,911354,157993,11984,14804,3620,143189,25644,184781,157993,,,,,0,0,0,0
1650436625.096421,public.usertable,143449,25752,195387392,16671,public,usertable,1,0,155499,913890,158320,12032,14871,3642,143449,25752,185223,158320,,,,,0,0,0,0
1650436626.13107,public.usertable,143717,25874,195846144,16671,public,usertable,1,0,156434,917117,158659,12087,14942,3658,143717,25874,185688,158659,,,,,0,0,0,0
1650436627.1633828,public.usertable,144016,25986,196296704,16671,public,usertable,1,0,157362,920683,159021,12141,15005,3673,144016,25986,186167,159021,,,,,0,0,0,0
1650436628.193973,public.usertable,144452,26124,196763648,16671,public,usertable,1,0,158638,926412,159537,12221,15085,3707,144452,26124,186843,159537,,,,,0,0,0,0
1650436629.2271905,public.usertable,144717,26234,197197824,16671,public,usertable,1,0,159500,929444,159862,12275,15145,3729,144717,26234,187282,159862,,,,,0,0,0,0
1650436630.2575896,public.usertable,144989,26324,197615616,16671,public,usertable,1,0,160443,933755,160191,12319,15202,3751,144989,26324,187712,160191,,,,,0,0,0,0
1650436631.2859635,public.usertable,145270,26425,198066176,16671,public,usertable,1,0,161423,939549,160538,12363,15268,3771,145270,26425,188169,160538,,,,,0,0,0,0
1650436632.3200974,public.usertable,145544,26525,198500352,16671,public,usertable,1,0,162271,941373,160865,12416,15321,3792,145544,26525,188602,160865,,,,,0,0,0,0
1650436633.3494682,public.usertable,145826,26610,198942720,16671,public,usertable,1,0,163143,945976,161209,12450,15383,3802,145826,26610,189042,161209,,,,,0,0,0,0
1650436634.3798654,public.usertable,146087,26723,199376896,16671,public,usertable,1,0,164049,949981,161539,12500,15452,3819,146087,26723,189491,161539,,,,,0,0,0,0
1650436635.4116414,public.usertable,146331,26825,199778304,16671,public,usertable,1,0,164951,955002,161849,12540,15518,3838,146331,26825,189907,161849,,,,,0,0,0,0
1650436636.440498,public.usertable,146599,26914,200212480,16671,public,usertable,1,0,165772,957251,162172,12580,15573,3851,146599,26914,190325,162172,,,,,0,0,0,0
1650436637.470722,public.usertable,146840,27026,200630272,16671,public,usertable,1,0,166713,962092,162490,12625,15650,3862,146840,27026,190765,162490,,,,,0,0,0,0
1650436638.501166,public.usertable,147107,27131,201056256,16671,public,usertable,1,0,167645,964934,162816,12674,15709,3883,147107,27131,191199,162816,,,,,0,0,0,0
1650436639.5316615,public.usertable,147377,27229,201474048,16671,public,usertable,1,0,168480,968894,163147,12715,15770,3903,147377,27229,191632,163147,,,,,0,0,0,0
1650436640.5595577,public.usertable,147627,27330,201867264,16671,public,usertable,1,0,169316,973360,163464,12753,15837,3918,147627,27330,192054,163464,,,,,0,0,0,0
1650436641.5908794,public.usertable,147903,27407,202309632,16671,public,usertable,1,0,170146,975836,163786,12794,15883,3935,147903,27407,192463,163786,,,,,0,0,0,0
1650436642.619577,public.usertable,148172,27493,202727424,16671,public,usertable,1,0,170904,979198,164104,12838,15932,3953,148172,27493,192874,164104,,,,,0,0,0,0
1650436643.6488645,public.usertable,148445,27571,203137024,16671,public,usertable,1,0,171733,984075,164431,12873,15986,3971,148445,27571,193290,164431,,,,,0,0,0,0
1650436644.6778715,public.usertable,148717,27681,203579392,16671,public,usertable,1,0,172589,989177,164762,12931,16045,3992,148717,27681,193738,164762,,,,,0,0,0,0
1650436645.7090902,public.usertable,149137,27818,204005376,16671,public,usertable,1,0,173810,993074,165266,12988,16129,4018,149137,27818,194383,165266,,,,,0,0,0,0
1650436646.7455492,public.usertable,149403,27928,204447744,16671,public,usertable,1,0,174776,997462,165599,13042,16196,4043,149403,27928,194837,165599,,,,,0,0,0,0
1650436647.7757835,public.usertable,149653,28020,204832768,16671,public,usertable,1,0,175615,1000075,165911,13080,16258,4059,149653,28020,195249,165911,,,,,0,0,0,0
1650436648.804413,public.usertable,149888,28131,205234176,16671,public,usertable,1,0,176453,1003276,166212,13128,16324,4081,149888,28131,195664,166212,,,,,0,0,0,0
1650436649.8333673,public.usertable,150149,28212,205643776,16671,public,usertable,1,0,177200,1009515,166522,13173,16373,4097,150149,28212,196068,166522,,,,,0,0,0,0
1650436650.8629403,public.usertable,150439,28305,206086144,16671,public,usertable,1,0,178082,1011621,166862,13217,16423,4118,150439,28305,196502,166862,,,,,0,0,0,0
1650436651.892903,public.usertable,150724,28378,206512128,16671,public,usertable,1,0,178853,1014429,167197,13257,16473,4137,150724,28378,196927,167197,,,,,0,0,0,0
1650436652.9229436,public.usertable,151022,28462,206954496,16671,public,usertable,1,0,179701,1017016,167543,13299,16521,4150,151022,28462,197363,167543,,,,,0,0,0,0
1650436653.9531538,public.usertable,151290,28563,207380480,16671,public,usertable,1,0,180616,1019824,167869,13344,16579,4170,151290,28563,197792,167869,,,,,0,0,0,0
1650436654.982294,public.usertable,151569,28672,207814656,16671,public,usertable,1,0,181479,1021881,168206,13400,16637,4193,151569,28672,198243,168206,,,,,0,0,0,0
1650436656.0112994,public.usertable,151834,28750,208232448,16671,public,usertable,1,0,182286,1024491,168519,13436,16685,4207,151834,28750,198640,168519,,,,,0,0,0,0
1650436657.0428798,public.usertable,152070,28875,208658432,16671,public,usertable,1,0,183229,1026291,168835,13487,16765,4226,152070,28875,199087,168835,,,,,0,0,0,0
1650436658.0733,public.usertable,152332,28957,209059840,16671,public,usertable,1,0,184059,1031112,169150,13528,16818,4237,152332,28957,199496,169150,,,,,0,0,0,0
1650436659.104043,public.usertable,152555,29087,209461248,16671,public,usertable,1,0,185080,1033192,169449,13587,16894,4257,152555,29087,199930,169449,,,,,0,0,0,0
1650436660.133768,public.usertable,152823,29193,209911808,16671,public,usertable,1,0,186011,1036102,169771,13645,16948,4284,152823,29193,200364,169771,,,,,0,0,0,0
1650436661.1629112,public.usertable,153092,29324,210337792,16671,public,usertable,1,0,187061,1041557,170109,13715,17017,4316,153092,29324,200841,170109,,,,,0,0,0,0
1650436662.1927516,public.usertable,153348,29440,210796544,16671,public,usertable,1,0,187971,1044528,170434,13767,17086,4331,153348,29440,201287,170434,,,,,0,0,0,0
1650436663.2218006,public.usertable,153662,29528,211271680,16671,public,usertable,1,0,188898,1049103,170807,13805,17145,4348,153662,29528,201757,170807,,,,,0,0,0,0
1650436664.2514353,public.usertable,154133,29706,211804160,16671,public,usertable,1,0,190497,1053905,171388,13887,17255,4377,154133,29706,202530,171388,,,,,0,0,0,0
1650436665.2823987,public.usertable,154446,29815,212271104,16671,public,usertable,1,0,191426,1056433,171766,13936,17320,4395,154446,29815,203022,171766,,,,,0,0,0,0
1650436666.314985,public.usertable,154743,29903,212721664,16671,public,usertable,1,0,192257,1060177,172112,13980,17369,4414,154743,29903,203461,172112,,,,,0,0,0,0
1650436667.3440616,public.usertable,154904,29973,212983808,16671,public,usertable,1,0,192848,1062452,172321,14007,17417,4426,154904,29973,203745,172321,,,,,0,0,0,0
1650436668.3745868,public.usertable,155070,30031,213254144,16671,public,usertable,1,0,193379,1065924,172519,14034,17449,4436,155070,30031,204002,172519,,,,,0,0,0,0
1650436669.4075437,public.usertable,155278,30131,213606400,16671,public,usertable,1,0,194125,1067428,172789,14074,17511,4451,155278,30131,204374,172789,,,,,0,0,0,0
1650436670.4406607,public.usertable,155461,30207,213901312,16671,public,usertable,1,0,194753,1070618,173017,14107,17556,4465,155461,30207,204680,173017,,,,,0,0,0,0
1650436671.4693682,public.usertable,155629,30291,214188032,16671,public,usertable,1,0,195414,1072875,173245,14132,17616,4476,155629,30291,204993,173245,,,,,0,0,0,0
1650436672.4992104,public.usertable,155839,30357,214499328,16671,public,usertable,1,0,196091,1074357,173494,14161,17655,4490,155839,30357,205310,173494,,,,,0,0,0,0
1650436673.5298805,public.usertable,156048,30428,214827008,16671,public,usertable,1,0,196770,1076289,173743,14197,17695,4506,156048,30428,205635,173743,,,,,0,0,0,0
1650436674.5577216,public.usertable,156261,30502,215162880,16671,public,usertable,1,0,197463,1079381,173996,14236,17735,4520,156261,30502,205967,173996,,,,,0,0,0,0
1650436675.586999,public.usertable,156502,30589,215580672,16671,public,usertable,1,0,198192,1080934,174287,14276,17785,4532,156502,30589,206348,174287,,,,,0,0,0,0
1650436676.6178205,public.usertable,156818,30661,216047616,16671,public,usertable,1,0,199020,1085401,174648,14316,17830,4549,156818,30661,206794,174648,,,,,0,0,0,0
1650436677.6479576,public.usertable,157100,30750,216465408,16671,public,usertable,1,0,199862,1089943,174989,14354,17889,4565,157100,30750,207232,174989,,,,,0,0,0,0
1650436678.6845865,public.usertable,157357,30834,216866816,16671,public,usertable,1,0,200672,1094110,175294,14396,17937,4584,157357,30834,207627,175294,,,,,0,0,0,0
1650436679.7186298,public.usertable,157618,30917,217260032,16671,public,usertable,1,0,201547,1098999,175616,14422,17998,4598,157618,30917,208036,175616,,,,,0,0,0,0
1650436680.7475114,public.usertable,157885,31005,217669632,16671,public,usertable,1,0,202459,1102453,175944,14456,18059,4609,157885,31005,208459,175944,,,,,0,0,0,0
1650436681.7764647,public.usertable,158117,31112,218071040,16671,public,usertable,1,0,203323,1104660,176233,14508,18116,4631,158117,31112,208857,176233,,,,,0,0,0,0
1650436682.8057523,public.usertable,158376,31187,218480640,16671,public,usertable,1,0,204083,1107036,176547,14539,18171,4641,158376,31187,209257,176547,,,,,0,0,0,0
1650436683.8342419,public.usertable,158633,31287,218898432,16671,public,usertable,1,0,204898,1109752,176863,14586,18230,4657,158633,31287,209679,176863,,,,,0,0,0,0
1650436684.862237,public.usertable,159021,31425,219291648,16671,public,usertable,1,0,206237,1112933,177330,14654,18309,4688,159021,31425,210293,177330,,,,,0,0,0,0
1650436685.8917987,public.usertable,159319,31506,219742208,16671,public,usertable,1,0,207148,1117207,177672,14700,18353,4701,159319,31506,210725,177672,,,,,0,0,0,0
1650436686.9234176,public.usertable,159566,31599,220135424,16671,public,usertable,1,0,207973,1119077,177975,14745,18409,4717,159566,31599,211129,177975,,,,,0,0,0,0
1650436687.9533098,public.usertable,159808,31670,220487680,16671,public,usertable,1,0,208659,1120803,178252,14787,18444,4736,159808,31670,211483,178252,,,,,0,0,0,0
1650436688.9833746,public.usertable,160035,31758,220872704,16671,public,usertable,1,0,209363,1124227,178535,14820,18500,4749,160035,31758,211855,178535,,,,,0,0,0,0
1650436690.011604,public.usertable,160253,31846,221200384,16671,public,usertable,1,0,210150,1125930,178811,14852,18558,4763,160253,31846,212221,178811,,,,,0,0,0,0
1650436691.0417042,public.usertable,160453,31916,221511680,16671,public,usertable,1,0,210778,1127345,179055,14879,18602,4775,160453,31916,212536,179055,,,,,0,0,0,0
1650436692.075532,public.usertable,160665,31972,221822976,16671,public,usertable,1,0,211366,1128535,179290,14914,18625,4791,160665,31972,212829,179290,,,,,0,0,0,0
1650436693.1044588,public.usertable,160888,32038,222167040,16671,public,usertable,1,0,212067,1131992,179561,14943,18673,4799,160888,32038,213177,179561,,,,,0,0,0,0
1650436694.134668,public.usertable,161084,32122,222511104,16671,public,usertable,1,0,212790,1135902,179809,14985,18725,4820,161084,32122,213519,179809,,,,,0,0,0,0
1650436695.165281,public.usertable,161345,32202,222904320,16671,public,usertable,1,0,213623,1138588,180122,15022,18777,4840,161345,32202,213921,180122,,,,,0,0,0,0
1650436696.1963692,public.usertable,161594,32287,223272960,16671,public,usertable,1,0,214431,1141723,180422,15063,18828,4855,161594,32287,214313,180422,,,,,0,0,0,0
1650436697.225923,public.usertable,161810,32361,223649792,16671,public,usertable,1,0,215131,1144676,180683,15095,18873,4861,161810,32361,214651,180683,,,,,0,0,0,0
1650436698.2541041,public.usertable,162062,32465,224059392,16671,public,usertable,1,0,215941,1147991,180986,15152,18924,4886,162062,32465,215062,180986,,,,,0,0,0,0
1650436699.2831044,public.usertable,162322,32549,224468992,16671,public,usertable,1,0,216723,1150067,181300,15189,18978,4899,162322,32549,215467,181300,,,,,0,0,0,0
1650436700.315354,public.usertable,162571,32663,224903168,16671,public,usertable,1,0,217633,1153301,181612,15241,19041,4917,162571,32663,215894,181612,,,,,0,0,0,0
1650436701.3462088,public.usertable,162871,32741,225329152,16671,public,usertable,1,0,218530,1155771,181968,15276,19097,4933,162871,32741,216341,181968,,,,,0,0,0,0
1650436702.3760903,public.usertable,163123,32834,225738752,16671,public,usertable,1,0,219392,1157879,182272,15317,19149,4946,163123,32834,216738,182272,,,,,0,0,0,0
1650436703.40683,public.usertable,163500,32972,226115584,16671,public,usertable,1,0,220597,1162416,182723,15390,19223,4979,163500,32972,217336,182723,,,,,0,0,0,0
1650436704.4387233,public.usertable,163777,33073,226549760,16671,public,usertable,1,0,221495,1164124,183049,15444,19272,5003,163777,33073,217765,183049,,,,,0,0,0,0
1650436705.4705536,public.usertable,164056,33157,226975744,16671,public,usertable,1,0,222388,1168213,183378,15493,19322,5022,164056,33157,218193,183378,,,,,0,0,0,0
1650436706.5017319,public.usertable,164341,33257,227426304,16671,public,usertable,1,0,223348,1170756,183725,15537,19384,5041,164341,33257,218646,183725,,,,,0,0,0,0
1650436707.530843,public.usertable,164618,33354,227868672,16671,public,usertable,1,0,224248,1173539,184063,15585,19445,5064,164618,33354,219093,184063,,,,,0,0,0,0
1650436708.5620747,public.usertable,164872,33440,228253696,16671,public,usertable,1,0,225005,1177585,184369,15626,19497,5085,164872,33440,219492,184369,,,,,0,0,0,0
1650436709.5934584,public.usertable,165168,33539,228696064,16671,public,usertable,1,0,225876,1179199,184715,15676,19547,5110,165168,33539,219938,184715,,,,,0,0,0,0
1650436710.6236455,public.usertable,165444,33612,229130240,16671,public,usertable,1,0,226809,1182912,185037,15717,19593,5123,165444,33612,220347,185037,,,,,0,0,0,0
1650436711.6537466,public.usertable,165729,33692,229539840,16671,public,usertable,1,0,227706,1185870,185371,15755,19642,5139,165729,33692,220768,185371,,,,,0,0,0,0
1650436712.682522,public.usertable,165941,33765,229883904,16671,public,usertable,1,0,228395,1188474,185639,15787,19698,5152,165941,33765,221124,185639,,,,,0,0,0,0
1650436713.7114325,public.usertable,166161,33869,230252544,16671,public,usertable,1,0,229272,1191728,185930,15829,19769,5170,166161,33869,221528,185930,,,,,0,0,0,0
1650436714.7397006,public.usertable,166417,33962,230678528,16671,public,usertable,1,0,230160,1193933,186237,15874,19820,5187,166417,33962,221931,186237,,,,,0,0,0,0
1650436715.7707887,public.usertable,166671,34049,231063552,16671,public,usertable,1,0,230996,1196143,186545,15910,19874,5204,166671,34049,222329,186545,,,,,0,0,0,0
1650436716.801594,public.usertable,166928,34132,231456768,16671,public,usertable,1,0,231809,1199758,186859,15939,19931,5216,166928,34132,222729,186859,,,,,0,0,0,0
1650436717.83244,public.usertable,167183,34225,231874560,16671,public,usertable,1,0,232697,1203145,187168,15982,19985,5232,167183,34225,223135,187168,,,,,0,0,0,0
1650436718.8611176,public.usertable,167474,34295,232316928,16671,public,usertable,1,0,233510,1205738,187508,16015,20034,5243,167474,34295,223557,187508,,,,,0,0,0,0
1650436719.8924463,public.usertable,167759,34383,232718336,16671,public,usertable,1,0,234372,1208003,187842,16058,20083,5259,167759,34383,223983,187842,,,,,0,0,0,0
1650436720.9219518,public.usertable,168009,34476,233127936,16671,public,usertable,1,0,235296,1211028,188156,16096,20147,5276,168009,34476,224399,188156,,,,,0,0,0,0
1650436721.9514828,public.usertable,168270,34553,233562112,16671,public,usertable,1,0,236218,1214913,188472,16128,20202,5287,168270,34553,224802,188472,,,,,0,0,0,0
1650436722.9800897,public.usertable,168645,34704,233955328,16671,public,usertable,1,0,237628,1218883,188938,16200,20293,5320,168645,34704,225431,188938,,,,,0,0,0,0
1650436724.011803,public.usertable,168905,34792,234356736,16671,public,usertable,1,0,238438,1221762,189248,16243,20343,5339,168905,34792,225834,189248,,,,,0,0,0,0
1650436725.042248,public.usertable,169188,34866,234774528,16671,public,usertable,1,0,239345,1225195,189573,16279,20385,5354,169188,34866,226237,189573,,,,,0,0,0,0
1650436726.0718377,public.usertable,169453,34941,235167744,16671,public,usertable,1,0,240195,1227837,189880,16314,20427,5370,169453,34941,226621,189880,,,,,0,0,0,0
1650436727.100426,public.usertable,169701,35024,235536384,16671,public,usertable,1,0,240970,1231176,190172,16356,20471,5388,169701,35024,226999,190172,,,,,0,0,0,0
1650436728.1309094,public.usertable,169954,35115,235937792,16671,public,usertable,1,0,241791,1233769,190479,16401,20525,5408,169954,35115,227405,190479,,,,,0,0,0,0
1650436729.1611466,public.usertable,170213,35202,236363776,16671,public,usertable,1,0,242655,1236135,190788,16443,20575,5424,170213,35202,227806,190788,,,,,0,0,0,0
1650436730.1917603,public.usertable,170495,35287,236773376,16671,public,usertable,1,0,243555,1238415,191112,16489,20617,5438,170495,35287,228218,191112,,,,,0,0,0,0
1650436731.2211351,public.usertable,170770,35380,237215744,16671,public,usertable,1,0,244396,1240949,191456,16518,20686,5451,170770,35380,228660,191456,,,,,0,0,0,0
1650436732.2514832,public.usertable,171061,35465,237633536,16671,public,usertable,1,0,245263,1242534,191797,16556,20736,5466,171061,35465,229089,191797,,,,,0,0,0,0
1650436733.281016,public.usertable,171325,35526,238026752,16671,public,usertable,1,0,246015,1245704,192097,16598,20772,5486,171325,35526,229467,192097,,,,,0,0,0,0
1650436734.3112128,public.usertable,171594,35597,238444544,16671,public,usertable,1,0,246810,1249569,192416,16630,20822,5501,171594,35597,229868,192416,,,,,0,0,0,0
1650436735.3412578,public.usertable,171895,35661,238837760,16671,public,usertable,1,0,247649,1252311,192758,16664,20863,5522,171895,35661,230285,192758,,,,,0,0,0,0
1650436736.3714895,public.usertable,172131,35754,239247360,16671,public,usertable,1,0,248485,1254818,193049,16706,20918,5541,172131,35754,230673,193049,,,,,0,0,0,0
1650436737.400295,public.usertable,172397,35861,239681536,16671,public,usertable,1,0,249386,1256328,193380,16749,20983,5556,172397,35861,231112,193380,,,,,0,0,0,0
1650436738.4290414,public.usertable,172688,35949,240107520,16671,public,usertable,1,0,250235,1259830,193724,16789,21036,5571,172688,35949,231549,193724,,,,,0,0,0,0
1650436739.4615142,public.usertable,172946,36051,240525312,16671,public,usertable,1,0,251154,1261340,194048,16828,21102,5583,172946,36051,231978,194048,,,,,0,0,0,0
1650436740.4930503,public.usertable,173210,36147,240967680,16671,public,usertable,1,0,251980,1263145,194369,16869,21159,5601,173210,36147,232397,194369,,,,,0,0,0,0
1650436741.5239413,public.usertable,173642,36256,241393664,16671,public,usertable,1,0,253232,1266440,194870,16920,21228,5615,173642,36256,233018,194870,,,,,0,0,0,0
1650436742.552775,public.usertable,173874,36351,241762304,16671,public,usertable,1,0,254059,1269137,195159,16961,21285,5631,173874,36351,233405,195159,,,,,0,0,0,0
1650436743.583857,public.usertable,174141,36434,242171904,16671,public,usertable,1,0,254916,1272165,195474,17001,21333,5651,174141,36434,233808,195474,,,,,0,0,0,0
1650436744.6124744,public.usertable,174430,36513,242597888,16671,public,usertable,1,0,255715,1275629,195810,17037,21380,5668,174430,36513,234227,195810,,,,,0,0,0,0
1650436745.6414852,public.usertable,174723,36596,243048448,16671,public,usertable,1,0,256651,1279695,196163,17074,21440,5684,174723,36596,234677,196163,,,,,0,0,0,0
1650436746.6711166,public.usertable,175029,36693,243515392,16671,public,usertable,1,0,257606,1281706,196522,17119,21493,5705,175029,36693,235134,196522,,,,,0,0,0,0
1650436747.7005873,public.usertable,175343,36768,243965952,16671,public,usertable,1,0,258523,1283868,196885,17154,21542,5724,175343,36768,235581,196885,,,,,0,0,0,0
1650436748.7301226,public.usertable,175639,36856,244416512,16671,public,usertable,1,0,259488,1288048,197240,17193,21601,5739,175639,36856,236034,197240,,,,,0,0,0,0
1650436749.7590044,public.usertable,175920,36955,244858880,16671,public,usertable,1,0,260424,1290783,197578,17242,21658,5762,175920,36955,236478,197578,,,,,0,0,0,0
1650436750.7901127,public.usertable,176237,37042,245325824,16671,public,usertable,1,0,261282,1294463,197942,17289,21705,5788,176237,37042,236936,197942,,,,,0,0,0,0
1650436751.8203235,public.usertable,176528,37138,245768192,16671,public,usertable,1,0,262208,1297833,198294,17334,21766,5812,176528,37138,237394,198294,,,,,0,0,0,0
1650436752.8496485,public.usertable,176804,37252,246202368,16671,public,usertable,1,0,263089,1299767,198637,17381,21833,5832,176804,37252,237851,198637,,,,,0,0,0,0
1650436753.8789463,public.usertable,177087,37341,246644736,16671,public,usertable,1,0,264015,1303881,198973,17429,21886,5856,177087,37341,238288,198973,,,,,0,0,0,0
1650436754.9075658,public.usertable,177362,37435,247087104,16671,public,usertable,1,0,265058,1307036,199311,17467,21949,5877,177362,37435,238727,199311,,,,,0,0,0,0
1650436755.9392612,public.usertable,177691,37520,247554048,16671,public,usertable,1,0,265993,1309934,199685,17512,21994,5894,177691,37520,239191,199685,,,,,0,0,0,0
1650436756.969356,public.usertable,177995,37617,248020992,16671,public,usertable,1,0,266784,1312606,200045,17555,22050,5914,177995,37617,239650,200045,,,,,0,0,0,0
1650436758.004444,public.usertable,178276,37690,248438784,16671,public,usertable,1,0,267653,1314040,200375,17588,22099,5930,178276,37690,240062,200375,,,,,0,0,0,0
1650436759.0342622,public.usertable,178570,37785,248872960,16671,public,usertable,1,0,268611,1316728,200726,17632,22156,5952,178570,37785,240514,200726,,,,,0,0,0,0
1650436760.0647511,public.usertable,178982,37905,249298944,16671,public,usertable,1,0,269880,1320984,201223,17676,22241,5968,178982,37905,241140,201223,,,,,0,0,0,0
1650436761.0941837,public.usertable,179278,37987,249724928,16671,public,usertable,1,0,270747,1322870,201569,17711,22291,5989,179278,37987,241571,201569,,,,,0,0,0,0
1650436762.1234932,public.usertable,179575,38063,250150912,16671,public,usertable,1,0,271688,1327517,201902,17757,22327,6009,179575,38063,241986,201902,,,,,0,0,0,0
1650436763.1536865,public.usertable,179837,38142,250560512,16671,public,usertable,1,0,272585,1330841,202217,17792,22380,6024,179837,38142,242389,202217,,,,,0,0,0,0
1650436764.184436,public.usertable,180108,38223,250978304,16671,public,usertable,1,0,273513,1334354,202542,17830,22434,6044,180108,38223,242806,202542,,,,,0,0,0,0
1650436765.2170002,public.usertable,180393,38308,251404288,16671,public,usertable,1,0,274360,1336618,202878,17865,22485,6056,180393,38308,243228,202878,,,,,0,0,0,0
1650436766.2471807,public.usertable,180692,38409,251871232,16671,public,usertable,1,0,275272,1339200,203237,17912,22545,6079,180692,38409,243694,203237,,,,,0,0,0,0
1650436767.2763932,public.usertable,181018,38498,252362752,16671,public,usertable,1,0,276205,1341539,203616,17953,22598,6094,181018,38498,244167,203616,,,,,0,0,0,0
1650436768.3071635,public.usertable,181312,38580,252788736,16671,public,usertable,1,0,277068,1345024,203956,17993,22644,6111,181312,38580,244593,203956,,,,,0,0,0,0
1650436769.3377528,public.usertable,181597,38664,253239296,16671,public,usertable,1,0,278021,1349552,204296,18036,22699,6127,181597,38664,245031,204296,,,,,0,0,0,0
1650436770.3663793,public.usertable,181919,38738,253689856,16671,public,usertable,1,0,278864,1351790,204668,18064,22749,6139,181919,38738,245481,204668,,,,,0,0,0,0
1650436771.3959463,public.usertable,182192,38819,254115840,16671,public,usertable,1,0,279735,1355405,204985,18107,22793,6154,182192,38819,245885,204985,,,,,0,0,0,0
1650436772.4252775,public.usertable,182482,38902,254541824,16671,public,usertable,1,0,280656,1357631,205321,18149,22839,6175,182482,38902,246309,205321,,,,,0,0,0,0
1650436773.4634988,public.usertable,182789,38996,255000576,16671,public,usertable,1,0,281592,1359854,205681,18192,22892,6193,182789,38996,246765,205681,,,,,0,0,0,0
1650436774.4927716,public.usertable,183082,39072,255442944,16671,public,usertable,1,0,282436,1362799,206026,18225,22944,6212,183082,39072,247195,206026,,,,,0,0,0,0
1650436775.5219946,public.usertable,183375,39166,255901696,16671,public,usertable,1,0,283315,1364072,206371,18271,22996,6233,183375,39166,247638,206371,,,,,0,0,0,0
1650436776.5509083,public.usertable,183678,39263,256368640,16671,public,usertable,1,0,284312,1370151,206728,18324,23050,6252,183678,39263,248102,206728,,,,,0,0,0,0
1650436777.5836885,public.usertable,184003,39347,256835584,16671,public,usertable,1,0,285273,1373310,207093,18375,23090,6277,184003,39347,248558,207093,,,,,0,0,0,0
1650436778.6148696,public.usertable,184477,39461,257294336,16671,public,usertable,1,0,286686,1376731,207627,18440,23150,6303,184477,39461,249217,207627,,,,,0,0,0,0
1650436779.6461701,public.usertable,184799,39536,257761280,16671,public,usertable,1,0,287589,1381298,207993,18480,23194,6316,184799,39536,249667,207993,,,,,0,0,0,0
1650436780.6747818,public.usertable,185083,39621,258195456,16671,public,usertable,1,0,288458,1383756,208323,18524,23240,6334,185083,39621,250087,208323,,,,,0,0,0,0
1650436781.7042546,public.usertable,185371,39695,258621440,16671,public,usertable,1,0,289254,1385162,208659,18554,23288,6350,185371,39695,250501,208659,,,,,0,0,0,0
1650436782.7337556,public.usertable,185680,39762,259055616,16671,public,usertable,1,0,290093,1388692,209009,18589,23329,6362,185680,39762,250927,209009,,,,,0,0,0,0
1650436783.7633393,public.usertable,185980,39840,259514368,16671,public,usertable,1,0,290999,1391249,209361,18622,23381,6376,185980,39840,251364,209361,,,,,0,0,0,0
1650436784.792673,public.usertable,186309,39934,259989504,16671,public,usertable,1,0,292015,1392321,209738,18672,23429,6399,186309,39934,251839,209738,,,,,0,0,0,0
1650436785.8252168,public.usertable,186616,40031,260481024,16671,public,usertable,1,0,293016,1394359,210104,18720,23488,6421,186616,40031,252312,210104,,,,,0,0,0,0
1650436786.856016,public.usertable,186916,40123,260923392,16671,public,usertable,1,0,293974,1397062,210453,18769,23537,6441,186916,40123,252759,210453,,,,,0,0,0,0
1650436787.8864434,public.usertable,187186,40183,261275648,16671,public,usertable,1,0,294704,1397824,210760,18795,23574,6450,187186,40183,253129,210760,,,,,0,0,0,0
1650436788.9187145,public.usertable,187457,40258,261726208,16671,public,usertable,1,0,295439,1401312,211071,18834,23614,6466,187457,40258,253519,211071,,,,,0,0,0,0
1650436789.9478614,public.usertable,187769,40356,262184960,16671,public,usertable,1,0,296505,1403863,211442,18877,23673,6488,187769,40356,253992,211442,,,,,0,0,0,0
1650436790.978989,public.usertable,188096,40440,262660096,16671,public,usertable,1,0,297535,1407679,211817,18922,23721,6508,188096,40440,254460,211817,,,,,0,0,0,0
1650436792.009847,public.usertable,188386,40530,263102464,16671,public,usertable,1,0,298508,1412635,212163,18966,23777,6529,188386,40530,254906,212163,,,,,0,0,0,0
1650436793.0402455,public.usertable,188656,40595,263471104,16671,public,usertable,1,0,299269,1413451,212464,19001,23808,6541,188656,40595,255273,212464,,,,,0,0,0,0
1650436794.0685802,public.usertable,188887,40667,263774208,16671,public,usertable,1,0,300055,1415980,212736,19041,23849,6556,188887,40667,255626,212736,,,,,0,0,0,0
1650436795.0989075,public.usertable,189028,40714,263970816,16671,public,usertable,1,0,300496,1418548,212901,19066,23873,6566,189028,40714,255840,212901,,,,,0,0,0,0
1650436796.1279066,public.usertable,189160,40758,264151040,16671,public,usertable,1,0,300910,1419245,213052,19094,23892,6579,189160,40758,256038,213052,,,,,0,0,0,0
1650436797.1593783,public.usertable,189312,40800,264388608,16671,public,usertable,1,0,301311,1419944,213232,19109,23920,6584,189312,40800,256261,213232,,,,,0,0,0,0
1650436798.1874404,public.usertable,189456,40852,264634368,16671,public,usertable,1,0,301770,1421550,213403,19134,23947,6596,189456,40852,256484,213403,,,,,0,0,0,0
1650436799.2144601,public.usertable,189696,40907,264855552,16671,public,usertable,1,0,302415,1422948,213674,19163,23978,6605,189696,40907,256815,213674,,,,,0,0,0,0
1650436800.2444596,public.usertable,189835,40954,265076736,16671,public,usertable,1,0,302902,1423319,213839,19185,24004,6613,189835,40954,257028,213839,,,,,0,0,0,0
1650436801.2738667,public.usertable,190001,41008,265338880,16671,public,usertable,1,0,303426,1425367,214041,19209,24040,6622,190001,41008,257290,214041,,,,,0,0,0,0
1650436802.304418,public.usertable,190207,41063,265650176,16671,public,usertable,1,0,304044,1426652,214278,19236,24071,6633,190207,41063,257585,214278,,,,,0,0,0,0
1650436803.3338492,public.usertable,190437,41103,265986048,16671,public,usertable,1,0,304792,1428680,214542,19259,24105,6643,190437,41103,257906,214542,,,,,0,0,0,0
1650436804.3632145,public.usertable,190701,41186,266403840,16671,public,usertable,1,0,305714,1430921,214862,19293,24161,6654,190701,41186,258316,214862,,,,,0,0,0,0
1650436805.3935874,public.usertable,190986,41285,266854400,16671,public,usertable,1,0,306613,1431464,215209,19340,24223,6679,190986,41285,258772,215209,,,,,0,0,0,0
1650436806.424476,public.usertable,191287,41360,267296768,16671,public,usertable,1,0,307594,1433811,215554,19378,24267,6698,191287,41360,259199,215554,,,,,0,0,0,0
1650436807.4549332,public.usertable,191562,41420,267665408,16671,public,usertable,1,0,308418,1435228,215873,19409,24311,6711,191562,41420,259593,215873,,,,,0,0,0,0
1650436808.4861622,public.usertable,191808,41489,268058624,16671,public,usertable,1,0,309211,1436847,216161,19441,24353,6724,191808,41489,259955,216161,,,,,0,0,0,0
1650436809.5179982,public.usertable,192092,41572,268476416,16671,public,usertable,1,0,310165,1439961,216493,19481,24401,6737,192092,41572,260375,216493,,,,,0,0,0,0
1650436810.5472066,public.usertable,192411,41637,268959744,16671,public,usertable,1,0,310980,1441218,216848,19518,24437,6750,192411,41637,260803,216848,,,,,0,0,0,0
1650436811.576454,public.usertable,192713,41704,269369344,16671,public,usertable,1,0,311864,1442895,217180,19558,24467,6763,192713,41704,261205,217180,,,,,0,0,0,0
1650436812.6048026,public.usertable,192980,41772,269762560,16671,public,usertable,1,0,312673,1445249,217484,19598,24504,6779,192980,41772,261586,217484,,,,,0,0,0,0
1650436813.6345084,public.usertable,193289,41831,270204928,16671,public,usertable,1,0,313612,1446976,217829,19632,24540,6795,193289,41831,262001,217829,,,,,0,0,0,0
1650436814.667597,public.usertable,193582,41919,270671872,16671,public,usertable,1,0,314567,1447790,218176,19666,24594,6805,193582,41919,262436,218176,,,,,0,0,0,0
1650436815.6994932,public.usertable,193897,41968,271089664,16671,public,usertable,1,0,315486,1452054,218523,19696,24626,6820,193897,41968,262845,218523,,,,,0,0,0,0
1650436816.729788,public.usertable,194170,42056,271523840,16671,public,usertable,1,0,316501,1454591,218849,19741,24679,6840,194170,42056,263269,218849,,,,,0,0,0,0
1650436817.7612517,public.usertable,194475,42120,271941632,16671,public,usertable,1,0,317413,1456956,219197,19769,24722,6854,194475,42120,263688,219197,,,,,0,0,0,0
1650436818.7924497,public.usertable,194873,42218,272326656,16671,public,usertable,1,0,318555,1461963,219655,19820,24782,6878,194873,42218,264257,219655,,,,,0,0,0,0
1650436819.824187,public.usertable,195102,42279,272662528,16671,public,usertable,1,0,319290,1463995,219918,19850,24816,6893,195102,42279,264584,219918,,,,,0,0,0,0
1650436820.8538141,public.usertable,195413,42370,273121280,16671,public,usertable,1,0,320199,1466429,220275,19897,24862,6915,195413,42370,265034,220275,,,,,0,0,0,0
1650436821.8821542,public.usertable,195690,42442,273539072,16671,public,usertable,1,0,321168,1469004,220597,19931,24907,6928,195690,42442,265435,220597,,,,,0,0,0,0
1650436822.912127,public.usertable,195996,42516,273981440,16671,public,usertable,1,0,321996,1470265,220947,19962,24951,6944,195996,42516,265860,220947,,,,,0,0,0,0
1650436823.9404085,public.usertable,196304,42583,274407424,16671,public,usertable,1,0,322800,1470920,221293,19995,24989,6963,196304,42583,266277,221293,,,,,0,0,0,0
1650436824.9685247,public.usertable,196578,42677,274857984,16671,public,usertable,1,0,323672,1474194,221630,20036,25052,6983,196578,42677,266718,221630,,,,,0,0,0,0
1650436825.9977736,public.usertable,196898,42759,275308544,16671,public,usertable,1,0,324724,1476855,222000,20077,25102,7003,196898,42759,267179,222000,,,,,0,0,0,0
1650436827.0260139,public.usertable,197189,42864,275767296,16671,public,usertable,1,0,325748,1479635,222350,20124,25161,7024,197189,42864,267635,222350,,,,,0,0,0,0
1650436828.0570989,public.usertable,197479,42949,276176896,16671,public,usertable,1,0,326618,1482031,222698,20156,25219,7042,197479,42949,268073,222698,,,,,0,0,0,0
1650436829.0855849,public.usertable,197763,43018,276619264,16671,public,usertable,1,0,327540,1487141,223027,20201,25264,7061,197763,43018,268492,223027,,,,,0,0,0,0
1650436830.114541,public.usertable,198053,43101,277037056,16671,public,usertable,1,0,328410,1489312,223363,20242,25310,7082,198053,43101,268915,223363,,,,,0,0,0,0
1650436831.1439314,public.usertable,198321,43176,277446656,16671,public,usertable,1,0,329211,1492742,223678,20278,25357,7097,198321,43176,269313,223678,,,,,0,0,0,0
1650436832.1735587,public.usertable,198600,43251,277864448,16671,public,usertable,1,0,330109,1495849,224009,20311,25409,7109,198600,43251,269729,224009,,,,,0,0,0,0
1650436833.2024274,public.usertable,198872,43341,278290432,16671,public,usertable,1,0,331075,1498986,224338,20352,25466,7127,198872,43341,270156,224338,,,,,0,0,0,0
1650436834.232399,public.usertable,199160,43414,278716416,16671,public,usertable,1,0,331995,1501089,224665,20391,25505,7143,199160,43414,270561,224665,,,,,0,0,0,0
1650436835.2611318,public.usertable,199445,43486,279134208,16671,public,usertable,1,0,332821,1503409,224997,20419,25552,7154,199445,43486,270968,224997,,,,,0,0,0,0
1650436836.2905178,public.usertable,199726,43566,279552000,16671,public,usertable,1,0,333653,1503800,225327,20450,25601,7164,199726,43566,271378,225327,,,,,0,0,0,0
1650436837.3212104,public.usertable,200153,43689,279986176,16671,public,usertable,1,0,335052,1508072,225837,20499,25684,7188,200153,43689,272020,225837,,,,,0,0,0,0
1650436838.351135,public.usertable,200452,43756,280420352,16671,public,usertable,1,0,335959,1511596,226176,20536,25724,7205,200452,43756,272436,226176,,,,,0,0,0,0
1650436839.3832486,public.usertable,200748,43828,280846336,16671,public,usertable,1,0,336827,1513619,226520,20567,25772,7219,200748,43828,272859,226520,,,,,0,0,0,0
1650436840.4131145,public.usertable,201050,43899,281280512,16671,public,usertable,1,0,337718,1516818,226862,20606,25812,7235,201050,43899,273280,226862,,,,,0,0,0,0
1650436841.441815,public.usertable,201352,43973,281739264,16671,public,usertable,1,0,338600,1518359,227207,20647,25855,7253,201352,43973,273709,227207,,,,,0,0,0,0
1650436842.4712126,public.usertable,201650,44065,282198016,16671,public,usertable,1,0,339564,1521688,227564,20689,25914,7272,201650,44065,274167,227564,,,,,0,0,0,0
1650436843.5040212,public.usertable,201947,44145,282624000,16671,public,usertable,1,0,340412,1523480,227908,20728,25961,7291,201947,44145,274597,227908,,,,,0,0,0,0
1650436844.5338266,public.usertable,202222,44208,283017216,16671,public,usertable,1,0,341260,1525131,228225,20755,26003,7303,202222,44208,274983,228225,,,,,0,0,0,0
1650436845.5637276,public.usertable,202479,44275,283394048,16671,public,usertable,1,0,342006,1528018,228524,20788,26045,7321,202479,44275,275357,228524,,,,,0,0,0,0
1650436846.5950701,public.usertable,202734,44333,283746304,16671,public,usertable,1,0,342749,1530845,228817,20813,26083,7332,202734,44333,275713,228817,,,,,0,0,0,0
1650436847.6247947,public.usertable,202948,44401,284090368,16671,public,usertable,1,0,343460,1531739,229069,20847,26121,7347,202948,44401,276037,229069,,,,,0,0,0,0
1650436848.6560671,public.usertable,203171,44478,284426240,16671,public,usertable,1,0,344183,1534591,229342,20879,26171,7360,203171,44478,276392,229342,,,,,0,0,0,0
1650436849.684334,public.usertable,203399,44535,284737536,16671,public,usertable,1,0,344884,1536367,229601,20907,26202,7369,203399,44535,276710,229601,,,,,0,0,0,0
1650436850.713538,public.usertable,203602,44582,285032448,16671,public,usertable,1,0,345541,1539189,229835,20932,26233,7385,203602,44582,277000,229835,,,,,0,0,0,0
1650436851.745537,public.usertable,203797,44644,285351936,16671,public,usertable,1,0,346272,1541619,230063,20974,26266,7406,203797,44644,277303,230063,,,,,0,0,0,0
1650436852.7784944,public.usertable,204048,44722,285777920,16671,public,usertable,1,0,347173,1544541,230347,21022,26299,7421,204048,44722,277668,230347,,,,,0,0,0,0
1650436853.8101795,public.usertable,204360,44785,286220288,16671,public,usertable,1,0,348128,1548058,230690,21062,26330,7440,204360,44785,278082,230690,,,,,0,0,0,0
1650436854.8395813,public.usertable,204663,44856,286629888,16671,public,usertable,1,0,348968,1550494,231035,21097,26372,7455,204663,44856,278504,231035,,,,,0,0,0,0
1650436855.8679795,public.usertable,205080,44953,287039488,16671,public,usertable,1,0,350236,1555244,231512,21144,26432,7483,205080,44953,279088,231512,,,,,0,0,0,0
1650436856.8969767,public.usertable,205365,45030,287440896,16671,public,usertable,1,0,351069,1557784,231836,21183,26471,7505,205365,45030,279490,231836,,,,,0,0,0,0
1650436857.9280255,public.usertable,205656,45090,287866880,16671,public,usertable,1,0,351992,1559266,232169,21212,26513,7518,205656,45090,279894,232169,,,,,0,0,0,0
1650436858.9579105,public.usertable,205964,45153,288309248,16671,public,usertable,1,0,352845,1563016,232517,21244,26553,7534,205964,45153,280314,232517,,,,,0,0,0,0
1650436859.9955013,public.usertable,206270,45240,288784384,16671,public,usertable,1,0,353784,1565558,232874,21284,26604,7545,206270,45240,280762,232874,,,,,0,0,0,0
1650436861.0250201,public.usertable,206575,45318,289210368,16671,public,usertable,1,0,354745,1567300,233224,21321,26649,7566,206575,45318,281194,233224,,,,,0,0,0,0
1650436862.0535865,public.usertable,206843,45412,289636352,16671,public,usertable,1,0,355669,1570184,233558,21361,26715,7588,206843,45412,281634,233558,,,,,0,0,0,0
1650436863.0839639,public.usertable,207143,45474,290078720,16671,public,usertable,1,0,356599,1573725,233898,21395,26755,7602,207143,45474,282048,233898,,,,,0,0,0,0
1650436864.113316,public.usertable,207464,45562,290545664,16671,public,usertable,1,0,357480,1575102,234272,21431,26808,7620,207464,45562,282511,234272,,,,,0,0,0,0
1650436865.1419332,public.usertable,207780,45631,291004416,16671,public,usertable,1,0,358378,1578284,234630,21467,26850,7639,207780,45631,282947,234630,,,,,0,0,0,0
1650436866.1714485,public.usertable,208082,45712,291438592,16671,public,usertable,1,0,359387,1581382,234985,21505,26903,7656,208082,45712,283393,234985,,,,,0,0,0,0
1650436867.2019405,public.usertable,208391,45798,291905536,16671,public,usertable,1,0,360395,1584053,235349,21546,26958,7674,208391,45798,283853,235349,,,,,0,0,0,0
1650436868.2316403,public.usertable,208688,45873,292331520,16671,public,usertable,1,0,361280,1587249,235684,21587,26996,7695,208688,45873,284267,235684,,,,,0,0,0,0
1650436869.2604434,public.usertable,208995,45955,292790272,16671,public,usertable,1,0,362280,1589618,236044,21620,27049,7713,208995,45955,284713,236044,,,,,0,0,0,0
1650436870.291659,public.usertable,209329,46024,293249024,16671,public,usertable,1,0,363162,1591846,236416,21657,27087,7731,209329,46024,285160,236416,,,,,0,0,0,0
1650436871.321894,public.usertable,209608,46102,293584896,16671,public,usertable,1,0,363980,1594591,236729,21706,27121,7752,209608,46102,285556,236729,,,,,0,0,0,0
1650436872.3520448,public.usertable,209811,46157,293953536,16671,public,usertable,1,0,364584,1595888,236960,21733,27149,7763,209811,46157,285842,236960,,,,,0,0,0,0
1650436873.3833773,public.usertable,210080,46222,294330368,16671,public,usertable,1,0,365416,1598336,237266,21763,27186,7774,210080,46222,286215,237266,,,,,0,0,0,0
1650436874.411735,public.usertable,210453,46320,294690816,16671,public,usertable,1,0,366653,1600868,237708,21795,27255,7786,210453,46320,286758,237708,,,,,0,0,0,0
1650436875.4413586,public.usertable,210756,46393,295124992,16671,public,usertable,1,0,367603,1602272,238060,21823,27304,7800,210756,46393,287187,238060,,,,,0,0,0,0
1650436876.470696,public.usertable,211033,46482,295559168,16671,public,usertable,1,0,368485,1604018,238400,21855,27367,7815,211033,46482,287622,238400,,,,,0,0,0,0
1650436877.4997604,public.usertable,211329,46560,296001536,16671,public,usertable,1,0,369388,1607685,238737,21904,27408,7838,211329,46560,288049,238737,,,,,0,0,0,0
1650436878.5290632,public.usertable,211629,46641,296419328,16671,public,usertable,1,0,370289,1611860,239079,21944,27450,7857,211629,46641,288473,239079,,,,,0,0,0,0
1650436879.5582378,public.usertable,211904,46713,296828928,16671,public,usertable,1,0,371075,1614218,239391,21979,27487,7872,211904,46713,288857,239391,,,,,0,0,0,0
1650436880.5870597,public.usertable,212168,46786,297222144,16671,public,usertable,1,0,371871,1616469,239700,22011,27532,7889,212168,46786,289243,239700,,,,,0,0,0,0
1650436881.6179686,public.usertable,212441,46859,297639936,16671,public,usertable,1,0,372725,1619844,240019,22045,27578,7901,212441,46859,289642,240019,,,,,0,0,0,0
1650436882.6489193,public.usertable,212711,46949,298049536,16671,public,usertable,1,0,373625,1622258,240338,22086,27627,7919,212711,46949,290051,240338,,,,,0,0,0,0
1650436883.6809764,public.usertable,213007,47023,298442752,16671,public,usertable,1,0,374570,1624436,240680,22121,27673,7938,213007,47023,290474,240680,,,,,0,0,0,0
1650436884.709734,public.usertable,213249,47094,298811392,16671,public,usertable,1,0,375427,1626129,240967,22160,27718,7958,213249,47094,290845,240967,,,,,0,0,0,0
1650436885.739212,public.usertable,213509,47145,299220992,16671,public,usertable,1,0,376237,1628792,241261,22189,27752,7972,213509,47145,291202,241261,,,,,0,0,0,0
1650436886.7682862,public.usertable,213842,47221,299704320,16671,public,usertable,1,0,377300,1632019,241639,22235,27797,7993,213842,47221,291671,241639,,,,,0,0,0,0
1650436887.7987876,public.usertable,214148,47283,300138496,16671,public,usertable,1,0,378213,1633640,241986,22260,27838,8001,214148,47283,292084,241986,,,,,0,0,0,0
1650436888.8328006,public.usertable,214437,47346,300572672,16671,public,usertable,1,0,379084,1636461,242313,22292,27876,8014,214437,47346,292481,242313,,,,,0,0,0,0
1650436889.862937,public.usertable,214749,47409,300998656,16671,public,usertable,1,0,379971,1638286,242655,22333,27906,8030,214749,47409,292894,242655,,,,,0,0,0,0
1650436890.8927038,public.usertable,215037,47462,301416448,16671,public,usertable,1,0,380815,1640590,242980,22355,27943,8043,215037,47462,293278,242980,,,,,0,0,0,0
1650436891.9277623,public.usertable,215345,47530,301834240,16671,public,usertable,1,0,381701,1642778,243327,22385,27982,8062,215345,47530,293694,243327,,,,,0,0,0,0
1650436892.9587243,public.usertable,215643,47598,302276608,16671,public,usertable,1,0,382548,1644024,243670,22412,28027,8066,215643,47598,294109,243670,,,,,0,0,0,0
1650436893.9880183,public.usertable,216118,47689,302727168,16671,public,usertable,1,0,383861,1646532,244198,22460,28080,8091,216118,47689,294738,244198,,,,,0,0,0,0
1650436895.0168643,public.usertable,216435,47774,303185920,16671,public,usertable,1,0,384778,1647068,244557,22504,28122,8110,216435,47774,295183,244557,,,,,0,0,0,0
1650436896.047827,public.usertable,216762,47855,303652864,16671,public,usertable,1,0,385796,1649524,244926,22544,28164,8126,216762,47855,295634,244926,,,,,0,0,0,0
1650436897.0776799,public.usertable,217063,47919,304095232,16671,public,usertable,1,0,386707,1652476,245276,22570,28213,8135,217063,47919,296059,245276,,,,,0,0,0,0
1650436898.1061575,public.usertable,217374,47979,304521216,16671,public,usertable,1,0,387558,1653837,245623,22601,28249,8153,217374,47979,296473,245623,,,,,0,0,0,0
1650436899.1369843,public.usertable,217652,48047,304939008,16671,public,usertable,1,0,388430,1656952,245947,22629,28295,8170,217652,48047,296871,245947,,,,,0,0,0,0
1650436900.169576,public.usertable,217969,48116,305405952,16671,public,usertable,1,0,389428,1659195,246304,22664,28335,8188,217969,48116,297303,246304,,,,,0,0,0,0
1650436901.197764,public.usertable,218289,48184,305840128,16671,public,usertable,1,0,390458,1661371,246666,22694,28377,8203,218289,48184,297737,246666,,,,,0,0,0,0
1650436902.2291687,public.usertable,218601,48268,306315264,16671,public,usertable,1,0,391474,1663685,247031,22726,28430,8218,218601,48268,298187,247031,,,,,0,0,0,0
1650436903.2591112,public.usertable,218933,48343,306782208,16671,public,usertable,1,0,392492,1665730,247408,22763,28475,8230,218933,48343,298646,247408,,,,,0,0,0,0
1650436904.2897596,public.usertable,219260,48403,307257344,16671,public,usertable,1,0,393467,1667619,247777,22793,28517,8244,219260,48403,299087,247777,,,,,0,0,0,0
1650436905.3217309,public.usertable,219575,48494,307724288,16671,public,usertable,1,0,394446,1669695,248141,22837,28566,8260,219575,48494,299544,248141,,,,,0,0,0,0
1650436906.3535824,public.usertable,219883,48576,308199424,16671,public,usertable,1,0,395510,1671897,248511,22866,28628,8270,219883,48576,300005,248511,,,,,0,0,0,0
1650436907.383564,public.usertable,220215,48646,308658176,16671,public,usertable,1,0,396521,1674883,248887,22899,28672,8281,220215,48646,300458,248887,,,,,0,0,0,0
1650436908.41493,public.usertable,220526,48716,309108736,16671,public,usertable,1,0,397469,1676867,249243,22934,28717,8300,220526,48716,300894,249243,,,,,0,0,0,0
1650436909.4465575,public.usertable,220859,48794,309608448,16671,public,usertable,1,0,398451,1680493,249630,22965,28771,8320,220859,48794,301366,249630,,,,,0,0,0,0
1650436910.475259,public.usertable,221173,48880,310083584,16671,public,usertable,1,0,399455,1683669,249991,23006,28818,8337,221173,48880,301815,249991,,,,,0,0,0,0
1650436911.5079474,public.usertable,221646,48988,310517760,16671,public,usertable,1,0,400856,1685819,250518,23065,28872,8357,221646,48988,302455,250518,,,,,0,0,0,0
1650436912.537062,public.usertable,221998,49050,310992896,16671,public,usertable,1,0,401813,1688389,250901,23104,28903,8379,221998,49050,302908,250901,,,,,0,0,0,0
1650436913.5678737,public.usertable,222298,49128,311451648,16671,public,usertable,1,0,402791,1692153,251243,23151,28945,8394,222298,49128,303339,251243,,,,,0,0,0,0
1650436914.596641,public.usertable,222630,49202,311918592,16671,public,usertable,1,0,403750,1694895,251621,23183,28991,8407,222630,49202,303795,251621,,,,,0,0,0,0
1650436915.6260574,public.usertable,222920,49290,312352768,16671,public,usertable,1,0,404786,1698669,251966,23229,29046,8427,222920,49290,304241,251966,,,,,0,0,0,0
1650436916.6567533,public.usertable,223228,49366,312836096,16671,public,usertable,1,0,405793,1701632,252323,23265,29095,8445,223228,49366,304683,252323,,,,,0,0,0,0
1650436917.6894896,public.usertable,223594,49431,313327616,16671,public,usertable,1,0,406701,1704542,252723,23303,29129,8462,223594,49431,305155,252723,,,,,0,0,0,0
1650436918.7196972,public.usertable,223899,49491,313729024,16671,public,usertable,1,0,407630,1707490,253067,23335,29168,8484,223899,49491,305570,253067,,,,,0,0,0,0
1650436919.748107,public.usertable,224108,49552,314040320,16671,public,usertable,1,0,408294,1709296,253314,23361,29206,8499,224108,49552,305881,253314,,,,,0,0,0,0
1650436920.77798,public.usertable,224287,49618,314310656,16671,public,usertable,1,0,408915,1710285,253536,23387,29249,8507,224287,49618,306172,253536,,,,,0,0,0,0
1650436921.8067062,public.usertable,224469,49670,314605568,16671,public,usertable,1,0,409560,1713015,253752,23409,29283,8518,224469,49670,306444,253752,,,,,0,0,0,0
1650436922.8359904,public.usertable,224708,49728,314966016,16671,public,usertable,1,0,410320,1715209,254025,23438,29317,8533,224708,49728,306780,254025,,,,,0,0,0,0
1650436923.8656542,public.usertable,224989,49798,315375616,16671,public,usertable,1,0,411212,1716749,254353,23466,29364,8547,224989,49798,307183,254353,,,,,0,0,0,0
1650436924.8960643,public.usertable,225299,49854,315817984,16671,public,usertable,1,0,412065,1718716,254689,23504,29390,8558,225299,49854,307583,254689,,,,,0,0,0,0
1650436925.9251933,public.usertable,225582,49936,316235776,16671,public,usertable,1,0,412998,1719811,255018,23542,29436,8577,225582,49936,307996,255018,,,,,0,0,0,0
1650436926.9547954,public.usertable,225880,50001,316694528,16671,public,usertable,1,0,413864,1721839,255352,23576,29472,8590,225880,50001,308400,255352,,,,,0,0,0,0
1650436927.983672,public.usertable,226231,50053,317169664,16671,public,usertable,1,0,414832,1725279,255743,23598,29512,8602,226231,50053,308853,255743,,,,,0,0,0,0
1650436929.0150273,public.usertable,226551,50130,317644800,16671,public,usertable,1,0,415865,1728261,256111,23635,29560,8611,226551,50130,309306,256111,,,,,0,0,0,0
1650436930.0439806,public.usertable,227060,50252,318144512,16671,public,usertable,1,0,417438,1730833,256696,23683,29636,8631,227060,50252,310015,256696,,,,,0,0,0,0
1650436931.0749714,public.usertable,227368,50329,318595072,16671,public,usertable,1,0,418497,1734406,257042,23730,29674,8648,227368,50329,310446,257042,,,,,0,0,0,0
1650436932.1034534,public.usertable,227686,50411,319062016,16671,public,usertable,1,0,419520,1737718,257406,23769,29720,8665,227686,50411,310895,257406,,,,,0,0,0,0
1650436933.1322622,public.usertable,228023,50487,319545344,16671,public,usertable,1,0,420600,1741866,257789,23808,29766,8682,228023,50487,311363,257789,,,,,0,0,0,0
1650436934.1625366,public.usertable,228360,50568,320028672,16671,public,usertable,1,0,421512,1744301,258168,23853,29808,8703,228360,50568,311829,258168,,,,,0,0,0,0
1650436935.1918356,public.usertable,228648,50637,320462848,16671,public,usertable,1,0,422447,1748180,258504,23890,29856,8725,228648,50637,312250,258504,,,,,0,0,0,0
1650436936.2227468,public.usertable,229013,50693,320954368,16671,public,usertable,1,0,423373,1750634,258905,23916,29892,8738,229013,50693,312713,258905,,,,,0,0,0,0
1650436937.2515416,public.usertable,229341,50773,321445888,16671,public,usertable,1,0,424354,1752593,259290,23946,29949,8750,229341,50773,313185,259290,,,,,0,0,0,0
1650436938.2804627,public.usertable,229672,50867,321937408,16671,public,usertable,1,0,425414,1754707,259671,23995,29999,8772,229672,50867,313665,259671,,,,,0,0,0,0
1650436939.3088162,public.usertable,230008,50949,322412544,16671,public,usertable,1,0,426415,1756326,260056,24034,30048,8796,230008,50949,314138,260056,,,,,0,0,0,0
1650436940.3394656,public.usertable,230341,51006,322871296,16671,public,usertable,1,0,427361,1758285,260423,24067,30082,8812,230341,51006,314572,260423,,,,,0,0,0,0
1650436941.3685954,public.usertable,230668,51064,323321856,16671,public,usertable,1,0,428297,1760083,260778,24105,30110,8825,230668,51064,314993,260778,,,,,0,0,0,0
1650436942.3974025,public.usertable,230951,51121,323739648,16671,public,usertable,1,0,429238,1761699,261099,24135,30148,8836,230951,51121,315382,261099,,,,,0,0,0,0
1650436943.4285467,public.usertable,231261,51211,324214784,16671,public,usertable,1,0,430268,1763453,261467,24175,30206,8859,231261,51211,315848,261467,,,,,0,0,0,0
1650436944.460886,public.usertable,231582,51295,324657152,16671,public,usertable,1,0,431308,1764574,261838,24215,30256,8877,231582,51295,316309,261838,,,,,0,0,0,0
1650436945.4885244,public.usertable,231880,51368,325115904,16671,public,usertable,1,0,432282,1767713,262192,24243,30312,8891,231880,51368,316747,262192,,,,,0,0,0,0
1650436946.5196257,public.usertable,232208,51453,325623808,16671,public,usertable,1,0,433379,1770590,262572,24288,30364,8908,232208,51453,317224,262572,,,,,0,0,0,0
1650436947.5485687,public.usertable,232545,51511,326074368,16671,public,usertable,1,0,434409,1774551,262952,24319,30407,8927,232545,51511,317678,262952,,,,,0,0,0,0
1650436948.5774555,public.usertable,233004,51635,326533120,16671,public,usertable,1,0,435851,1777913,263482,24383,30478,8953,233004,51635,318343,263482,,,,,0,0,0,0
1650436949.6057994,public.usertable,233321,51714,326991872,16671,public,usertable,1,0,436767,1778408,263843,24420,30522,8966,233321,51714,318785,263843,,,,,0,0,0,0
1650436950.6353803,public.usertable,233673,51773,327467008,16671,public,usertable,1,0,437701,1780525,264227,24449,30554,8979,233673,51773,319230,264227,,,,,0,0,0,0
1650436951.6639252,public.usertable,233999,51840,327933952,16671,public,usertable,1,0,438645,1783199,264595,24481,30596,8992,233999,51840,319672,264595,,,,,0,0,0,0
1650436952.6926062,public.usertable,234356,51907,328433664,16671,public,usertable,1,0,439592,1784254,264985,24517,30629,9005,234356,51907,320131,264985,,,,,0,0,0,0
1650436953.721487,public.usertable,234673,51980,328892416,16671,public,usertable,1,0,440566,1785319,265348,24553,30675,9021,234673,51980,320576,265348,,,,,0,0,0,0
1650436954.7497485,public.usertable,234989,52054,329359360,16671,public,usertable,1,0,441566,1788460,265721,24578,30732,9040,234989,52054,321031,265721,,,,,0,0,0,0
1650436955.7778058,public.usertable,235332,52121,329826304,16671,public,usertable,1,0,442529,1790310,266102,24610,30770,9056,235332,52121,321482,266102,,,,,0,0,0,0
1650436956.807859,public.usertable,235658,52196,330301440,16671,public,usertable,1,0,443503,1792723,266472,24647,30814,9070,235658,52196,321933,266472,,,,,0,0,0,0
1650436957.8367162,public.usertable,235971,52265,330727424,16671,public,usertable,1,0,444397,1794750,266835,24668,30864,9078,235971,52265,322367,266835,,,,,0,0,0,0
1650436958.8653622,public.usertable,236238,52311,331087872,16671,public,usertable,1,0,445185,1795506,267125,24694,30887,9089,236238,52311,322706,267125,,,,,0,0,0,0
1650436959.89501,public.usertable,236466,52365,331415552,16671,public,usertable,1,0,445840,1798359,267385,24724,30919,9102,236466,52365,323028,267385,,,,,0,0,0,0
1650436960.9242525,public.usertable,236707,52428,331792384,16671,public,usertable,1,0,446641,1801137,267660,24758,30953,9117,236707,52428,323371,267660,,,,,0,0,0,0
1650436961.9530778,public.usertable,236985,52492,332177408,16671,public,usertable,1,0,447548,1802033,267976,24784,30991,9129,236985,52492,323751,267976,,,,,0,0,0,0
1650436962.9829874,public.usertable,237252,52571,332611584,16671,public,usertable,1,0,448452,1804204,268296,24817,31044,9143,237252,52571,324157,268296,,,,,0,0,0,0
1650436964.0154932,public.usertable,237533,52622,333012992,16671,public,usertable,1,0,449242,1807095,268610,24841,31077,9149,237533,52622,324528,268610,,,,,0,0,0,0
1650436965.0448496,public.usertable,237845,52682,333463552,16671,public,usertable,1,0,450122,1809010,268954,24871,31109,9160,237845,52682,324934,268954,,,,,0,0,0,0
1650436966.0751095,public.usertable,238175,52748,333905920,16671,public,usertable,1,0,451151,1811750,269320,24907,31145,9174,238175,52748,325372,269320,,,,,0,0,0,0
1650436967.1048634,public.usertable,238612,52862,334331904,16671,public,usertable,1,0,452570,1817120,269817,24968,31205,9212,238612,52862,325990,269817,,,,,0,0,0,0
1650436968.1333435,public.usertable,238904,52939,334757888,16671,public,usertable,1,0,453517,1819456,270154,25005,31250,9236,238904,52939,326409,270154,,,,,0,0,0,0
1650436969.1661954,public.usertable,239231,52999,335216640,16671,public,usertable,1,0,454460,1821051,270519,25032,31288,9247,239231,52999,326839,270519,,,,,0,0,0,0
1650436970.199217,public.usertable,239547,53066,335667200,16671,public,usertable,1,0,455456,1823262,270881,25062,31334,9260,239547,53066,327277,270881,,,,,0,0,0,0
1650436971.2337368,public.usertable,239853,53141,336109568,16671,public,usertable,1,0,456354,1824648,271227,25098,31374,9273,239853,53141,327699,271227,,,,,0,0,0,0
1650436972.2641902,public.usertable,240126,53192,336502784,16671,public,usertable,1,0,457225,1825571,271535,25122,31409,9283,240126,53192,328066,271535,,,,,0,0,0,0
1650436973.2962348,public.usertable,240386,53256,336871424,16671,public,usertable,1,0,458131,1826679,271828,25162,31442,9301,240386,53256,328432,271828,,,,,0,0,0,0
1650436974.325928,public.usertable,240658,53309,337264640,16671,public,usertable,1,0,458982,1829472,272139,25187,31481,9315,240658,53309,328807,272139,,,,,0,0,0,0
1650436975.3542325,public.usertable,240947,53369,337666048,16671,public,usertable,1,0,459743,1832778,272462,25219,31515,9330,240947,53369,329196,272462,,,,,0,0,0,0
1650436976.3835459,public.usertable,241238,53431,338083840,16671,public,usertable,1,0,460595,1834356,272789,25252,31551,9346,241238,53431,329592,272789,,,,,0,0,0,0
1650436977.412488,public.usertable,241511,53504,338493440,16671,public,usertable,1,0,461386,1837190,273102,25290,31591,9360,241511,53504,329983,273102,,,,,0,0,0,0
1650436978.4427292,public.usertable,241774,53572,338870272,16671,public,usertable,1,0,462281,1838621,273412,25315,31638,9375,241774,53572,330365,273412,,,,,0,0,0,0
1650436979.4736495,public.usertable,242028,53641,339263488,16671,public,usertable,1,0,463093,1839899,273710,25345,31682,9385,242028,53641,330737,273710,,,,,0,0,0,0
1650436980.5035102,public.usertable,242331,53706,339722240,16671,public,usertable,1,0,464045,1841720,274056,25377,31725,9397,242331,53706,331158,274056,,,,,0,0,0,0
1650436981.5342567,public.usertable,242646,53780,340180992,16671,public,usertable,1,0,465102,1845140,274409,25426,31763,9417,242646,53780,331598,274409,,,,,0,0,0,0
1650436982.5637784,public.usertable,242934,53855,340598784,16671,public,usertable,1,0,466025,1846374,274747,25456,31813,9429,242934,53855,332016,274747,,,,,0,0,0,0
1650436983.5922558,public.usertable,243214,53923,341032960,16671,public,usertable,1,0,467000,1848053,275068,25491,31854,9442,243214,53923,332413,275068,,,,,0,0,0,0
1650436984.621174,public.usertable,243557,53987,341483520,16671,public,usertable,1,0,467996,1849426,275439,25531,31882,9461,243557,53987,332852,275439,,,,,0,0,0,0
1650436985.6507769,public.usertable,243991,54095,341901312,16671,public,usertable,1,0,469378,1851257,275938,25579,31947,9486,243991,54095,333464,275938,,,,,0,0,0,0
1650436986.6813648,public.usertable,244298,54179,342351872,16671,public,usertable,1,0,470416,1852733,276296,25619,31998,9510,244298,54179,333913,276296,,,,,0,0,0,0
1650436987.7107778,public.usertable,244579,54254,342745088,16671,public,usertable,1,0,471243,1856189,276625,25651,32046,9530,244579,54254,334322,276625,,,,,0,0,0,0
1650436988.7393842,public.usertable,244894,54317,343203840,16671,public,usertable,1,0,472146,1858099,276977,25684,32083,9544,244894,54317,334744,276977,,,,,0,0,0,0
1650436989.7697651,public.usertable,245231,54394,343687168,16671,public,usertable,1,0,473184,1859972,277360,25718,32129,9562,245231,54394,335207,277360,,,,,0,0,0,0
1650436990.8004134,public.usertable,245548,54471,344145920,16671,public,usertable,1,0,474103,1861452,277716,25757,32168,9576,245548,54471,335641,277716,,,,,0,0,0,0
1650436991.8303056,public.usertable,245871,54547,344604672,16671,public,usertable,1,0,475060,1864148,278086,25790,32215,9588,245871,54547,336091,278086,,,,,0,0,0,0
1650436992.860701,public.usertable,246195,54620,345079808,16671,public,usertable,1,0,476051,1867134,278452,25824,32257,9604,246195,54620,336533,278452,,,,,0,0,0,0
1650436993.891322,public.usertable,246526,54700,345563136,16671,public,usertable,1,0,477157,1869078,278824,25868,32298,9626,246526,54700,336990,278824,,,,,0,0,0,0
1650436994.9236982,public.usertable,246887,54761,346046464,16671,public,usertable,1,0,478188,1870149,279213,25905,32326,9642,246887,54761,337444,279213,,,,,0,0,0,0
1650436995.9546402,public.usertable,247205,54841,346513408,16671,public,usertable,1,0,479233,1871894,279581,25941,32376,9658,247205,54841,337898,279581,,,,,0,0,0,0
1650436996.984492,public.usertable,247530,54914,346963968,16671,public,usertable,1,0,480241,1873453,279949,25974,32419,9677,247530,54914,338342,279949,,,,,0,0,0,0
1650436998.0139372,public.usertable,247865,54962,347447296,16671,public,usertable,1,0,481255,1875989,280319,26001,32454,9685,247865,54962,338774,280319,,,,,0,0,0,0
1650436999.0462837,public.usertable,248210,55031,347930624,16671,public,usertable,1,0,482311,1878999,280707,26035,32497,9700,248210,55031,339239,280707,,,,,0,0,0,0
1650437000.0785494,public.usertable,248542,55088,348381184,16671,public,usertable,1,0,483333,1880503,281073,26068,32531,9717,248542,55088,339672,281073,,,,,0,0,0,0
1650437001.109696,public.usertable,248850,55164,348856320,16671,public,usertable,1,0,484309,1881780,281432,26102,32582,9733,248850,55164,340116,281432,,,,,0,0,0,0
1650437002.140006,public.usertable,249192,55230,349331456,16671,public,usertable,1,0,485320,1884634,281810,26137,32618,9750,249192,55230,340565,281810,,,,,0,0,0,0
1650437003.1709518,public.usertable,249528,55307,349798400,16671,public,usertable,1,0,486339,1886432,282192,26173,32664,9761,249528,55307,341029,282192,,,,,0,0,0,0
1650437004.2044444,public.usertable,249997,55412,350248960,16671,public,usertable,1,0,487908,1889770,282722,26236,32725,9784,249997,55412,341683,282722,,,,,0,0,0,0
1650437005.2334516,public.usertable,250304,55473,350683136,16671,public,usertable,1,0,488812,1892397,283067,26264,32763,9798,250304,55473,342094,283067,,,,,0,0,0,0
1650437006.2632318,public.usertable,250657,55535,351182848,16671,public,usertable,1,0,489837,1894303,283458,26293,32801,9809,250657,55535,342552,283458,,,,,0,0,0,0
1650437007.2943091,public.usertable,250967,55614,351633408,16671,public,usertable,1,0,490747,1895483,283817,26325,32850,9825,250967,55614,342992,283817,,,,,0,0,0,0
1650437008.3272827,public.usertable,251278,55677,352067584,16671,public,usertable,1,0,491692,1897658,284165,26355,32887,9837,251278,55677,343407,284165,,,,,0,0,0,0
1650437009.3557515,public.usertable,251591,55735,352501760,16671,public,usertable,1,0,492651,1898454,284510,26385,32919,9847,251591,55735,343814,284510,,,,,0,0,0,0
1650437010.3878086,public.usertable,251896,55813,352952320,16671,public,usertable,1,0,493642,1899592,284859,26422,32963,9865,251896,55813,344244,284859,,,,,0,0,0,0
1650437011.4168584,public.usertable,252245,55850,353402880,16671,public,usertable,1,0,494508,1901693,285236,26449,32991,9881,252245,55850,344676,285236,,,,,0,0,0,0
1650437012.446943,public.usertable,252541,55917,353820672,16671,public,usertable,1,0,495504,1904670,285568,26485,33027,9900,252541,55917,345080,285568,,,,,0,0,0,0
1650437013.4753122,public.usertable,252829,55986,354238464,16671,public,usertable,1,0,496328,1906354,285898,26514,33069,9914,252829,55986,345481,285898,,,,,0,0,0,0
1650437014.5051622,public.usertable,253147,56032,354680832,16671,public,usertable,1,0,497301,1910200,286250,26541,33103,9927,253147,56032,345894,286250,,,,,0,0,0,0
1650437015.534684,public.usertable,253433,56106,355115008,16671,public,usertable,1,0,498313,1912679,286587,26576,33154,9948,253433,56106,346317,286587,,,,,0,0,0,0
1650437016.564786,public.usertable,253758,56164,355557376,16671,public,usertable,1,0,499141,1913652,286943,26604,33185,9963,253758,56164,346732,286943,,,,,0,0,0,0
1650437017.5959702,public.usertable,254050,56227,355975168,16671,public,usertable,1,0,500059,1915560,287278,26633,33228,9978,254050,56227,347139,287278,,,,,0,0,0,0
1650437018.6250772,public.usertable,254348,56279,356352000,16671,public,usertable,1,0,500840,1916358,287608,26654,33260,9991,254348,56279,347522,287608,,,,,0,0,0,0
1650437019.6572695,public.usertable,254633,56340,356753408,16671,public,usertable,1,0,501638,1917430,287932,26679,33299,10005,254633,56340,347910,287932,,,,,0,0,0,0
1650437020.6868248,public.usertable,254915,56395,357212160,16671,public,usertable,1,0,502441,1918504,288254,26701,33339,10019,254915,56395,348294,288254,,,,,0,0,0,0
1650437021.72047,public.usertable,255247,56470,357654528,16671,public,usertable,1,0,503432,1920671,288630,26738,33383,10034,255247,56470,348751,288630,,,,,0,0,0,0
1650437022.751738,public.usertable,255701,56590,358105088,16671,public,usertable,1,0,504909,1924383,289153,26796,33452,10066,255701,56590,349401,289153,,,,,0,0,0,0
1650437023.7801304,public.usertable,256055,56645,358588416,16671,public,usertable,1,0,505902,1925706,289537,26826,33482,10079,256055,56645,349845,289537,,,,,0,0,0,0
1650437024.809823,public.usertable,256074,56649,358588416,16671,public,usertable,1,0,505976,1925727,289557,26829,33483,10080,256074,56649,349869,289557,,,,,0,0,0,0
1650437025.849598,public.usertable,256074,56649,358588416,16671,public,usertable,1,0,505976,1925727,289557,26829,33483,10080,256074,56649,349869,289557,,,,,0,0,0,0
1650437026.8791273,public.usertable,256074,56649,358588416,16671,public,usertable,1,0,505976,1925727,289557,26829,33483,10080,256074,56649,349869,289557,,,,,0,0,0,0
1650437027.9086943,public.usertable,256074,56649,358588416,16671,public,usertable,1,0,505976,1925727,289557,26829,33483,10080,256074,56649,349869,289557,,,,,0,0,0,0
