ds,table_name,pg_stat_get_live_tuples,pg_stat_get_dead_tuples,pg_table_size,relid,schemaname,relname,seq_scan,seq_tup_read,idx_scan,idx_tup_fetch,n_tup_ins,n_tup_upd,n_tup_del,n_tup_hot_upd,n_live_tup,n_dead_tup,n_mod_since_analyze,n_ins_since_vacuum,last_vacuum,last_autovacuum,last_analyze,last_autoanalyze,vacuum_count,autovacuum_count,analyze_count,autoanalyze_count
1650448000.1759415,public.usertable,100000,0,117088256,16893,public,usertable,1,0,0,0,100000,0,0,0,100000,0,100000,100000,,,,,0,0,0,0
1650448001.1935995,public.usertable,100000,0,117178368,16893,public,usertable,1,0,1,1,100000,0,0,0,100000,0,100000,100000,,,,,0,0,0,0
1650448002.2232053,public.usertable,100071,197,117497856,16893,public,usertable,1,0,442,7825,100183,87,112,12,100071,197,100382,100183,,,,,0,0,0,0
1650448003.2582297,public.usertable,100159,389,117858304,16893,public,usertable,1,0,949,16606,100389,164,230,27,100159,389,100783,100389,,,,,0,0,0,0
1650448004.2877278,public.usertable,100280,563,118210560,16893,public,usertable,1,0,1490,25959,100611,254,331,40,100280,563,101196,100611,,,,,0,0,0,0
1650448005.3184829,public.usertable,100413,748,118587392,16893,public,usertable,1,0,2031,33767,100848,336,435,55,100413,748,101619,100848,,,,,0,0,0,0
1650448006.3520813,public.usertable,100546,921,118939648,16893,public,usertable,1,0,2652,44486,101078,419,532,68,100546,921,102029,101078,,,,,0,0,0,0
1650448007.3820581,public.usertable,100736,1199,119308288,16893,public,usertable,1,0,3546,56423,101435,533,699,86,100736,1199,102667,101435,,,,,0,0,0,0
1650448008.4137118,public.usertable,100848,1392,119660544,16893,public,usertable,1,0,4202,64206,101662,616,814,102,100848,1392,103092,101662,,,,,0,0,0,0
1650448009.4418187,public.usertable,100985,1577,120029184,16893,public,usertable,1,0,4882,72210,101908,698,923,119,100985,1577,103529,101908,,,,,0,0,0,0
1650448010.4706678,public.usertable,101147,1765,120430592,16893,public,usertable,1,0,5582,77564,102167,796,1020,133,101147,1765,103983,102167,,,,,0,0,0,0
1650448011.4989831,public.usertable,101267,1950,120791040,16893,public,usertable,1,0,6244,86963,102404,866,1137,148,101267,1950,104407,102404,,,,,0,0,0,0
1650448012.529736,public.usertable,101418,2118,121167872,16893,public,usertable,1,0,6934,95586,102641,951,1223,157,101418,2118,104815,102641,,,,,0,0,0,0
1650448013.5597196,public.usertable,101579,2279,121544704,16893,public,usertable,1,0,7588,103091,102888,1031,1309,170,101579,2279,105228,102888,,,,,0,0,0,0
1650448014.591361,public.usertable,101741,2453,121937920,16893,public,usertable,1,0,8293,113171,103145,1113,1404,185,101741,2453,105662,103145,,,,,0,0,0,0
1650448015.6217823,public.usertable,101891,2624,122306560,16893,public,usertable,1,0,8942,119137,103390,1193,1499,205,101891,2624,106082,103390,,,,,0,0,0,0
1650448016.6547666,public.usertable,102011,2817,122642432,16893,public,usertable,1,0,9665,124844,103614,1287,1603,226,102011,2817,106504,103614,,,,,0,0,0,0
1650448017.6842985,public.usertable,102137,2985,123002880,16893,public,usertable,1,0,10302,130370,103839,1360,1702,241,102137,2985,106901,103839,,,,,0,0,0,0
1650448018.7142096,public.usertable,102309,3145,123379712,16893,public,usertable,1,0,11004,135201,104103,1431,1794,258,102309,3145,107328,104103,,,,,0,0,0,0
1650448019.7433646,public.usertable,102463,3293,123748352,16893,public,usertable,1,0,11593,141285,104336,1503,1873,274,102463,3293,107712,104336,,,,,0,0,0,0
1650448020.7723632,public.usertable,102644,3453,124141568,16893,public,usertable,1,0,12292,149859,104606,1578,1962,293,102644,3453,108146,104606,,,,,0,0,0,0
1650448021.8028123,public.usertable,102791,3633,124493824,16893,public,usertable,1,0,12970,155139,104864,1648,2073,307,102791,3633,108585,104864,,,,,0,0,0,0
1650448022.8336964,public.usertable,102943,3798,124854272,16893,public,usertable,1,0,13655,162423,105111,1722,2168,323,102943,3798,109001,105111,,,,,0,0,0,0
1650448023.8616223,public.usertable,103066,3960,125181952,16893,public,usertable,1,0,14262,169987,105335,1783,2269,335,103066,3960,109387,105335,,,,,0,0,0,0
1650448024.8922808,public.usertable,103227,4107,125558784,16893,public,usertable,1,0,14892,174829,105585,1845,2358,352,103227,4107,109788,105585,,,,,0,0,0,0
1650448025.923461,public.usertable,103469,4352,125935616,16893,public,usertable,1,0,15924,183820,105972,1958,2503,383,103469,4352,110433,105972,,,,,0,0,0,0
1650448026.9546697,public.usertable,103648,4511,126328832,16893,public,usertable,1,0,16701,192618,106244,2034,2596,404,103648,4511,110874,106244,,,,,0,0,0,0
1650448027.9837708,public.usertable,103829,4650,126689280,16893,public,usertable,1,0,17297,200910,106512,2092,2683,421,103829,4650,111287,106512,,,,,0,0,0,0
1650448029.0145774,public.usertable,103858,4668,126730240,16893,public,usertable,1,0,17397,201074,106553,2098,2695,422,103858,4668,111346,106553,,,,,0,0,0,0
1650448030.04627,public.usertable,104020,4828,127098880,16893,public,usertable,1,0,18145,207001,106808,2174,2788,447,104020,4828,111770,106808,,,,,0,0,0,0
1650448031.0766442,public.usertable,104208,4972,127483904,16893,public,usertable,1,0,18844,213860,107087,2227,2879,464,104208,4972,112193,107087,,,,,0,0,0,0
1650448032.1057198,public.usertable,104378,5106,127836160,16893,public,usertable,1,0,19490,217578,107343,2287,2965,476,104378,5106,112595,107343,,,,,0,0,0,0
1650448033.1339521,public.usertable,104538,5255,128188416,16893,public,usertable,1,0,20225,222451,107585,2357,3047,498,104538,5255,112989,107585,,,,,0,0,0,0
1650448034.1652813,public.usertable,104707,5403,128557056,16893,public,usertable,1,0,20886,227581,107835,2425,3128,510,104707,5403,113388,107835,,,,,0,0,0,0
1650448035.1933177,public.usertable,104875,5531,128909312,16893,public,usertable,1,0,21493,233337,108079,2483,3204,522,104875,5531,113766,108079,,,,,0,0,0,0
1650448036.2216468,public.usertable,105029,5637,129220608,16893,public,usertable,1,0,22015,237991,108294,2529,3265,529,105029,5637,114088,108294,,,,,0,0,0,0
1650448037.2519085,public.usertable,105210,5791,129613824,16893,public,usertable,1,0,22776,244691,108573,2591,3363,545,105210,5791,114527,108573,,,,,0,0,0,0
1650448038.2803361,public.usertable,105381,5958,130015232,16893,public,usertable,1,0,23475,250551,108828,2679,3447,559,105381,5958,114954,108828,,,,,0,0,0,0
1650448039.30931,public.usertable,105571,6119,130408448,16893,public,usertable,1,0,24217,258394,109115,2754,3544,582,105571,6119,115413,109115,,,,,0,0,0,0
1650448040.3396668,public.usertable,105731,6293,130793472,16893,public,usertable,1,0,24949,263114,109384,2820,3653,597,105731,6293,115857,109384,,,,,0,0,0,0
1650448041.3720176,public.usertable,105931,6429,131178496,16893,public,usertable,1,0,25682,265557,109661,2882,3730,614,105931,6429,116273,109661,,,,,0,0,0,0
1650448042.401491,public.usertable,106109,6551,131538944,16893,public,usertable,1,0,26321,269337,109920,2928,3811,623,106109,6551,116659,109920,,,,,0,0,0,0
1650448043.4310234,public.usertable,106250,6720,131891200,16893,public,usertable,1,0,27078,277833,110155,3006,3905,637,106250,6720,117066,110155,,,,,0,0,0,0
1650448044.4619231,public.usertable,106433,6867,132284416,16893,public,usertable,1,0,27790,282571,110417,3075,3984,658,106433,6867,117476,110417,,,,,0,0,0,0
1650448045.4906511,public.usertable,106625,7022,132685824,16893,public,usertable,1,0,28546,289159,110701,3145,4076,677,106625,7022,117922,110701,,,,,0,0,0,0
1650448046.520706,public.usertable,106815,7179,133079040,16893,public,usertable,1,0,29361,295089,110987,3215,4172,693,106815,7179,118374,110987,,,,,0,0,0,0
1650448047.5523992,public.usertable,107080,7388,133455872,16893,public,usertable,1,0,30329,300199,111365,3320,4285,717,107080,7388,118970,111365,,,,,0,0,0,0
1650448048.5825064,public.usertable,107245,7507,133775360,16893,public,usertable,1,0,30981,305410,111596,3376,4351,734,107245,7507,119323,111596,,,,,0,0,0,0
1650448049.6123884,public.usertable,107371,7607,134021120,16893,public,usertable,1,0,31505,309609,111775,3423,4404,749,107371,7607,119602,111775,,,,,0,0,0,0
1650448050.6409738,public.usertable,107509,7691,134266880,16893,public,usertable,1,0,31963,312047,111959,3464,4450,760,107509,7691,119873,111959,,,,,0,0,0,0
1650448051.6710923,public.usertable,107636,7780,134553600,16893,public,usertable,1,0,32380,315580,112141,3510,4505,771,107636,7780,120156,112141,,,,,0,0,0,0
1650448052.7003934,public.usertable,107755,7864,134766592,16893,public,usertable,1,0,32807,317353,112307,3547,4552,779,107755,7864,120406,112307,,,,,0,0,0,0
1650448053.7320251,public.usertable,107869,7944,134963200,16893,public,usertable,1,0,33249,320025,112456,3592,4587,795,107869,7944,120635,112456,,,,,0,0,0,0
1650448054.7613142,public.usertable,107952,8025,135176192,16893,public,usertable,1,0,33637,322208,112590,3624,4638,802,107952,8025,120852,112590,,,,,0,0,0,0
1650448055.7927678,public.usertable,108090,8114,135430144,16893,public,usertable,1,0,34130,325871,112781,3668,4691,818,108090,8114,121140,112781,,,,,0,0,0,0
1650448056.8235343,public.usertable,108209,8200,135675904,16893,public,usertable,1,0,34592,330592,112955,3703,4746,828,108209,8200,121404,112955,,,,,0,0,0,0
1650448057.8517315,public.usertable,108338,8282,135938048,16893,public,usertable,1,0,35034,333499,113132,3743,4794,837,108338,8282,121669,113132,,,,,0,0,0,0
1650448058.8848445,public.usertable,108456,8364,136192000,16893,public,usertable,1,0,35501,339337,113297,3786,4841,846,108456,8364,121924,113297,,,,,0,0,0,0
1650448059.9128494,public.usertable,108569,8496,136445952,16893,public,usertable,1,0,36099,343269,113491,3839,4922,862,108569,8496,122252,113491,,,,,0,0,0,0
1650448060.945485,public.usertable,108703,8580,136683520,16893,public,usertable,1,0,36571,346642,113674,3874,4971,873,108703,8580,122519,113674,,,,,0,0,0,0
1650448061.9762707,public.usertable,108860,8674,136962048,16893,public,usertable,1,0,37180,348847,113884,3917,5024,884,108860,8674,122825,113884,,,,,0,0,0,0
1650448063.0047293,public.usertable,108994,8770,137265152,16893,public,usertable,1,0,37645,351754,114075,3957,5081,894,108994,8770,123113,114075,,,,,0,0,0,0
1650448064.0351384,public.usertable,109177,8889,137633792,16893,public,usertable,1,0,38263,355762,114330,4010,5153,911,109177,8889,123493,114330,,,,,0,0,0,0
1650448065.0647874,public.usertable,109367,9015,138018816,16893,public,usertable,1,0,38972,360922,114590,4072,5223,929,109367,9015,123885,114590,,,,,0,0,0,0
1650448066.0958319,public.usertable,109574,9152,138420224,16893,public,usertable,1,0,39682,364123,114877,4135,5303,944,109574,9152,124315,114877,,,,,0,0,0,0
1650448067.1246076,public.usertable,109808,9286,138846208,16893,public,usertable,1,0,40445,367611,115181,4201,5373,968,109808,9286,124755,115181,,,,,0,0,0,0
1650448068.1561666,public.usertable,110031,9431,139255808,16893,public,usertable,1,0,41218,373694,115478,4281,5447,986,110031,9431,125206,115478,,,,,0,0,0,0
1650448069.1863167,public.usertable,110341,9634,139657216,16893,public,usertable,1,0,42301,379691,115902,4373,5561,1015,110341,9634,125836,115902,,,,,0,0,0,0
1650448070.2191074,public.usertable,110564,9761,140083200,16893,public,usertable,1,0,43154,386466,116199,4444,5635,1027,110564,9761,126278,116199,,,,,0,0,0,0
1650448071.2502005,public.usertable,110791,9887,140484608,16893,public,usertable,1,0,43895,391613,116500,4506,5709,1046,110791,9887,126715,116500,,,,,0,0,0,0
1650448072.2793255,public.usertable,110983,10019,140869632,16893,public,usertable,1,0,44622,395635,116775,4566,5792,1066,110983,10019,127133,116775,,,,,0,0,0,0
1650448073.3086462,public.usertable,111211,10135,141262848,16893,public,usertable,1,0,45372,401555,117075,4618,5864,1083,111211,10135,127557,117075,,,,,0,0,0,0
1650448074.3379242,public.usertable,111423,10267,141680640,16893,public,usertable,1,0,46212,404480,117359,4683,5936,1101,111423,10267,127978,117359,,,,,0,0,0,0
1650448075.3671632,public.usertable,111658,10400,142123008,16893,public,usertable,1,0,46983,407736,117678,4736,6020,1112,111658,10400,128434,117678,,,,,0,0,0,0
1650448076.3977928,public.usertable,111892,10537,142524416,16893,public,usertable,1,0,47723,410256,117984,4802,6092,1133,111892,10537,128878,117984,,,,,0,0,0,0
1650448077.4290752,public.usertable,112116,10661,142909440,16893,public,usertable,1,0,48476,415782,118281,4856,6165,1152,112116,10661,129302,118281,,,,,0,0,0,0
1650448078.4588256,public.usertable,112302,10813,143319040,16893,public,usertable,1,0,49219,420607,118564,4916,6262,1171,112302,10813,129742,118564,,,,,0,0,0,0
1650448079.4886665,public.usertable,112509,10957,143712256,16893,public,usertable,1,0,50082,424405,118847,4992,6338,1195,112509,10957,130177,118847,,,,,0,0,0,0
1650448080.5190911,public.usertable,112719,11103,144130048,16893,public,usertable,1,0,50838,429664,119136,5067,6417,1217,112719,11103,130620,119136,,,,,0,0,0,0
1650448081.5487065,public.usertable,112911,11259,144539648,16893,public,usertable,1,0,51686,433359,119420,5142,6509,1229,112911,11259,131071,119420,,,,,0,0,0,0
1650448082.5783558,public.usertable,113115,11392,144932864,16893,public,usertable,1,0,52445,437923,119702,5207,6587,1245,113115,11392,131496,119702,,,,,0,0,0,0
1650448083.6075304,public.usertable,113328,11522,145334272,16893,public,usertable,1,0,53192,441988,119994,5260,6666,1263,113328,11522,131920,119994,,,,,0,0,0,0
1650448084.6358812,public.usertable,113534,11661,145735680,16893,public,usertable,1,0,53920,445301,120280,5322,6746,1286,113534,11661,132348,120280,,,,,0,0,0,0
1650448085.6669016,public.usertable,113768,11802,146169856,16893,public,usertable,1,0,54755,448502,120586,5392,6818,1309,113768,11802,132796,120586,,,,,0,0,0,0
1650448086.6956618,public.usertable,114002,11937,146612224,16893,public,usertable,1,0,55611,454730,120901,5451,6899,1328,114002,11937,133251,120901,,,,,0,0,0,0
1650448087.7276418,public.usertable,114365,12145,147046400,16893,public,usertable,1,0,56921,462622,121389,5545,7024,1354,114365,12145,133958,121389,,,,,0,0,0,0
1650448088.7569232,public.usertable,114560,12301,147447808,16893,public,usertable,1,0,57761,467293,121668,5621,7108,1372,114560,12301,134397,121668,,,,,0,0,0,0
1650448089.7868273,public.usertable,114772,12448,147873792,16893,public,usertable,1,0,58549,468916,121960,5690,7188,1393,114772,12448,134838,121960,,,,,0,0,0,0
1650448090.81784,public.usertable,115015,12558,148275200,16893,public,usertable,1,0,59361,472729,122263,5748,7248,1410,115015,12558,135259,122263,,,,,0,0,0,0
1650448091.8489308,public.usertable,115228,12702,148692992,16893,public,usertable,1,0,60167,478120,122569,5809,7341,1434,115228,12702,135719,122569,,,,,0,0,0,0
1650448092.881917,public.usertable,115438,12842,149094400,16893,public,usertable,1,0,60971,480297,122853,5877,7415,1454,115438,12842,136145,122853,,,,,0,0,0,0
1650448093.9115956,public.usertable,115688,12956,149512192,16893,public,usertable,1,0,61747,484480,123163,5941,7475,1474,115688,12956,136579,123163,,,,,0,0,0,0
1650448094.9410434,public.usertable,115903,13103,149946368,16893,public,usertable,1,0,62496,486573,123468,6004,7565,1493,115903,13103,137037,123468,,,,,0,0,0,0
1650448095.9716823,public.usertable,116158,13217,150364160,16893,public,usertable,1,0,63272,489771,123801,6051,7643,1507,116158,13217,137495,123801,,,,,0,0,0,0
1650448097.0064151,public.usertable,116364,13360,150790144,16893,public,usertable,1,0,64113,493542,124095,6113,7731,1522,116364,13360,137939,124095,,,,,0,0,0,0
1650448098.0392003,public.usertable,116614,13486,151224320,16893,public,usertable,1,0,64973,497860,124415,6178,7801,1543,116614,13486,138394,124415,,,,,0,0,0,0
1650448099.0682483,public.usertable,116827,13630,151650304,16893,public,usertable,1,0,65801,503956,124708,6255,7881,1564,116827,13630,138844,124708,,,,,0,0,0,0
1650448100.099918,public.usertable,117062,13755,152068096,16893,public,usertable,1,0,66561,506986,125015,6317,7953,1582,117062,13755,139285,125015,,,,,0,0,0,0
1650448101.1291294,public.usertable,117254,13848,152379392,16893,public,usertable,1,0,67199,510350,125270,6353,8016,1595,117254,13848,139639,125270,,,,,0,0,0,0
1650448102.1577995,public.usertable,117437,13934,152682496,16893,public,usertable,1,0,67811,513844,125504,6392,8067,1605,117437,13934,139963,125504,,,,,0,0,0,0
1650448103.1888173,public.usertable,117581,14041,152944640,16893,public,usertable,1,0,68501,517295,125719,6435,8138,1622,117581,14041,140292,125719,,,,,0,0,0,0
1650448104.2232175,public.usertable,117730,14146,153247744,16893,public,usertable,1,0,69096,522032,125931,6477,8201,1636,117730,14146,140609,125931,,,,,0,0,0,0
1650448105.2550642,public.usertable,117958,14277,153509888,16893,public,usertable,1,0,69797,524900,126225,6547,8267,1661,117958,14277,141039,126225,,,,,0,0,0,0
1650448106.283825,public.usertable,118119,14360,153796608,16893,public,usertable,1,0,70385,528092,126440,6578,8321,1666,118119,14360,141339,126440,,,,,0,0,0,0
1650448107.3126395,public.usertable,118267,14477,154116096,16893,public,usertable,1,0,71117,531523,126666,6621,8399,1673,118267,14477,141686,126666,,,,,0,0,0,0
1650448108.3415976,public.usertable,118485,14609,154525696,16893,public,usertable,1,0,71972,538492,126963,6684,8478,1695,118485,14609,142125,126963,,,,,0,0,0,0
1650448109.371223,public.usertable,118721,14741,154943488,16893,public,usertable,1,0,72819,544676,127269,6750,8548,1717,118721,14741,142567,127269,,,,,0,0,0,0
1650448110.3998106,public.usertable,118972,14862,155385856,16893,public,usertable,1,0,73663,551368,127588,6810,8616,1738,118972,14862,143014,127588,,,,,0,0,0,0
1650448111.4299474,public.usertable,119222,14985,155795456,16893,public,usertable,1,0,74491,556812,127897,6877,8675,1760,119222,14985,143449,127897,,,,,0,0,0,0
1650448112.4582963,public.usertable,119478,15080,156205056,16893,public,usertable,1,0,75237,560714,128212,6921,8734,1776,119478,15080,143867,128212,,,,,0,0,0,0
1650448113.488977,public.usertable,119730,15190,156639232,16893,public,usertable,1,0,76071,565197,128528,6979,8798,1796,119730,15190,144305,128528,,,,,0,0,0,0
1650448114.5196936,public.usertable,119947,15322,157032448,16893,public,usertable,1,0,76862,570121,128826,7032,8879,1814,119947,15322,144737,128826,,,,,0,0,0,0
1650448115.5484743,public.usertable,120202,15462,157466624,16893,public,usertable,1,0,77803,573878,129149,7112,8947,1848,120202,15462,145208,129149,,,,,0,0,0,0
1650448116.5776975,public.usertable,120440,15592,157908992,16893,public,usertable,1,0,78668,576488,129460,7178,9020,1870,120440,15592,145658,129460,,,,,0,0,0,0
1650448117.606163,public.usertable,120687,15704,158343168,16893,public,usertable,1,0,79524,580303,129774,7236,9087,1884,120687,15704,146097,129774,,,,,0,0,0,0
1650448118.6348178,public.usertable,120933,15822,158744576,16893,public,usertable,1,0,80363,582764,130089,7288,9156,1907,120933,15822,146533,130089,,,,,0,0,0,0
1650448119.664286,public.usertable,121161,15975,159186944,16893,public,usertable,1,0,81220,585192,130402,7358,9241,1929,121161,15975,147001,130402,,,,,0,0,0,0
1650448120.6931655,public.usertable,121402,16107,159596544,16893,public,usertable,1,0,82084,589739,130720,7419,9318,1949,121402,16107,147457,130720,,,,,0,0,0,0
1650448121.7266164,public.usertable,121597,16231,159981568,16893,public,usertable,1,0,82921,593746,130987,7479,9390,1969,121597,16231,147856,130987,,,,,0,0,0,0
1650448122.7563477,public.usertable,121842,16334,160391168,16893,public,usertable,1,0,83738,598574,131299,7526,9457,1993,121842,16334,148282,131299,,,,,0,0,0,0
1650448123.7866833,public.usertable,122092,16468,160825344,16893,public,usertable,1,0,84566,601706,131618,7594,9526,2014,122092,16468,148738,131618,,,,,0,0,0,0
1650448124.8156893,public.usertable,122330,16604,161259520,16893,public,usertable,1,0,85432,603797,131933,7657,9603,2038,122330,16604,149193,131933,,,,,0,0,0,0
1650448125.844802,public.usertable,122696,16815,161693696,16893,public,usertable,1,0,86780,608373,132416,7758,9720,2080,122696,16815,149894,132416,,,,,0,0,0,0
1650448126.8731427,public.usertable,122952,16937,162119680,16893,public,usertable,1,0,87716,613429,132735,7820,9783,2106,122952,16937,150338,132735,,,,,0,0,0,0
1650448127.9040785,public.usertable,123204,17036,162512896,16893,public,usertable,1,0,88422,616273,133037,7873,9833,2130,123204,17036,150743,133037,,,,,0,0,0,0
1650448128.9360387,public.usertable,123405,17145,162889728,16893,public,usertable,1,0,89213,618969,133312,7916,9907,2144,123405,17145,151135,133312,,,,,0,0,0,0
1650448129.965487,public.usertable,123635,17249,163266560,16893,public,usertable,1,0,90049,624457,133606,7970,9971,2163,123635,17249,151547,133606,,,,,0,0,0,0
1650448130.9955251,public.usertable,123811,17349,163594240,16893,public,usertable,1,0,90704,626443,133836,8017,10025,2177,123811,17349,151878,133836,,,,,0,0,0,0
1650448132.0245833,public.usertable,124059,17455,164003840,16893,public,usertable,1,0,91458,629563,134148,8064,10089,2187,124059,17455,152301,134148,,,,,0,0,0,0
1650448133.0518615,public.usertable,124276,17566,164397056,16893,public,usertable,1,0,92246,632286,134435,8106,10159,2204,124276,17566,152700,134435,,,,,0,0,0,0
1650448134.0805726,public.usertable,124518,17664,164790272,16893,public,usertable,1,0,92995,635749,134737,8147,10219,2215,124518,17664,153103,134737,,,,,0,0,0,0
1650448135.1103458,public.usertable,124727,17772,165158912,16893,public,usertable,1,0,93725,641138,135008,8200,10281,2231,124727,17772,153489,135008,,,,,0,0,0,0
1650448136.1388943,public.usertable,124909,17874,165478400,16893,public,usertable,1,0,94351,643967,135253,8240,10344,2246,124909,17874,153837,135253,,,,,0,0,0,0
1650448137.1697023,public.usertable,125128,17972,165879808,16893,public,usertable,1,0,95009,648460,135534,8284,10406,2258,125128,17972,154224,135534,,,,,0,0,0,0
1650448138.2002475,public.usertable,125376,18095,166281216,16893,public,usertable,1,0,95788,651311,135845,8347,10469,2281,125376,18095,154661,135845,,,,,0,0,0,0
1650448139.2300143,public.usertable,125592,18213,166658048,16893,public,usertable,1,0,96549,657174,136132,8397,10540,2297,125592,18213,155069,136132,,,,,0,0,0,0
1650448140.2603555,public.usertable,125823,18308,167067648,16893,public,usertable,1,0,97302,660687,136430,8427,10607,2305,125823,18308,155464,136430,,,,,0,0,0,0
1650448141.291229,public.usertable,126087,18413,167501824,16893,public,usertable,1,0,98044,663519,136749,8480,10662,2323,126087,18413,155891,136749,,,,,0,0,0,0
1650448142.3195589,public.usertable,126361,18534,167936000,16893,public,usertable,1,0,98951,666879,137084,8540,10723,2347,126361,18534,156347,137084,,,,,0,0,0,0
1650448143.3502429,public.usertable,126614,18634,168370176,16893,public,usertable,1,0,99827,674141,137408,8591,10794,2359,126614,18634,156793,137408,,,,,0,0,0,0
1650448144.3818338,public.usertable,126844,18752,168755200,16893,public,usertable,1,0,100645,676903,137710,8645,10866,2376,126844,18752,157221,137710,,,,,0,0,0,0
1650448145.41264,public.usertable,127193,18910,169156608,16893,public,usertable,1,0,101833,684180,138160,8712,10967,2404,127193,18910,157839,138160,,,,,0,0,0,0
1650448146.441599,public.usertable,127457,19025,169598976,16893,public,usertable,1,0,102704,687202,138487,8767,11030,2427,127457,19025,158284,138487,,,,,0,0,0,0
1650448147.4707131,public.usertable,127742,19155,170074112,16893,public,usertable,1,0,103590,691141,138841,8836,11099,2454,127742,19155,158776,138841,,,,,0,0,0,0
1650448148.5031033,public.usertable,127970,19273,170459136,16893,public,usertable,1,0,104454,693930,139141,8888,11171,2476,127970,19273,159200,139141,,,,,0,0,0,0
1650448149.5344026,public.usertable,128202,19397,170876928,16893,public,usertable,1,0,105352,696150,139444,8944,11242,2495,128202,19397,159630,139444,,,,,0,0,0,0
1650448150.5631657,public.usertable,128456,19513,171294720,16893,public,usertable,1,0,106286,700769,139763,9000,11307,2517,128456,19513,160070,139763,,,,,0,0,0,0
1650448151.593068,public.usertable,128712,19630,171704320,16893,public,usertable,1,0,107073,703828,140093,9049,11381,2535,128712,19630,160523,140093,,,,,0,0,0,0
1650448152.621947,public.usertable,128929,19728,172105728,16893,public,usertable,1,0,107779,707638,140376,9085,11447,2547,128929,19728,160908,140376,,,,,0,0,0,0
1650448153.6550374,public.usertable,129186,19837,172539904,16893,public,usertable,1,0,108668,712525,140695,9141,11509,2568,129186,19837,161345,140695,,,,,0,0,0,0
1650448154.6844673,public.usertable,129457,19944,172965888,16893,public,usertable,1,0,109435,715236,141025,9190,11568,2585,129457,19944,161783,141025,,,,,0,0,0,0
1650448155.712647,public.usertable,129703,20068,173383680,16893,public,usertable,1,0,110306,716984,141346,9246,11643,2611,129703,20068,162235,141346,,,,,0,0,0,0
1650448156.7412953,public.usertable,129979,20180,173850624,16893,public,usertable,1,0,111242,719927,141690,9295,11711,2632,129979,20180,162696,141690,,,,,0,0,0,0
1650448157.772182,public.usertable,130271,20300,174325760,16893,public,usertable,1,0,112192,723026,142047,9352,11776,2658,130271,20300,163175,142047,,,,,0,0,0,0
1650448158.802142,public.usertable,130541,20434,174776320,16893,public,usertable,1,0,113054,726748,142396,9409,11855,2676,130541,20434,163660,142396,,,,,0,0,0,0
1650448159.8313313,public.usertable,130793,20561,175243264,16893,public,usertable,1,0,113941,730593,142727,9462,11934,2693,130793,20561,164123,142727,,,,,0,0,0,0
1650448160.8613222,public.usertable,131104,20652,175685632,16893,public,usertable,1,0,114701,734092,143092,9512,11988,2712,131104,20652,164592,143092,,,,,0,0,0,0
1650448161.890716,public.usertable,131353,20759,176078848,16893,public,usertable,1,0,115566,739138,143401,9562,12048,2729,131353,20759,165011,143401,,,,,0,0,0,0
1650448162.920488,public.usertable,131601,20855,176496640,16893,public,usertable,1,0,116427,743592,143698,9616,12097,2748,131601,20855,165411,143698,,,,,0,0,0,0
1650448163.9493768,public.usertable,131965,21011,176889856,16893,public,usertable,1,0,117652,747761,144154,9690,12189,2771,131965,21011,166033,144154,,,,,0,0,0,0
1650448164.9805143,public.usertable,132224,21119,177324032,16893,public,usertable,1,0,118534,750173,144475,9745,12251,2788,132224,21119,166471,144475,,,,,0,0,0,0
1650448166.0096157,public.usertable,132445,21232,177717248,16893,public,usertable,1,0,119385,753753,144763,9797,12318,2808,132445,21232,166878,144763,,,,,0,0,0,0
1650448167.0386546,public.usertable,132717,21363,178184192,16893,public,usertable,1,0,120285,755786,145114,9853,12397,2825,132717,21363,167364,145114,,,,,0,0,0,0
1650448168.0724034,public.usertable,132960,21477,178593792,16893,public,usertable,1,0,121231,761731,145430,9906,12470,2847,132960,21477,167806,145430,,,,,0,0,0,0
1650448169.1020215,public.usertable,133199,21585,179003392,16893,public,usertable,1,0,122060,767358,145737,9958,12538,2866,133199,21585,168233,145737,,,,,0,0,0,0
1650448170.1330972,public.usertable,133463,21702,179437568,16893,public,usertable,1,0,122907,770246,146070,10014,12607,2885,133463,21702,168691,146070,,,,,0,0,0,0
1650448171.1638443,public.usertable,133694,21802,179838976,16893,public,usertable,1,0,123736,775169,146366,10057,12672,2898,133694,21802,169095,146366,,,,,0,0,0,0
1650448172.1926188,public.usertable,133947,21901,180248576,16893,public,usertable,1,0,124485,776910,146666,10111,12719,2916,133947,21901,169496,146666,,,,,0,0,0,0
1650448173.2260652,public.usertable,134211,21992,180666368,16893,public,usertable,1,0,125312,780223,146979,10161,12768,2933,134211,21992,169908,146979,,,,,0,0,0,0
1650448174.2556658,public.usertable,134434,22122,181059584,16893,public,usertable,1,0,126206,783775,147283,10215,12849,2951,134434,22122,170347,147283,,,,,0,0,0,0
1650448175.2854652,public.usertable,134686,22234,181485568,16893,public,usertable,1,0,127072,788668,147608,10259,12922,2972,134686,22234,170789,147608,,,,,0,0,0,0
1650448176.3161657,public.usertable,134956,22331,181927936,16893,public,usertable,1,0,127889,790754,147935,10306,12979,2989,134956,22331,171220,147935,,,,,0,0,0,0
1650448177.3450403,public.usertable,135192,22451,182337536,16893,public,usertable,1,0,128775,793300,148242,10360,13050,3009,135192,22451,171652,148242,,,,,0,0,0,0
1650448178.3752131,public.usertable,135434,22568,182738944,16893,public,usertable,1,0,129491,797748,148551,10415,13117,3027,135434,22568,172083,148551,,,,,0,0,0,0
1650448179.4087276,public.usertable,135722,22660,183189504,16893,public,usertable,1,0,130349,800134,148884,10466,13162,3048,135722,22660,172512,148884,,,,,0,0,0,0
1650448180.439023,public.usertable,136006,22759,183640064,16893,public,usertable,1,0,131205,806111,149235,10510,13229,3066,136006,22759,172974,149235,,,,,0,0,0,0
1650448181.469638,public.usertable,136262,22889,184066048,16893,public,usertable,1,0,132121,810131,149566,10568,13304,3089,136262,22889,173438,149566,,,,,0,0,0,0
1650448182.5007267,public.usertable,136600,23066,184467456,16893,public,usertable,1,0,133415,815908,150024,10635,13424,3119,136600,23066,174083,150024,,,,,0,0,0,0
1650448183.5306823,public.usertable,136862,23196,184918016,16893,public,usertable,1,0,134344,820156,150359,10697,13497,3141,136862,23196,174553,150359,,,,,0,0,0,0
1650448184.561889,public.usertable,137158,23311,185384960,16893,public,usertable,1,0,135255,822665,150711,10759,13553,3162,137158,23311,175023,150711,,,,,0,0,0,0
1650448185.5910556,public.usertable,137406,23432,185819136,16893,public,usertable,1,0,136105,825415,151026,10814,13620,3177,137406,23432,175460,151026,,,,,0,0,0,0
1650448186.622096,public.usertable,137703,23516,186269696,16893,public,usertable,1,0,136885,828706,151370,10860,13667,3190,137703,23516,175897,151370,,,,,0,0,0,0
1650448187.6531124,public.usertable,137958,23639,186695680,16893,public,usertable,1,0,137843,832913,151700,10918,13742,3219,137958,23639,176360,151700,,,,,0,0,0,0
1650448188.6818526,public.usertable,138206,23755,187121664,16893,public,usertable,1,0,138675,836867,152013,10977,13807,3245,138206,23755,176797,152013,,,,,0,0,0,0
1650448189.7108285,public.usertable,138468,23887,187572224,16893,public,usertable,1,0,139584,840719,152346,11040,13878,3269,138468,23887,177264,152346,,,,,0,0,0,0
1650448190.7416923,public.usertable,138740,24018,188039168,16893,public,usertable,1,0,140534,843507,152692,11099,13952,3288,138740,24018,177743,152692,,,,,0,0,0,0
1650448191.7739968,public.usertable,139028,24123,188489728,16893,public,usertable,1,0,141500,847992,153037,11156,14009,3306,139028,24123,178202,153037,,,,,0,0,0,0
1650448192.8054974,public.usertable,139278,24231,188882944,16893,public,usertable,1,0,142278,849919,153344,11208,14066,3324,139278,24231,178618,153344,,,,,0,0,0,0
1650448193.8365657,public.usertable,139547,24322,189300736,16893,public,usertable,1,0,143051,854413,153659,11262,14112,3340,139547,24322,179033,153659,,,,,0,0,0,0
1650448194.8653843,public.usertable,139816,24413,189726720,16893,public,usertable,1,0,143910,857850,153980,11306,14164,3360,139816,24413,179450,153980,,,,,0,0,0,0
1650448195.89488,public.usertable,140090,24508,190136320,16893,public,usertable,1,0,144697,859973,154310,11350,14220,3375,140090,24508,179880,154310,,,,,0,0,0,0
1650448196.924977,public.usertable,140310,24608,190521344,16893,public,usertable,1,0,145446,863683,154584,11401,14274,3393,140310,24608,180259,154584,,,,,0,0,0,0
1650448197.9576232,public.usertable,140552,24710,190922752,16893,public,usertable,1,0,146201,866994,154882,11452,14330,3411,140552,24710,180664,154882,,,,,0,0,0,0
1650448198.9857893,public.usertable,140792,24803,191283200,16893,public,usertable,1,0,147074,869634,155186,11482,14394,3421,140792,24803,181062,155186,,,,,0,0,0,0
1650448200.0151281,public.usertable,141134,24935,191660032,16893,public,usertable,1,0,148148,873421,155610,11536,14476,3445,141134,24935,181622,155610,,,,,0,0,0,0
1650448201.044492,public.usertable,141363,25024,192028672,16893,public,usertable,1,0,148877,876231,155887,11579,14524,3459,141363,25024,181990,155887,,,,,0,0,0,0
1650448202.0732403,public.usertable,141608,25115,192430080,16893,public,usertable,1,0,149736,880283,156187,11626,14579,3473,141608,25115,182392,156187,,,,,0,0,0,0
1650448203.1022453,public.usertable,141847,25221,192831488,16893,public,usertable,1,0,150511,883340,156492,11667,14645,3489,141847,25221,182804,156492,,,,,0,0,0,0
1650448204.1313283,public.usertable,142121,25306,193241088,16893,public,usertable,1,0,151373,888222,156813,11716,14692,3509,142121,25306,183221,156813,,,,,0,0,0,0
1650448205.162399,public.usertable,142393,25408,193683456,16893,public,usertable,1,0,152235,891737,157142,11765,14749,3527,142393,25408,183656,157142,,,,,0,0,0,0
1650448206.1901476,public.usertable,142675,25504,194117632,16893,public,usertable,1,0,153137,894893,157480,11812,14805,3544,142675,25504,184097,157480,,,,,0,0,0,0
1650448207.2197008,public.usertable,142958,25625,194560000,16893,public,usertable,1,0,154105,896969,157830,11866,14872,3570,142958,25625,184568,157830,,,,,0,0,0,0
1650448208.2478566,public.usertable,143190,25739,194969600,16893,public,usertable,1,0,154913,900547,158126,11923,14936,3597,143190,25739,184985,158126,,,,,0,0,0,0
1650448209.2787373,public.usertable,143452,25841,195395584,16893,public,usertable,1,0,155788,903410,158448,11966,14996,3611,143452,25841,185410,158448,,,,,0,0,0,0
1650448210.3083634,public.usertable,143689,25940,195772416,16893,public,usertable,1,0,156597,906862,158748,12011,15059,3627,143689,25940,185818,158748,,,,,0,0,0,0
1650448211.337918,public.usertable,143906,26024,196124672,16893,public,usertable,1,0,157254,908613,159012,12054,15106,3642,143906,26024,186172,159012,,,,,0,0,0,0
1650448212.3686821,public.usertable,144149,26117,196542464,16893,public,usertable,1,0,158039,909926,159315,12094,15166,3657,144149,26117,186575,159315,,,,,0,0,0,0
1650448213.4000194,public.usertable,144410,26193,196935680,16893,public,usertable,1,0,158787,912462,159623,12130,15213,3670,144410,26193,186966,159623,,,,,0,0,0,0
1650448214.430054,public.usertable,144672,26290,197353472,16893,public,usertable,1,0,159618,914827,159933,12188,15261,3698,144672,26290,187382,159933,,,,,0,0,0,0
1650448215.4618132,public.usertable,144942,26399,197804032,16893,public,usertable,1,0,160557,918994,160271,12240,15329,3724,144942,26399,187840,160271,,,,,0,0,0,0
1650448216.4935675,public.usertable,145252,26498,198287360,16893,public,usertable,1,0,161519,924298,160640,12285,15388,3744,145252,26498,188313,160640,,,,,0,0,0,0
1650448217.5248468,public.usertable,145566,26584,198729728,16893,public,usertable,1,0,162474,927375,161012,12319,15446,3756,145566,26584,188777,161012,,,,,0,0,0,0
1650448218.5543733,public.usertable,145848,26686,199163904,16893,public,usertable,1,0,163341,931529,161353,12367,15505,3774,145848,26686,189225,161353,,,,,0,0,0,0
1650448219.58578,public.usertable,146245,26823,199589888,16893,public,usertable,1,0,164510,938794,161831,12433,15586,3799,146245,26823,189850,161831,,,,,0,0,0,0
1650448220.6155899,public.usertable,146503,26923,200007680,16893,public,usertable,1,0,165370,941809,162151,12474,15648,3816,146503,26923,190273,162151,,,,,0,0,0,0
1650448221.6452057,public.usertable,146770,27013,200425472,16893,public,usertable,1,0,166246,945914,162477,12514,15707,3835,146770,27013,190698,162477,,,,,0,0,0,0
1650448222.6756608,public.usertable,147027,27116,200859648,16893,public,usertable,1,0,167081,948956,162802,12553,15775,3848,147027,27116,191130,162802,,,,,0,0,0,0
1650448223.7035558,public.usertable,147305,27220,201285632,16893,public,usertable,1,0,167977,952895,163138,12604,15833,3872,147305,27220,191575,163138,,,,,0,0,0,0
1650448224.7317898,public.usertable,147595,27323,201728000,16893,public,usertable,1,0,168773,956645,163492,12646,15897,3895,147595,27323,192035,163492,,,,,0,0,0,0
1650448225.7622664,public.usertable,147883,27417,202186752,16893,public,usertable,1,0,169713,960096,163835,12691,15952,3917,147883,27417,192478,163835,,,,,0,0,0,0
1650448226.7957926,public.usertable,148157,27539,202653696,16893,public,usertable,1,0,170658,966240,164187,12744,16030,3937,148157,27539,192961,164187,,,,,0,0,0,0
1650448227.8277798,public.usertable,148454,27656,203120640,16893,public,usertable,1,0,171597,969499,164543,12807,16089,3967,148454,27656,193439,164543,,,,,0,0,0,0
1650448228.857483,public.usertable,148739,27758,203563008,16893,public,usertable,1,0,172511,973487,164882,12861,16143,3984,148739,27758,193886,164882,,,,,0,0,0,0
1650448229.8864973,public.usertable,149019,27840,204021760,16893,public,usertable,1,0,173387,976968,165226,12902,16207,3996,149019,27840,194335,165226,,,,,0,0,0,0
1650448230.9163153,public.usertable,149318,27937,204447744,16893,public,usertable,1,0,174216,980075,165585,12943,16267,4017,149318,27937,194795,165585,,,,,0,0,0,0
1650448231.9454894,public.usertable,149596,28030,204881920,16893,public,usertable,1,0,175012,982672,165915,12986,16319,4034,149596,28030,195220,165915,,,,,0,0,0,0
1650448232.97352,public.usertable,149854,28125,205299712,16893,public,usertable,1,0,175932,988063,166228,13033,16374,4049,149854,28125,195635,166228,,,,,0,0,0,0
1650448234.0015066,public.usertable,150119,28208,205709312,16893,public,usertable,1,0,176745,992433,166546,13071,16427,4066,150119,28208,196044,166546,,,,,0,0,0,0
1650448235.033152,public.usertable,150402,28296,206159872,16893,public,usertable,1,0,177566,995922,166880,13111,16478,4079,150402,28296,196469,166880,,,,,0,0,0,0
1650448236.069819,public.usertable,150692,28392,206602240,16893,public,usertable,1,0,178506,1000959,167233,13161,16541,4102,150692,28392,196935,167233,,,,,0,0,0,0
1650448237.1023138,public.usertable,151061,28565,207011840,16893,public,usertable,1,0,179799,1005266,167709,13230,16648,4131,151061,28565,197587,167709,,,,,0,0,0,0
1650448238.132049,public.usertable,151318,28674,207429632,16893,public,usertable,1,0,180662,1009640,168027,13284,16709,4155,151318,28674,198020,168027,,,,,0,0,0,0
1650448239.1606028,public.usertable,151621,28752,207880192,16893,public,usertable,1,0,181530,1013907,168372,13327,16751,4172,151621,28752,198450,168372,,,,,0,0,0,0
1650448240.1897686,public.usertable,151891,28858,208330752,16893,public,usertable,1,0,182414,1017095,168711,13375,16820,4188,151891,28858,198906,168711,,,,,0,0,0,0
1650448241.2199378,public.usertable,152161,28968,208773120,16893,public,usertable,1,0,183341,1020077,169052,13421,16891,4212,152161,28968,199364,169052,,,,,0,0,0,0
1650448242.2496378,public.usertable,152462,29067,209223680,16893,public,usertable,1,0,184249,1023613,169412,13467,16950,4228,152462,29067,199829,169412,,,,,0,0,0,0
1650448243.2798374,public.usertable,152731,29182,209674240,16893,public,usertable,1,0,185098,1027589,169757,13509,17026,4247,152731,29182,200292,169757,,,,,0,0,0,0
1650448244.3093684,public.usertable,153001,29269,210092032,16893,public,usertable,1,0,185919,1031056,170084,13545,17083,4263,153001,29269,200712,170084,,,,,0,0,0,0
1650448245.3385487,public.usertable,153269,29387,210550784,16893,public,usertable,1,0,186889,1033660,170427,13595,17158,4279,153269,29387,201180,170427,,,,,0,0,0,0
1650448246.3675585,public.usertable,153520,29493,210960384,16893,public,usertable,1,0,187739,1035233,170749,13634,17229,4292,153520,29493,201612,170749,,,,,0,0,0,0
1650448247.396656,public.usertable,153808,29591,211410944,16893,public,usertable,1,0,188649,1037519,171097,13676,17289,4313,153808,29591,202062,171097,,,,,0,0,0,0
1650448248.425235,public.usertable,154086,29673,211836928,16893,public,usertable,1,0,189529,1039820,171421,13723,17335,4328,154086,29673,202479,171421,,,,,0,0,0,0
1650448249.4539392,public.usertable,154371,29775,212295680,16893,public,usertable,1,0,190301,1042245,171768,13770,17397,4341,154371,29775,202935,171768,,,,,0,0,0,0
1650448250.4851818,public.usertable,154632,29877,212688896,16893,public,usertable,1,0,191109,1044363,172086,13818,17454,4361,154632,29877,203358,172086,,,,,0,0,0,0
1650448251.514478,public.usertable,154889,29956,213082112,16893,public,usertable,1,0,191874,1045907,172389,13854,17500,4378,154889,29956,203743,172389,,,,,0,0,0,0
1650448252.5461948,public.usertable,155153,30055,213499904,16893,public,usertable,1,0,192669,1049610,172708,13904,17555,4403,155153,30055,204167,172708,,,,,0,0,0,0
1650448253.5743308,public.usertable,155413,30141,213909504,16893,public,usertable,1,0,193497,1052229,173027,13941,17614,4415,155413,30141,204582,173027,,,,,0,0,0,0
1650448254.6032863,public.usertable,155667,30225,214302720,16893,public,usertable,1,0,194312,1055517,173334,13981,17667,4434,155667,30225,204982,173334,,,,,0,0,0,0
1650448255.6323893,public.usertable,156075,30362,214728704,16893,public,usertable,1,0,195471,1061016,173820,14043,17745,4460,156075,30362,205608,173820,,,,,0,0,0,0
1650448256.6627715,public.usertable,156325,30452,215121920,16893,public,usertable,1,0,196262,1064382,174119,14087,17794,4479,156325,30452,206000,174119,,,,,0,0,0,0
1650448257.6927454,public.usertable,156584,30549,215539712,16893,public,usertable,1,0,197138,1069120,174435,14133,17851,4501,156584,30549,206419,174435,,,,,0,0,0,0
1650448258.7225716,public.usertable,156844,30657,215932928,16893,public,usertable,1,0,198043,1072739,174754,14186,17910,4524,156844,30657,206850,174754,,,,,0,0,0,0
1650448259.7537427,public.usertable,157110,30740,216358912,16893,public,usertable,1,0,198885,1076034,175069,14227,17959,4540,157110,30740,207255,175069,,,,,0,0,0,0
1650448260.785636,public.usertable,157412,30813,216801280,16893,public,usertable,1,0,199726,1081201,175410,14269,17998,4555,157412,30813,207677,175410,,,,,0,0,0,0
1650448261.8145638,public.usertable,157708,30907,217260032,16893,public,usertable,1,0,200697,1083938,175761,14320,18053,4581,157708,30907,208134,175761,,,,,0,0,0,0
1650448262.845701,public.usertable,158016,31001,217718784,16893,public,usertable,1,0,201596,1085931,176128,14359,18112,4596,158016,31001,208599,176128,,,,,0,0,0,0
1650448263.8772132,public.usertable,158237,31116,218087424,16893,public,usertable,1,0,202433,1089470,176421,14409,18184,4626,158237,31116,209014,176421,,,,,0,0,0,0
1650448264.9055634,public.usertable,158485,31192,218480640,16893,public,usertable,1,0,203264,1091990,176721,14447,18236,4645,158485,31192,209404,176721,,,,,0,0,0,0
1650448265.9340174,public.usertable,158745,31268,218890240,16893,public,usertable,1,0,204060,1094195,177026,14483,18281,4652,158745,31268,209790,177026,,,,,0,0,0,0
1650448266.9639642,public.usertable,159037,31365,219357184,16893,public,usertable,1,0,205020,1097196,177379,14521,18342,4663,159037,31365,210242,177379,,,,,0,0,0,0
1650448267.993728,public.usertable,159331,31452,219791360,16893,public,usertable,1,0,205904,1100344,177735,14568,18404,4684,159331,31452,210707,177735,,,,,0,0,0,0
1650448269.0236123,public.usertable,159577,31550,220217344,16893,public,usertable,1,0,206739,1102922,178039,14611,18462,4701,159577,31550,211112,178039,,,,,0,0,0,0
1650448270.0525765,public.usertable,159864,31651,220684288,16893,public,usertable,1,0,207683,1105011,178395,14656,18531,4718,159864,31651,211582,178395,,,,,0,0,0,0
1650448271.0821033,public.usertable,160173,31747,221159424,16893,public,usertable,1,0,208608,1108079,178760,14709,18587,4746,160173,31747,212056,178760,,,,,0,0,0,0
1650448272.1108,public.usertable,160482,31848,221618176,16893,public,usertable,1,0,209525,1111924,179131,14750,18649,4761,160482,31848,212530,179131,,,,,0,0,0,0
1650448273.1398623,public.usertable,160775,31935,222060544,16893,public,usertable,1,0,210433,1114907,179483,14786,18708,4781,160775,31935,212977,179483,,,,,0,0,0,0
1650448274.1692164,public.usertable,161080,32033,222519296,16893,public,usertable,1,0,211511,1117268,179839,14835,18759,4804,161080,32033,213433,179839,,,,,0,0,0,0
1650448275.197861,public.usertable,161496,32184,222937088,16893,public,usertable,1,0,212798,1120719,180333,14912,18837,4837,161496,32184,214082,180333,,,,,0,0,0,0
1650448276.2270522,public.usertable,161774,32285,223387648,16893,public,usertable,1,0,213669,1123725,180676,14961,18902,4855,161774,32285,214539,180676,,,,,0,0,0,0
1650448277.2577374,public.usertable,162057,32387,223838208,16893,public,usertable,1,0,214582,1127088,181018,15010,18961,4875,162057,32387,214989,181018,,,,,0,0,0,0
1650448278.2858043,public.usertable,162365,32465,224280576,16893,public,usertable,1,0,215531,1128080,181372,15043,19007,4887,162365,32465,215422,181372,,,,,0,0,0,0
1650448279.3138196,public.usertable,162677,32559,224755712,16893,public,usertable,1,0,216389,1131929,181733,15091,19056,4907,162677,32559,215880,181733,,,,,0,0,0,0
1650448280.3449473,public.usertable,162959,32664,225214464,16893,public,usertable,1,0,217276,1134665,182075,15145,19116,4928,162959,32664,216336,182075,,,,,0,0,0,0
1650448281.3762789,public.usertable,163262,32751,225656832,16893,public,usertable,1,0,218145,1141045,182430,15190,19168,4947,163262,32751,216788,182430,,,,,0,0,0,0
1650448282.4091432,public.usertable,163542,32851,226091008,16893,public,usertable,1,0,219058,1145111,182770,15234,19228,4964,163542,32851,217232,182770,,,,,0,0,0,0
1650448283.441317,public.usertable,163801,32935,226508800,16893,public,usertable,1,0,219856,1149819,183087,15265,19286,4971,163801,32935,217638,183087,,,,,0,0,0,0
1650448284.473839,public.usertable,164067,33033,226934784,16893,public,usertable,1,0,220704,1152645,183404,15316,19337,4995,164067,33033,218057,183404,,,,,0,0,0,0
1650448285.5043838,public.usertable,164361,33117,227368960,16893,public,usertable,1,0,221525,1156264,183737,15367,19376,5016,164361,33117,218480,183737,,,,,0,0,0,0
1650448286.534538,public.usertable,164649,33205,227835904,16893,public,usertable,1,0,222383,1163900,184088,15403,19439,5027,164649,33205,218930,184088,,,,,0,0,0,0
1650448287.563757,public.usertable,164991,33302,228319232,16893,public,usertable,1,0,223339,1166235,184480,15453,19489,5047,164991,33302,219422,184480,,,,,0,0,0,0
1650448288.5941336,public.usertable,165262,33388,228753408,16893,public,usertable,1,0,224233,1169471,184797,15499,19535,5056,165262,33388,219831,184797,,,,,0,0,0,0
1650448289.6247342,public.usertable,165549,33471,229163008,16893,public,usertable,1,0,225033,1171229,185134,15536,19585,5074,165549,33471,220255,185134,,,,,0,0,0,0
1650448290.6564429,public.usertable,165816,33562,229580800,16893,public,usertable,1,0,225922,1173587,185454,15576,19638,5089,165816,33562,220668,185454,,,,,0,0,0,0
1650448291.6874862,public.usertable,166071,33643,229982208,16893,public,usertable,1,0,226734,1175531,185759,15611,19688,5100,166071,33643,221058,185759,,,,,0,0,0,0
1650448292.7212782,public.usertable,166474,33772,230383616,16893,public,usertable,1,0,228023,1177967,186235,15682,19761,5136,166474,33772,221678,186235,,,,,0,0,0,0
1650448293.7509186,public.usertable,166718,33854,230776832,16893,public,usertable,1,0,228856,1183459,186535,15718,19817,5149,166718,33854,222070,186535,,,,,0,0,0,0
1650448294.7795498,public.usertable,166979,33954,231186432,16893,public,usertable,1,0,229748,1186294,186852,15767,19873,5172,166979,33954,222492,186852,,,,,0,0,0,0
1650448295.8106754,public.usertable,167230,34046,231596032,16893,public,usertable,1,0,230540,1189758,187159,15808,19929,5188,167230,34046,222896,187159,,,,,0,0,0,0
1650448296.8403904,public.usertable,167480,34133,231972864,16893,public,usertable,1,0,231376,1191703,187459,15849,19979,5211,167480,34133,223287,187459,,,,,0,0,0,0
1650448297.869646,public.usertable,167766,34214,232407040,16893,public,usertable,1,0,232192,1193624,187794,15883,20028,5224,167766,34214,223705,187794,,,,,0,0,0,0
1650448298.900028,public.usertable,168016,34307,232800256,16893,public,usertable,1,0,233049,1197343,188102,15927,20086,5246,168016,34307,224115,188102,,,,,0,0,0,0
1650448299.9308696,public.usertable,168274,34400,233226240,16893,public,usertable,1,0,233944,1200837,188417,15970,20143,5266,168274,34400,224530,188417,,,,,0,0,0,0
1650448300.9593534,public.usertable,168564,34485,233676800,16893,public,usertable,1,0,234773,1203808,188764,16009,20200,5279,168564,34485,224973,188764,,,,,0,0,0,0
1650448301.9885612,public.usertable,168851,34584,234110976,16893,public,usertable,1,0,235675,1205643,189108,16055,20257,5295,168851,34584,225420,189108,,,,,0,0,0,0
1650448303.0193548,public.usertable,169125,34676,234561536,16893,public,usertable,1,0,236588,1207257,189436,16095,20311,5310,169125,34676,225842,189436,,,,,0,0,0,0
1650448304.0504386,public.usertable,169420,34762,234979328,16893,public,usertable,1,0,237468,1210615,189777,16141,20357,5327,169420,34762,226275,189777,,,,,0,0,0,0
1650448305.0791988,public.usertable,169645,34862,235331584,16893,public,usertable,1,0,238332,1213188,190063,16185,20418,5347,169645,34862,226666,190063,,,,,0,0,0,0
1650448306.1087584,public.usertable,169898,34930,235732992,16893,public,usertable,1,0,239076,1215021,190359,16212,20461,5356,169898,34930,227032,190359,,,,,0,0,0,0
1650448307.1392481,public.usertable,170149,35011,236093440,16893,public,usertable,1,0,239823,1216713,190653,16253,20504,5380,170149,35011,227410,190653,,,,,0,0,0,0
1650448308.1694555,public.usertable,170376,35096,236396544,16893,public,usertable,1,0,240548,1219110,190927,16293,20551,5395,170376,35096,227771,190927,,,,,0,0,0,0
1650448309.1977236,public.usertable,170561,35152,236716032,16893,public,usertable,1,0,241066,1220743,191146,16318,20585,5408,170561,35152,228049,191146,,,,,0,0,0,0
1650448310.2268639,public.usertable,170787,35231,237051904,16893,public,usertable,1,0,241883,1222137,191420,16359,20633,5433,170787,35231,228412,191420,,,,,0,0,0,0
1650448311.2555273,public.usertable,171030,35294,237404160,16893,public,usertable,1,0,242658,1223387,191693,16404,20663,5451,171030,35294,228760,191693,,,,,0,0,0,0
1650448312.2848067,public.usertable,171323,35373,237666304,16893,public,usertable,1,0,243539,1225815,192027,16445,20704,5473,171323,35373,229176,192027,,,,,0,0,0,0
1650448313.314265,public.usertable,171524,35436,237977600,16893,public,usertable,1,0,244208,1226845,192262,16475,20738,5487,171524,35436,229475,192262,,,,,0,0,0,0
1650448314.3451467,public.usertable,171725,35499,238288896,16893,public,usertable,1,0,244884,1230873,192510,16501,20785,5503,171725,35499,229796,192510,,,,,0,0,0,0
1650448315.3760724,public.usertable,171931,35572,238600192,16893,public,usertable,1,0,245608,1232954,192762,16534,20831,5520,171931,35572,230127,192762,,,,,0,0,0,0
1650448316.40452,public.usertable,172119,35629,238878720,16893,public,usertable,1,0,246083,1234098,192980,16561,20861,5532,172119,35629,230402,192980,,,,,0,0,0,0
1650448317.4331386,public.usertable,172305,35680,239149056,16893,public,usertable,1,0,246617,1235050,193190,16589,20885,5543,172305,35680,230664,193190,,,,,0,0,0,0
1650448318.4615052,public.usertable,172515,35725,239460352,16893,public,usertable,1,0,247303,1236521,193433,16606,20918,5550,172515,35725,230957,193433,,,,,0,0,0,0
1650448319.4910848,public.usertable,172713,35795,239779840,16893,public,usertable,1,0,247935,1237861,193673,16635,20960,5562,172713,35795,231268,193673,,,,,0,0,0,0
1650448320.5208774,public.usertable,172964,35858,240148480,16893,public,usertable,1,0,248700,1239499,193964,16667,21000,5576,172964,35858,231631,193964,,,,,0,0,0,0
1650448321.5497594,public.usertable,173196,35924,240500736,16893,public,usertable,1,0,249453,1243803,194239,16705,21043,5593,173196,35924,231987,194239,,,,,0,0,0,0
1650448322.5779364,public.usertable,173406,35989,240812032,16893,public,usertable,1,0,250128,1246647,194489,16738,21083,5608,173406,35989,232310,194489,,,,,0,0,0,0
1650448323.6082885,public.usertable,173648,36054,241197056,16893,public,usertable,1,0,250815,1247231,194769,16766,21121,5621,173648,36054,232656,194769,,,,,0,0,0,0
1650448324.6377404,public.usertable,173908,36126,241590272,16893,public,usertable,1,0,251624,1249907,195075,16800,21167,5628,173908,36126,233042,195075,,,,,0,0,0,0
1650448325.6697712,public.usertable,174157,36210,241999872,16893,public,usertable,1,0,252385,1251842,195380,16835,21223,5636,174157,36210,233438,195380,,,,,0,0,0,0
1650448326.6986947,public.usertable,174440,36301,242434048,16893,public,usertable,1,0,253238,1252755,195717,16872,21277,5648,174440,36301,233866,195717,,,,,0,0,0,0
1650448327.7293332,public.usertable,174717,36391,242868224,16893,public,usertable,1,0,254132,1254978,196050,16916,21333,5666,174717,36391,234299,196050,,,,,0,0,0,0
1650448328.763269,public.usertable,174979,36494,243286016,16893,public,usertable,1,0,255041,1256705,196378,16958,21399,5677,174979,36494,234735,196378,,,,,0,0,0,0
1650448329.793746,public.usertable,175226,36595,243720192,16893,public,usertable,1,0,255943,1258000,196696,16990,21470,5689,175226,36595,235156,196696,,,,,0,0,0,0
1650448330.8238256,public.usertable,175539,36656,244137984,16893,public,usertable,1,0,256870,1261777,197055,17024,21516,5703,175539,36656,235595,197055,,,,,0,0,0,0
1650448331.8555372,public.usertable,175939,36797,244563968,16893,public,usertable,1,0,258152,1264595,197532,17093,21593,5735,175939,36797,236218,197532,,,,,0,0,0,0
1650448332.8834546,public.usertable,176191,36899,244981760,16893,public,usertable,1,0,259038,1267450,197847,17145,21656,5761,176191,36899,236648,197847,,,,,0,0,0,0
1650448333.9123745,public.usertable,176495,36970,245415936,16893,public,usertable,1,0,259960,1270072,198193,17183,21698,5775,176495,36970,237074,198193,,,,,0,0,0,0
1650448334.9419034,public.usertable,176773,37056,245850112,16893,public,usertable,1,0,260882,1271592,198525,17225,21752,5789,176773,37056,237502,198525,,,,,0,0,0,0
1650448335.9723735,public.usertable,177035,37129,246235136,16893,public,usertable,1,0,261734,1274603,198832,17255,21797,5800,177035,37129,237884,198832,,,,,0,0,0,0
1650448337.0024521,public.usertable,177260,37184,246587392,16893,public,usertable,1,0,262424,1280089,199100,17278,21840,5809,177260,37184,238218,199100,,,,,0,0,0,0
1650448338.0325632,public.usertable,177576,37245,247029760,16893,public,usertable,1,0,263258,1283170,199455,17309,21879,5826,177576,37245,238643,199455,,,,,0,0,0,0
1650448339.0648544,public.usertable,177864,37334,247472128,16893,public,usertable,1,0,264164,1286495,199798,17350,21934,5850,177864,37334,239082,199798,,,,,0,0,0,0
1650448340.0957942,public.usertable,178137,37428,247881728,16893,public,usertable,1,0,265135,1288701,200130,17391,21993,5870,178137,37428,239514,200130,,,,,0,0,0,0
1650448341.1267583,public.usertable,178448,37498,248356864,16893,public,usertable,1,0,266022,1291015,200486,17422,22038,5883,178448,37498,239946,200486,,,,,0,0,0,0
1650448342.1590564,public.usertable,178744,37565,248766464,16893,public,usertable,1,0,266856,1293956,200826,17454,22082,5892,178744,37565,240362,200826,,,,,0,0,0,0
1650448343.1880805,public.usertable,179041,37651,249200640,16893,public,usertable,1,0,267656,1295262,201165,17499,22124,5920,179041,37651,240788,201165,,,,,0,0,0,0
1650448344.2219143,public.usertable,179330,37734,249626624,16893,public,usertable,1,0,268652,1298574,201500,17539,22170,5940,179330,37734,241209,201500,,,,,0,0,0,0
1650448345.251926,public.usertable,179612,37821,250068992,16893,public,usertable,1,0,269635,1300967,201837,17582,22225,5958,179612,37821,241644,201837,,,,,0,0,0,0
1650448346.28038,public.usertable,179896,37913,250519552,16893,public,usertable,1,0,270570,1304506,202173,17625,22277,5977,179896,37913,242075,202173,,,,,0,0,0,0
1650448347.3106213,public.usertable,180208,38004,250961920,16893,public,usertable,1,0,271530,1306395,202535,17672,22327,5996,180208,38004,242534,202535,,,,,0,0,0,0
1650448348.3407016,public.usertable,180483,38092,251412480,16893,public,usertable,1,0,272457,1309508,202867,17718,22384,6013,180483,38092,242969,202867,,,,,0,0,0,0
1650448349.3730903,public.usertable,180803,38166,251871232,16893,public,usertable,1,0,273405,1312760,203220,17767,22417,6040,180803,38166,243404,203220,,,,,0,0,0,0
1650448350.404638,public.usertable,181241,38293,252305408,16893,public,usertable,1,0,274652,1316994,203739,17823,22498,6063,181241,38293,244060,203739,,,,,0,0,0,0
1650448351.4345396,public.usertable,181517,38382,252731392,16893,public,usertable,1,0,275523,1319456,204074,17857,22557,6076,181517,38382,244488,204074,,,,,0,0,0,0
1650448352.4642994,public.usertable,181788,38469,253157376,16893,public,usertable,1,0,276347,1321755,204395,17906,22607,6100,181788,38469,244908,204395,,,,,0,0,0,0
1650448353.4968936,public.usertable,182085,38546,253591552,16893,public,usertable,1,0,277208,1323179,204734,17945,22649,6116,182085,38546,245328,204734,,,,,0,0,0,0
1650448354.5262496,public.usertable,182381,38631,254025728,16893,public,usertable,1,0,278129,1326582,205084,17979,22703,6133,182381,38631,245766,205084,,,,,0,0,0,0
1650448355.5560255,public.usertable,182669,38723,254476288,16893,public,usertable,1,0,278986,1329109,205426,18024,22757,6148,182669,38723,246207,205426,,,,,0,0,0,0
1650448356.5866895,public.usertable,182941,38808,254894080,16893,public,usertable,1,0,279918,1331575,205760,18060,22819,6164,182941,38808,246639,205760,,,,,0,0,0,0
1650448357.6174028,public.usertable,183234,38880,255336448,16893,public,usertable,1,0,280773,1333001,206094,18093,22860,6173,183234,38880,247047,206094,,,,,0,0,0,0
1650448358.6490476,public.usertable,183516,38965,255754240,16893,public,usertable,1,0,281750,1336762,206433,18130,22917,6193,183516,38965,247480,206433,,,,,0,0,0,0
1650448359.677882,public.usertable,183717,39038,256049152,16893,public,usertable,1,0,282404,1338066,206685,18156,22968,6205,183717,39038,247809,206685,,,,,0,0,0,0
1650448360.706569,public.usertable,183920,39100,256385024,16893,public,usertable,1,0,283031,1339736,206930,18180,23010,6220,183920,39100,248120,206930,,,,,0,0,0,0
1650448361.7357514,public.usertable,184180,39209,256802816,16893,public,usertable,1,0,283954,1341764,207254,18228,23074,6239,184180,39209,248556,207254,,,,,0,0,0,0
1650448362.7640438,public.usertable,184406,39266,257097728,16893,public,usertable,1,0,284668,1344652,207507,18263,23101,6257,184406,39266,248871,207507,,,,,0,0,0,0
1650448363.7944386,public.usertable,184585,39319,257376256,16893,public,usertable,1,0,285339,1346476,207720,18289,23135,6271,184585,39319,249144,207720,,,,,0,0,0,0
1650448364.823537,public.usertable,184796,39388,257703936,16893,public,usertable,1,0,285943,1347512,207965,18324,23169,6288,184796,39388,249458,207965,,,,,0,0,0,0
1650448365.8527951,public.usertable,185022,39457,258048000,16893,public,usertable,1,0,286696,1348844,208237,18352,23215,6302,185022,39457,249804,208237,,,,,0,0,0,0
1650448366.885362,public.usertable,185284,39534,258441216,16893,public,usertable,1,0,287456,1350855,208547,18383,23263,6315,185284,39534,250193,208547,,,,,0,0,0,0
1650448367.9156077,public.usertable,185542,39603,258883584,16893,public,usertable,1,0,288225,1352887,208849,18417,23307,6332,185542,39603,250573,208849,,,,,0,0,0,0
1650448368.9488804,public.usertable,185997,39744,259334144,16893,public,usertable,1,0,289738,1357512,209384,18489,23387,6365,185997,39744,251260,209384,,,,,0,0,0,0
1650448369.9792829,public.usertable,186314,39829,259801088,16893,public,usertable,1,0,290713,1360873,209752,18528,23438,6382,186314,39829,251718,209752,,,,,0,0,0,0
1650448371.0107882,public.usertable,186623,39911,260259840,16893,public,usertable,1,0,291732,1364874,210102,18579,23479,6398,186623,39911,252160,210102,,,,,0,0,0,0
1650448372.0414133,public.usertable,186936,40000,260734976,16893,public,usertable,1,0,292665,1367614,210468,18620,23532,6416,186936,40000,252620,210468,,,,,0,0,0,0
1650448373.0705423,public.usertable,187207,40086,261136384,16893,public,usertable,1,0,293584,1373189,210792,18659,23585,6432,187207,40086,253036,210792,,,,,0,0,0,0
1650448374.101048,public.usertable,187461,40142,261521408,16893,public,usertable,1,0,294322,1375872,211081,18687,23620,6444,187461,40142,253388,211081,,,,,0,0,0,0
1650448375.1316004,public.usertable,187745,40213,261922816,16893,public,usertable,1,0,295211,1378900,211401,18735,23656,6466,187745,40213,253792,211401,,,,,0,0,0,0
1650448376.1615593,public.usertable,188027,40285,262340608,16893,public,usertable,1,0,296015,1380893,211728,18770,23701,6483,188027,40285,254199,211728,,,,,0,0,0,0
1650448377.1899338,public.usertable,188355,40337,262807552,16893,public,usertable,1,0,296924,1384114,212088,18798,23733,6495,188355,40337,254619,212088,,,,,0,0,0,0
1650448378.2200031,public.usertable,188664,40420,263266304,16893,public,usertable,1,0,297852,1386255,212444,18839,23780,6510,188664,40420,255063,212444,,,,,0,0,0,0
1650448379.2507737,public.usertable,188946,40504,263684096,16893,public,usertable,1,0,298771,1390121,212773,18878,23827,6525,188946,40504,255478,212773,,,,,0,0,0,0
1650448380.2824085,public.usertable,189231,40573,264093696,16893,public,usertable,1,0,299619,1391897,213100,18915,23869,6544,189231,40573,255884,213100,,,,,0,0,0,0
1650448381.3119895,public.usertable,189490,40637,264486912,16893,public,usertable,1,0,300358,1393659,213400,18947,23910,6559,189490,40637,256257,213400,,,,,0,0,0,0
1650448382.3419826,public.usertable,189791,40718,264896512,16893,public,usertable,1,0,301311,1396207,213748,18983,23957,6580,189791,40718,256688,213748,,,,,0,0,0,0
1650448383.3737626,public.usertable,190037,40799,265289728,16893,public,usertable,1,0,302156,1398860,214045,19017,24008,6595,190037,40799,257070,214045,,,,,0,0,0,0
1650448384.4026456,public.usertable,190256,40868,265625600,16893,public,usertable,1,0,302894,1401570,214305,19051,24049,6606,190256,40868,257405,214305,,,,,0,0,0,0
1650448385.4322956,public.usertable,190563,40950,266092544,16893,public,usertable,1,0,303865,1403732,214664,19088,24101,6625,190563,40950,257853,214664,,,,,0,0,0,0
1650448386.4620926,public.usertable,190864,41032,266526720,16893,public,usertable,1,0,304855,1405992,215010,19129,24146,6643,190864,41032,258285,215010,,,,,0,0,0,0
1650448387.492985,public.usertable,191303,41159,266985472,16893,public,usertable,1,0,306189,1411461,215527,19193,24224,6676,191303,41159,258944,215527,,,,,0,0,0,0
1650448388.5231464,public.usertable,191583,41234,267395072,16893,public,usertable,1,0,307128,1414905,215855,19228,24272,6697,191583,41234,259355,215855,,,,,0,0,0,0
1650448389.553698,public.usertable,191884,41311,267837440,16893,public,usertable,1,0,308126,1416337,216201,19264,24317,6716,191884,41311,259782,216201,,,,,0,0,0,0
1650448390.5832472,public.usertable,192190,41385,268296192,16893,public,usertable,1,0,309020,1419602,216551,19301,24361,6727,192190,41385,260213,216551,,,,,0,0,0,0
1650448391.6126516,public.usertable,192438,41475,268673024,16893,public,usertable,1,0,309830,1420831,216856,19349,24418,6749,192438,41475,260623,216856,,,,,0,0,0,0
1650448392.6440854,public.usertable,192716,41557,269107200,16893,public,usertable,1,0,310698,1421982,217185,19387,24469,6764,192716,41557,261041,217185,,,,,0,0,0,0
1650448393.673949,public.usertable,192999,41636,269541376,16893,public,usertable,1,0,311583,1426090,217515,19425,24516,6783,192999,41636,261456,217515,,,,,0,0,0,0
1650448394.705147,public.usertable,193280,41728,269967360,16893,public,usertable,1,0,312451,1428596,217850,19468,24570,6806,193280,41728,261888,217850,,,,,0,0,0,0
1650448395.735496,public.usertable,193598,41796,270401536,16893,public,usertable,1,0,313364,1432549,218210,19504,24612,6822,193598,41796,262326,218210,,,,,0,0,0,0
1650448396.7640805,public.usertable,193870,41862,270819328,16893,public,usertable,1,0,314303,1434965,218530,19535,24660,6833,193870,41862,262725,218530,,,,,0,0,0,0
1650448397.7932596,public.usertable,194138,41947,271228928,16893,public,usertable,1,0,315109,1436826,218848,19581,24710,6857,194138,41947,263139,218848,,,,,0,0,0,0
1650448398.8238552,public.usertable,194416,42040,271663104,16893,public,usertable,1,0,316023,1438944,219183,19622,24767,6873,194416,42040,263572,219183,,,,,0,0,0,0
1650448399.8537605,public.usertable,194717,42126,272121856,16893,public,usertable,1,0,317013,1441335,219541,19661,24824,6892,194717,42126,264026,219541,,,,,0,0,0,0
1650448400.8825223,public.usertable,195058,42192,272621568,16893,public,usertable,1,0,318042,1443910,219926,19691,24868,6903,195058,42192,264485,219926,,,,,0,0,0,0
1650448401.9129162,public.usertable,195366,42267,273055744,16893,public,usertable,1,0,319000,1446673,220280,19727,24914,6921,195366,42267,264921,220280,,,,,0,0,0,0
1650448402.9422412,public.usertable,195672,42343,273489920,16893,public,usertable,1,0,319855,1448450,220624,19769,24952,6939,195672,42343,265345,220624,,,,,0,0,0,0
1650448403.972911,public.usertable,195929,42410,273858560,16893,public,usertable,1,0,320705,1451270,220925,19803,24996,6955,195929,42410,265724,220925,,,,,0,0,0,0
1650448405.0031207,public.usertable,196206,42479,274284544,16893,public,usertable,1,0,321485,1454288,221241,19843,25035,6973,196206,42479,266119,221241,,,,,0,0,0,0
1650448406.032906,public.usertable,196502,42556,274718720,16893,public,usertable,1,0,322384,1455387,221578,19882,25076,6986,196502,42556,266536,221578,,,,,0,0,0,0
1650448407.0630982,public.usertable,196936,42666,275144704,16893,public,usertable,1,0,323701,1459440,222078,19948,25142,7016,196936,42666,267168,222078,,,,,0,0,0,0
1650448408.0921855,public.usertable,197170,42762,275529728,16893,public,usertable,1,0,324629,1464047,222372,19990,25202,7029,197170,42762,267564,222372,,,,,0,0,0,0
1650448409.120683,public.usertable,197415,42842,275898368,16893,public,usertable,1,0,325471,1465944,222659,20029,25244,7049,197415,42842,267932,222659,,,,,0,0,0,0
1650448410.1522517,public.usertable,197685,42926,276332544,16893,public,usertable,1,0,326326,1468260,222975,20069,25290,7057,197685,42926,268334,222975,,,,,0,0,0,0
1650448411.1809647,public.usertable,197917,42995,276668416,16893,public,usertable,1,0,327103,1472598,223254,20098,25337,7069,197917,42995,268689,223254,,,,,0,0,0,0
1650448412.211319,public.usertable,198141,43050,276996096,16893,public,usertable,1,0,327778,1474332,223510,20126,25369,7085,198141,43050,269005,223510,,,,,0,0,0,0
1650448413.2411854,public.usertable,198345,43102,277299200,16893,public,usertable,1,0,328381,1476838,223748,20159,25403,7097,198345,43102,269310,223748,,,,,0,0,0,0
1650448414.2692575,public.usertable,198545,43146,277577728,16893,public,usertable,1,0,328965,1478003,223970,20182,25425,7107,198545,43146,269577,223970,,,,,0,0,0,0
1650448415.3013582,public.usertable,198735,43203,277864448,16893,public,usertable,1,0,329576,1479627,224192,20211,25457,7123,198735,43203,269860,224192,,,,,0,0,0,0
1650448416.3318822,public.usertable,198891,43249,278077440,16893,public,usertable,1,0,330077,1480930,224373,20237,25482,7135,198891,43249,270092,224373,,,,,0,0,0,0
1650448417.3639364,public.usertable,199058,43301,278364160,16893,public,usertable,1,0,330546,1482062,224572,20261,25514,7146,199058,43301,270347,224572,,,,,0,0,0,0
1650448418.3949995,public.usertable,199247,43346,278634496,16893,public,usertable,1,0,331157,1485337,224789,20288,25542,7150,199247,43346,270619,224789,,,,,0,0,0,0
1650448419.4273252,public.usertable,199454,43388,278921216,16893,public,usertable,1,0,331753,1487404,225026,20311,25572,7160,199454,43388,270909,225026,,,,,0,0,0,0
1650448420.4581318,public.usertable,199623,43443,279166976,16893,public,usertable,1,0,332337,1487950,225218,20344,25595,7177,199623,43443,271157,225218,,,,,0,0,0,0
1650448421.4858282,public.usertable,199822,43483,279478272,16893,public,usertable,1,0,332899,1489674,225440,20364,25618,7185,199822,43483,271422,225440,,,,,0,0,0,0
1650448422.5137963,public.usertable,200072,43556,279920640,16893,public,usertable,1,0,333700,1492301,225732,20397,25660,7195,200072,43556,271789,225732,,,,,0,0,0,0
1650448423.5433347,public.usertable,200405,43624,280395776,16893,public,usertable,1,0,334606,1494484,226102,20437,25697,7212,200405,43624,272236,226102,,,,,0,0,0,0
1650448424.5737493,public.usertable,200731,43695,280854528,16893,public,usertable,1,0,335552,1495862,226477,20464,25746,7223,200731,43695,272687,226477,,,,,0,0,0,0
1650448425.6053414,public.usertable,201057,43761,281305088,16893,public,usertable,1,0,336562,1499851,226849,20493,25792,7236,201057,43761,273134,226849,,,,,0,0,0,0
1650448426.6421824,public.usertable,201543,43888,281812992,16893,public,usertable,1,0,337995,1504403,227398,20568,25855,7263,201543,43888,273821,227398,,,,,0,0,0,0
1650448427.6725342,public.usertable,201888,43972,282312704,16893,public,usertable,1,0,339046,1506365,227792,20612,25904,7281,201888,43972,274308,227792,,,,,0,0,0,0
1650448428.702098,public.usertable,202136,44074,282722304,16893,public,usertable,1,0,339901,1509178,228100,20654,25964,7296,202136,44074,274718,228100,,,,,0,0,0,0
1650448429.7323892,public.usertable,202425,44155,283148288,16893,public,usertable,1,0,340831,1510790,228435,20690,26010,7312,202425,44155,275135,228435,,,,,0,0,0,0
1650448430.7629135,public.usertable,202740,44234,283607040,16893,public,usertable,1,0,341779,1512324,228799,20728,26059,7328,202740,44234,275586,228799,,,,,0,0,0,0
1650448431.796855,public.usertable,203072,44295,284090368,16893,public,usertable,1,0,342763,1515862,229176,20758,26104,7336,203072,44295,276038,229176,,,,,0,0,0,0
1650448432.8300922,public.usertable,203388,44380,284540928,16893,public,usertable,1,0,343701,1519612,229534,20806,26146,7354,203388,44380,276486,229534,,,,,0,0,0,0
1650448433.858698,public.usertable,203689,44458,284991488,16893,public,usertable,1,0,344599,1522455,229883,20842,26194,7370,203689,44458,276919,229883,,,,,0,0,0,0
1650448434.8886828,public.usertable,203960,44539,285417472,16893,public,usertable,1,0,345475,1523973,230206,20875,26246,7383,203960,44539,277327,230206,,,,,0,0,0,0
1650448435.9192677,public.usertable,204266,44626,285876224,16893,public,usertable,1,0,346434,1527672,230571,20912,26305,7399,204266,44626,277788,230571,,,,,0,0,0,0
1650448436.9477522,public.usertable,204576,44704,286318592,16893,public,usertable,1,0,347275,1530134,230924,20952,26348,7415,204576,44704,278224,230924,,,,,0,0,0,0
1650448437.9766111,public.usertable,204841,44798,286744576,16893,public,usertable,1,0,348235,1531752,231247,20995,26406,7432,204841,44798,278648,231247,,,,,0,0,0,0
1650448439.0062757,public.usertable,205160,44868,287186944,16893,public,usertable,1,0,349124,1534425,231604,21032,26444,7448,205160,44868,279080,231604,,,,,0,0,0,0
1650448440.0356064,public.usertable,205441,44952,287612928,16893,public,usertable,1,0,350020,1536292,231932,21072,26491,7463,205441,44952,279495,231932,,,,,0,0,0,0
1650448441.064641,public.usertable,205730,45033,288047104,16893,public,usertable,1,0,350881,1538951,232276,21101,26546,7475,205730,45033,279923,232276,,,,,0,0,0,0
1650448442.093029,public.usertable,206022,45107,288464896,16893,public,usertable,1,0,351754,1540972,232610,21141,26588,7492,206022,45107,280339,232610,,,,,0,0,0,0
1650448443.1220543,public.usertable,206290,45164,288841728,16893,public,usertable,1,0,352470,1544034,232911,21169,26621,7503,206290,45164,280701,232911,,,,,0,0,0,0
1650448444.151833,public.usertable,206546,45250,289234944,16893,public,usertable,1,0,353463,1546191,233221,21201,26675,7515,206546,45250,281097,233221,,,,,0,0,0,0
1650448445.1838434,public.usertable,206948,45346,289652736,16893,public,usertable,1,0,354789,1552561,233691,21252,26743,7536,206948,45346,281686,233691,,,,,0,0,0,0
1650448446.211949,public.usertable,207221,45430,290062336,16893,public,usertable,1,0,355694,1553451,234011,21293,26790,7554,207221,45430,282094,234011,,,,,0,0,0,0
1650448447.2430239,public.usertable,207501,45518,290496512,16893,public,usertable,1,0,356667,1556271,234351,21330,26850,7571,207501,45518,282531,234351,,,,,0,0,0,0
1650448448.2716727,public.usertable,207785,45577,290897920,16893,public,usertable,1,0,357501,1558587,234678,21361,26893,7589,207785,45577,282932,234678,,,,,0,0,0,0
1650448449.3031998,public.usertable,208062,45633,291299328,16893,public,usertable,1,0,358346,1560715,234993,21382,26931,7596,208062,45633,283306,234993,,,,,0,0,0,0
1650448450.3326697,public.usertable,208350,45708,291725312,16893,public,usertable,1,0,359216,1564551,235324,21418,26974,7613,208350,45708,283716,235324,,,,,0,0,0,0
1650448451.362526,public.usertable,208676,45778,292200448,16893,public,usertable,1,0,360203,1567501,235696,21455,27020,7632,208676,45778,284171,235696,,,,,0,0,0,0
1650448452.3920903,public.usertable,208994,45856,292675584,16893,public,usertable,1,0,361168,1569604,236068,21485,27074,7644,208994,45856,284627,236068,,,,,0,0,0,0
1650448453.422502,public.usertable,209331,45939,293142528,16893,public,usertable,1,0,362189,1571436,236447,21532,27116,7669,209331,45939,285095,236447,,,,,0,0,0,0
1650448454.4521825,public.usertable,209673,46016,293625856,16893,public,usertable,1,0,363074,1573421,236828,21572,27155,7690,209673,46016,285555,236828,,,,,0,0,0,0
1650448455.484106,public.usertable,209977,46097,294084608,16893,public,usertable,1,0,363998,1575789,237182,21607,27205,7706,209977,46097,285994,237182,,,,,0,0,0,0
1650448456.5143769,public.usertable,210286,46179,294518784,16893,public,usertable,1,0,364993,1579206,237548,21635,27262,7720,210286,46179,286445,237548,,,,,0,0,0,0
1650448457.5419598,public.usertable,210612,46240,294985728,16893,public,usertable,1,0,365872,1581426,237910,21666,27298,7734,210612,46240,286874,237910,,,,,0,0,0,0
1650448458.5717614,public.usertable,210944,46313,295477248,16893,public,usertable,1,0,366823,1583225,238296,21692,27352,7746,210944,46313,287340,238296,,,,,0,0,0,0
1650448459.6010334,public.usertable,211250,46387,295903232,16893,public,usertable,1,0,367756,1586466,238645,21732,27395,7763,211250,46387,287772,238645,,,,,0,0,0,0
1650448460.6319726,public.usertable,211537,46469,296345600,16893,public,usertable,1,0,368825,1589701,238980,21778,27443,7782,211537,46469,288201,238980,,,,,0,0,0,0
1650448461.6631804,public.usertable,211852,46553,296787968,16893,public,usertable,1,0,369761,1591769,239348,21813,27496,7796,211852,46553,288657,239348,,,,,0,0,0,0
1650448462.6942918,public.usertable,212118,46631,297197568,16893,public,usertable,1,0,370641,1595097,239663,21848,27545,7809,212118,46631,289056,239663,,,,,0,0,0,0
1650448463.7232125,public.usertable,212388,46720,297623552,16893,public,usertable,1,0,371583,1596385,239988,21882,27600,7824,212388,46720,289470,239988,,,,,0,0,0,0
1650448464.7527869,public.usertable,212829,46829,298049536,16893,public,usertable,1,0,372903,1600836,240487,21944,27658,7853,212829,46829,290089,240487,,,,,0,0,0,0
1650448465.7817264,public.usertable,213112,46924,298475520,16893,public,usertable,1,0,373887,1603068,240827,21988,27715,7876,213112,46924,290530,240827,,,,,0,0,0,0
1650448466.8115764,public.usertable,213411,47017,298958848,16893,public,usertable,1,0,375000,1606101,241193,22027,27782,7887,213411,47017,291002,241193,,,,,0,0,0,0
1650448467.8413494,public.usertable,213738,47095,299425792,16893,public,usertable,1,0,375935,1606694,241572,22064,27834,7904,213738,47095,291470,241572,,,,,0,0,0,0
1650448468.8725212,public.usertable,214022,47176,299851776,16893,public,usertable,1,0,376937,1608495,241899,22108,27877,7925,214022,47176,291884,241899,,,,,0,0,0,0
1650448469.9019682,public.usertable,214312,47252,300294144,16893,public,usertable,1,0,377809,1610407,242244,22142,27932,7941,214312,47252,292318,242244,,,,,0,0,0,0
1650448470.9323933,public.usertable,214601,47343,300736512,16893,public,usertable,1,0,378832,1612181,242588,22181,27987,7957,214601,47343,292756,242588,,,,,0,0,0,0
1650448471.962964,public.usertable,214859,47414,301088768,16893,public,usertable,1,0,379614,1613412,242889,22212,28030,7974,214859,47414,293131,242889,,,,,0,0,0,0
1650448472.9924726,public.usertable,215060,47447,301375488,16893,public,usertable,1,0,380151,1615442,243112,22228,28052,7984,215060,47447,293392,243112,,,,,0,0,0,0
1650448474.0221744,public.usertable,215270,47492,301670400,16893,public,usertable,1,0,380848,1618087,243350,22250,28080,7993,215270,47492,293680,243350,,,,,0,0,0,0
1650448475.0520275,public.usertable,215477,47550,301965312,16893,public,usertable,1,0,381522,1620142,243592,22275,28115,8004,215477,47550,293982,243592,,,,,0,0,0,0
1650448476.0903373,public.usertable,215677,47594,302252032,16893,public,usertable,1,0,382059,1621083,243814,22298,28137,8015,215677,47594,294249,243814,,,,,0,0,0,0
1650448477.1188343,public.usertable,215863,47661,302538752,16893,public,usertable,1,0,382741,1622853,244039,22331,28176,8031,215863,47661,294546,244039,,,,,0,0,0,0
1650448478.1472778,public.usertable,216088,47713,302899200,16893,public,usertable,1,0,383474,1624062,244295,22360,28207,8046,216088,47713,294862,244295,,,,,0,0,0,0
1650448479.1755059,public.usertable,216288,47781,303144960,16893,public,usertable,1,0,384106,1624695,244529,22397,28241,8067,216288,47781,295167,244529,,,,,0,0,0,0
1650448480.2059288,public.usertable,216474,47833,303423488,16893,public,usertable,1,0,384709,1625542,244744,22423,28270,8079,216474,47833,295437,244744,,,,,0,0,0,0
1650448481.2347295,public.usertable,216665,47881,303702016,16893,public,usertable,1,0,385273,1626423,244959,22451,28294,8090,216665,47881,295704,244959,,,,,0,0,0,0
1650448482.2671216,public.usertable,216873,47930,304054272,16893,public,usertable,1,0,385842,1628139,245198,22477,28325,8105,216873,47930,296000,245198,,,,,0,0,0,0
1650448483.2975829,public.usertable,217138,47987,304422912,16893,public,usertable,1,0,386558,1630438,245502,22498,28364,8112,217138,47987,296364,245502,,,,,0,0,0,0
1650448484.327262,public.usertable,217510,48102,304816128,16893,public,usertable,1,0,387826,1631974,245943,22550,28433,8135,217510,48102,296926,245943,,,,,0,0,0,0
1650448485.3599632,public.usertable,217809,48167,305242112,16893,public,usertable,1,0,388778,1635153,246281,22581,28472,8151,217809,48167,297334,246281,,,,,0,0,0,0
1650448486.3920147,public.usertable,218049,48231,305602560,16893,public,usertable,1,0,389498,1636388,246569,22598,28520,8159,218049,48231,297687,246569,,,,,0,0,0,0
1650448487.4205778,public.usertable,218362,48304,306061312,16893,public,usertable,1,0,390472,1640775,246936,22630,28574,8176,218362,48304,298140,246936,,,,,0,0,0,0
1650448488.4498696,public.usertable,218720,48401,306585600,16893,public,usertable,1,0,391560,1643259,247350,22674,28630,8203,218720,48401,298654,247350,,,,,0,0,0,0
1650448489.4830575,public.usertable,219059,48477,307036160,16893,public,usertable,1,0,392602,1645069,247727,22722,28668,8228,219059,48477,299117,247727,,,,,0,0,0,0
1650448490.5122511,public.usertable,219384,48525,307511296,16893,public,usertable,1,0,393566,1650908,248082,22757,28698,8248,219384,48525,299537,248082,,,,,0,0,0,0
1650448491.543054,public.usertable,219708,48609,307994624,16893,public,usertable,1,0,394560,1654991,248451,22808,28743,8268,219708,48609,300002,248451,,,,,0,0,0,0
1650448492.5735424,public.usertable,220048,48698,308494336,16893,public,usertable,1,0,395599,1655961,248851,22842,28803,8285,220048,48698,300496,248851,,,,,0,0,0,0
1650448493.604925,public.usertable,220357,48780,308961280,16893,public,usertable,1,0,396617,1658880,249217,22877,28860,8301,220357,48780,300954,249217,,,,,0,0,0,0
1650448494.6353605,public.usertable,220675,48860,309411840,16893,public,usertable,1,0,397575,1662139,249591,22911,28916,8317,220675,48860,301418,249591,,,,,0,0,0,0
1650448495.6657643,public.usertable,221001,48934,309895168,16893,public,usertable,1,0,398602,1664856,249962,22948,28961,8334,221001,48934,301871,249962,,,,,0,0,0,0
1650448496.6962595,public.usertable,221308,49009,310353920,16893,public,usertable,1,0,399489,1669210,250320,22979,29012,8346,221308,49009,302311,250320,,,,,0,0,0,0
1650448497.7278554,public.usertable,221657,49075,310829056,16893,public,usertable,1,0,400390,1672539,250707,23010,29050,8360,221657,49075,302767,250707,,,,,0,0,0,0
1650448498.7570586,public.usertable,221955,49162,311279616,16893,public,usertable,1,0,401337,1674258,251056,23049,29101,8374,221955,49162,303206,251056,,,,,0,0,0,0
1650448499.7862983,public.usertable,222247,49237,311738368,16893,public,usertable,1,0,402315,1676643,251397,23079,29150,8390,222247,49237,303626,251397,,,,,0,0,0,0
1650448500.8163242,public.usertable,222571,49309,312156160,16893,public,usertable,1,0,403232,1678714,251754,23123,29183,8411,222571,49309,304060,251754,,,,,0,0,0,0
1650448501.8479655,public.usertable,222883,49371,312614912,16893,public,usertable,1,0,404035,1680793,252107,23149,29224,8424,222883,49371,304480,252107,,,,,0,0,0,0
1650448502.8771436,public.usertable,223339,49474,313040896,16893,public,usertable,1,0,405404,1683971,252625,23203,29286,8445,223339,49474,305114,252625,,,,,0,0,0,0
1650448503.907055,public.usertable,223619,49556,313466880,16893,public,usertable,1,0,406329,1687889,252956,23241,29337,8467,223619,49556,305534,252956,,,,,0,0,0,0
1650448504.9354312,public.usertable,223930,49634,313909248,16893,public,usertable,1,0,407244,1690806,253316,23272,29386,8481,223930,49634,305974,253316,,,,,0,0,0,0
1650448505.9635866,public.usertable,224250,49695,314359808,16893,public,usertable,1,0,408220,1692691,253675,23306,29425,8499,224250,49695,306406,253675,,,,,0,0,0,0
1650448506.991813,public.usertable,224566,49771,314818560,16893,public,usertable,1,0,409126,1695121,254032,23347,29466,8516,224566,49771,306845,254032,,,,,0,0,0,0
1650448508.0208817,public.usertable,224882,49830,315244544,16893,public,usertable,1,0,409981,1696721,254381,23381,29499,8529,224882,49830,307261,254381,,,,,0,0,0,0
1650448509.0501645,public.usertable,225150,49893,315662336,16893,public,usertable,1,0,410839,1699032,254703,23403,29553,8542,225150,49893,307659,254703,,,,,0,0,0,0
1650448510.0793123,public.usertable,225442,49962,316088320,16893,public,usertable,1,0,411747,1702307,255036,23445,29594,8568,225442,49962,308075,255036,,,,,0,0,0,0
1650448511.1079597,public.usertable,225762,50040,316563456,16893,public,usertable,1,0,412840,1705585,255410,23480,29648,8584,225762,50040,308538,255410,,,,,0,0,0,0
1650448512.1377506,public.usertable,226096,50105,317030400,16893,public,usertable,1,0,413801,1709363,255787,23515,29691,8599,226096,50105,308993,255787,,,,,0,0,0,0
1650448513.167323,public.usertable,226389,50187,317472768,16893,public,usertable,1,0,414799,1711737,256134,23549,29745,8614,226389,50187,309428,256134,,,,,0,0,0,0
1650448514.197766,public.usertable,226701,50256,317915136,16893,public,usertable,1,0,415759,1715592,256491,23583,29790,8634,226701,50256,309864,256491,,,,,0,0,0,0
1650448515.2266715,public.usertable,227006,50348,318365696,16893,public,usertable,1,0,416719,1717663,256851,23627,29845,8660,227006,50348,310323,256851,,,,,0,0,0,0
1650448516.2577717,public.usertable,227342,50401,318840832,16893,public,usertable,1,0,417693,1719050,257218,23651,29876,8673,227342,50401,310745,257218,,,,,0,0,0,0
1650448517.287022,public.usertable,227680,50475,319307776,16893,public,usertable,1,0,418596,1720526,257594,23688,29914,8689,227680,50475,311196,257594,,,,,0,0,0,0
1650448518.3151808,public.usertable,227982,50556,319750144,16893,public,usertable,1,0,419519,1723039,257951,23726,29969,8707,227982,50556,311646,257951,,,,,0,0,0,0
1650448519.3459442,public.usertable,228301,50614,320200704,16893,public,usertable,1,0,420501,1725400,258311,23764,30010,8724,228301,50614,312085,258311,,,,,0,0,0,0
1650448520.3749335,public.usertable,228633,50680,320651264,16893,public,usertable,1,0,421521,1727777,258682,23800,30049,8744,228633,50680,312531,258682,,,,,0,0,0,0
1650448521.4087036,public.usertable,229108,50771,321118208,16893,public,usertable,1,0,422738,1730496,259207,23849,30099,8764,229108,50771,313155,259207,,,,,0,0,0,0
1650448522.4377463,public.usertable,229410,50848,321560576,16893,public,usertable,1,0,423614,1731257,259557,23883,30147,8779,229410,50848,313587,259557,,,,,0,0,0,0
1650448523.469394,public.usertable,229736,50917,322027520,16893,public,usertable,1,0,424649,1733505,259920,23924,30184,8797,229736,50917,314028,259920,,,,,0,0,0,0
1650448524.4985385,public.usertable,230067,50987,322510848,16893,public,usertable,1,0,425622,1737758,260302,23951,30235,8805,230067,50987,314488,260302,,,,,0,0,0,0
1650448525.528396,public.usertable,230397,51051,322969600,16893,public,usertable,1,0,426585,1741268,260668,23991,30271,8828,230397,51051,314930,260668,,,,,0,0,0,0
1650448526.5577288,public.usertable,230729,51113,323461120,16893,public,usertable,1,0,427512,1745043,261043,24031,30314,8843,230729,51113,315388,261043,,,,,0,0,0,0
1650448527.5888765,public.usertable,231047,51207,323928064,16893,public,usertable,1,0,428531,1748124,261421,24070,30374,8859,231047,51207,315865,261421,,,,,0,0,0,0
1650448528.6207004,public.usertable,231354,51276,324378624,16893,public,usertable,1,0,429432,1751601,261773,24105,30419,8875,231354,51276,316297,261773,,,,,0,0,0,0
1650448529.650051,public.usertable,231671,51352,324829184,16893,public,usertable,1,0,430471,1753944,262136,24137,30465,8889,231671,51352,316738,262136,,,,,0,0,0,0
1650448530.6789255,public.usertable,232003,51419,325296128,16893,public,usertable,1,0,431363,1755417,262504,24171,30501,8903,232003,51419,317176,262504,,,,,0,0,0,0
1650448531.7109506,public.usertable,232301,51507,325763072,16893,public,usertable,1,0,432273,1756909,262850,24215,30549,8921,232301,51507,317614,262850,,,,,0,0,0,0
1650448532.7420511,public.usertable,232636,51577,326230016,16893,public,usertable,1,0,433280,1758715,263226,24246,30590,8939,232636,51577,318062,263226,,,,,0,0,0,0
1650448533.7704785,public.usertable,232966,51669,326713344,16893,public,usertable,1,0,434294,1760519,263603,24294,30637,8962,232966,51669,318534,263603,,,,,0,0,0,0
1650448534.7988634,public.usertable,233319,51727,327196672,16893,public,usertable,1,0,435243,1762212,264001,24317,30682,8973,233319,51727,319000,264001,,,,,0,0,0,0
1650448535.827406,public.usertable,233652,51790,327671808,16893,public,usertable,1,0,436112,1764851,264373,24348,30721,8985,233652,51790,319442,264373,,,,,0,0,0,0
1650448536.8570778,public.usertable,233977,51858,328146944,16893,public,usertable,1,0,437037,1766853,264745,24382,30768,8993,233977,51858,319895,264745,,,,,0,0,0,0
1650448537.8856292,public.usertable,234310,51926,328622080,16893,public,usertable,1,0,438071,1768386,265123,24412,30813,9006,234310,51926,320348,265123,,,,,0,0,0,0
1650448538.916484,public.usertable,234639,52000,329097216,16893,public,usertable,1,0,439135,1770836,265501,24445,30862,9024,234639,52000,320808,265501,,,,,0,0,0,0
1650448539.9463665,public.usertable,234966,52084,329572352,16893,public,usertable,1,0,440164,1772016,265880,24482,30914,9039,234966,52084,321276,265880,,,,,0,0,0,0
1650448540.9753497,public.usertable,235457,52205,330047488,16893,public,usertable,1,0,441634,1775203,266437,24541,30980,9065,235457,52205,321958,266437,,,,,0,0,0,0
1650448542.0037708,public.usertable,235799,52257,330506240,16893,public,usertable,1,0,442609,1776699,266810,24571,31011,9078,235799,52257,322392,266810,,,,,0,0,0,0
1650448543.032385,public.usertable,236102,52318,330948608,16893,public,usertable,1,0,443499,1779454,267149,24606,31047,9095,236102,52318,322802,267149,,,,,0,0,0,0
1650448544.0635238,public.usertable,236434,52385,331407360,16893,public,usertable,1,0,444476,1780452,267517,24641,31083,9110,236434,52385,323241,267517,,,,,0,0,0,0
1650448545.0939722,public.usertable,236751,52449,331857920,16893,public,usertable,1,0,445457,1783412,267870,24679,31119,9127,236751,52449,323668,267870,,,,,0,0,0,0
1650448546.1249955,public.usertable,237046,52529,332300288,16893,public,usertable,1,0,446501,1787036,268213,24717,31167,9148,237046,52529,324097,268213,,,,,0,0,0,0
1650448547.157238,public.usertable,237363,52588,332734464,16893,public,usertable,1,0,447486,1790084,268565,24748,31202,9157,237363,52588,324515,268565,,,,,0,0,0,0
1650448548.1869476,public.usertable,237670,52651,333185024,16893,public,usertable,1,0,448423,1792207,268908,24786,31238,9174,237670,52651,324932,268908,,,,,0,0,0,0
1650448549.2164989,public.usertable,237931,52707,333537280,16893,public,usertable,1,0,449264,1795007,269199,24822,31268,9189,237931,52707,325289,269199,,,,,0,0,0,0
1650448550.2477834,public.usertable,238166,52756,333856768,16893,public,usertable,1,0,449958,1796317,269466,24841,31300,9201,238166,52756,325607,269466,,,,,0,0,0,0
1650448551.2777576,public.usertable,238347,52798,334118912,16893,public,usertable,1,0,450508,1797950,269677,24854,31330,9206,238347,52798,325861,269677,,,,,0,0,0,0
1650448552.3070178,public.usertable,238562,52848,334430208,16893,public,usertable,1,0,451112,1799231,269927,24872,31365,9216,238562,52848,326164,269927,,,,,0,0,0,0
1650448553.338325,public.usertable,238758,52894,334708736,16893,public,usertable,1,0,451742,1800374,270150,24895,31392,9230,238758,52894,326437,270150,,,,,0,0,0,0
1650448554.3683882,public.usertable,238999,52942,335069184,16893,public,usertable,1,0,452450,1801799,270419,24923,31420,9244,238999,52942,326762,270419,,,,,0,0,0,0
1650448555.3978066,public.usertable,239258,52982,335421440,16893,public,usertable,1,0,453085,1803446,270703,24940,31445,9254,239258,52982,327088,270703,,,,,0,0,0,0
1650448556.426426,public.usertable,239533,53047,335798272,16893,public,usertable,1,0,453927,1804140,271015,24974,31482,9265,239533,53047,327471,271015,,,,,0,0,0,0
1650448557.4577348,public.usertable,239778,53102,336175104,16893,public,usertable,1,0,454667,1804344,271293,24998,31515,9280,239778,53102,327806,271293,,,,,0,0,0,0
1650448558.4876304,public.usertable,240041,53158,336560128,16893,public,usertable,1,0,455560,1806423,271596,25022,31555,9288,240041,53158,328173,271596,,,,,0,0,0,0
1650448559.5175114,public.usertable,240412,53259,336912384,16893,public,usertable,1,0,456778,1809262,272024,25068,31612,9314,240412,53259,328704,272024,,,,,0,0,0,0
1650448560.5457382,public.usertable,240707,53338,337346560,16893,public,usertable,1,0,457785,1810932,272360,25109,31653,9328,240707,53338,329122,272360,,,,,0,0,0,0
1650448561.5737472,public.usertable,241024,53401,337788928,16893,public,usertable,1,0,458735,1813387,272716,25139,31692,9342,241024,53401,329547,272716,,,,,0,0,0,0
1650448562.6018474,public.usertable,241295,53456,338182144,16893,public,usertable,1,0,459584,1816306,273025,25170,31730,9358,241295,53456,329925,273025,,,,,0,0,0,0
1650448563.6313844,public.usertable,241603,53520,338616320,16893,public,usertable,1,0,460529,1818763,273366,25209,31763,9377,241603,53520,330338,273366,,,,,0,0,0,0
1650448564.6616094,public.usertable,241884,53587,339034112,16893,public,usertable,1,0,461407,1820416,273693,25240,31809,9388,241884,53587,330742,273693,,,,,0,0,0,0
1650448565.6948302,public.usertable,242193,53655,339476480,16893,public,usertable,1,0,462299,1822809,274037,25278,31844,9405,242193,53655,331159,274037,,,,,0,0,0,0
1650448566.7242177,public.usertable,242525,53722,339943424,16893,public,usertable,1,0,463210,1824145,274402,25316,31877,9425,242525,53722,331595,274402,,,,,0,0,0,0
1650448567.7529066,public.usertable,242872,53779,340418560,16893,public,usertable,1,0,464240,1827185,274787,25345,31915,9433,242872,53779,332047,274787,,,,,0,0,0,0
1650448568.781997,public.usertable,243177,53833,340836352,16893,public,usertable,1,0,465114,1830714,275125,25377,31948,9448,243177,53833,332450,275125,,,,,0,0,0,0
1650448569.8110461,public.usertable,243471,53888,341254144,16893,public,usertable,1,0,465904,1832043,275455,25398,31984,9460,243471,53888,332837,275455,,,,,0,0,0,0
1650448570.8426607,public.usertable,243777,53975,341712896,16893,public,usertable,1,0,466874,1834680,275804,25442,32027,9481,243777,53975,333273,275804,,,,,0,0,0,0
1650448571.8725495,public.usertable,244053,54052,342040576,16893,public,usertable,1,0,467765,1835415,276122,25480,32069,9501,244053,54052,333671,276122,,,,,0,0,0,0
1650448572.9024067,public.usertable,244229,54098,342335488,16893,public,usertable,1,0,468365,1836097,276334,25499,32105,9509,244229,54098,333938,276334,,,,,0,0,0,0
1650448573.931183,public.usertable,244500,54163,342736896,16893,public,usertable,1,0,469265,1836862,276643,25527,32143,9517,244500,54163,334313,276643,,,,,0,0,0,0
1650448574.9588904,public.usertable,244760,54215,343146496,16893,public,usertable,1,0,470097,1838964,276929,25559,32169,9532,244760,54215,334657,276929,,,,,0,0,0,0
1650448575.9898655,public.usertable,245074,54261,343580672,16893,public,usertable,1,0,470992,1841323,277277,25583,32203,9538,245074,54261,335063,277277,,,,,0,0,0,0
1650448577.01773,public.usertable,245371,54312,343957504,16893,public,usertable,1,0,471826,1843802,277616,25600,32245,9544,245371,54312,335461,277616,,,,,0,0,0,0
1650448578.0457711,public.usertable,245624,54359,344268800,16893,public,usertable,1,0,472552,1845764,277906,25618,32282,9553,245624,54359,335806,277906,,,,,0,0,0,0
1650448579.0758536,public.usertable,245792,54413,344547328,16893,public,usertable,1,0,473116,1846250,278110,25639,32318,9562,245792,54413,336067,278110,,,,,0,0,0,0
1650448580.1054118,public.usertable,246091,54477,344825856,16893,public,usertable,1,0,474046,1848001,278450,25669,32359,9580,246091,54477,336478,278450,,,,,0,0,0,0
1650448581.1358922,public.usertable,246276,54524,345096192,16893,public,usertable,1,0,474636,1848351,278664,25690,32388,9587,246276,54524,336742,278664,,,,,0,0,0,0
1650448582.1678464,public.usertable,246437,54562,345333760,16893,public,usertable,1,0,475171,1849135,278846,25708,32409,9595,246437,54562,336963,278846,,,,,0,0,0,0
1650448583.1981885,public.usertable,246592,54596,345546752,16893,public,usertable,1,0,475625,1850333,279018,25726,32426,9603,246592,54596,337170,279018,,,,,0,0,0,0
1650448584.2265985,public.usertable,246749,54635,345776128,16893,public,usertable,1,0,476184,1851568,279202,25741,32453,9607,246749,54635,337396,279202,,,,,0,0,0,0
1650448585.2601209,public.usertable,246953,54681,346087424,16893,public,usertable,1,0,476785,1853478,279433,25764,32480,9619,246953,54681,337677,279433,,,,,0,0,0,0
1650448586.2894363,public.usertable,247210,54735,346472448,16893,public,usertable,1,0,477576,1855234,279724,25795,32514,9634,247210,54735,338033,279724,,,,,0,0,0,0
1650448587.3205862,public.usertable,247485,54805,346873856,16893,public,usertable,1,0,478461,1858437,280042,25830,32557,9650,247485,54805,338429,280042,,,,,0,0,0,0
1650448588.3487995,public.usertable,247735,54863,347234304,16893,public,usertable,1,0,479170,1860075,280335,25852,32600,9658,247735,54863,338787,280335,,,,,0,0,0,0
1650448589.382833,public.usertable,247976,54943,347611136,16893,public,usertable,1,0,479984,1860663,280627,25882,32651,9676,247976,54943,339160,280627,,,,,0,0,0,0
1650448590.4125686,public.usertable,248285,55010,348053504,16893,public,usertable,1,0,480933,1862184,280976,25912,32691,9684,248285,55010,339579,280976,,,,,0,0,0,0
1650448591.4423547,public.usertable,248600,55059,348487680,16893,public,usertable,1,0,481730,1865317,281318,25941,32718,9698,248600,55059,339977,281318,,,,,0,0,0,0
1650448592.4727077,public.usertable,248877,55125,348880896,16893,public,usertable,1,0,482638,1866670,281638,25968,32761,9714,248877,55125,340367,281638,,,,,0,0,0,0
1650448593.501161,public.usertable,249164,55180,349306880,16893,public,usertable,1,0,483422,1868490,281963,25999,32799,9727,249164,55180,340761,281963,,,,,0,0,0,0
1650448594.532188,public.usertable,249463,55252,349732864,16893,public,usertable,1,0,484454,1871898,282306,26035,32843,9745,249463,55252,341184,282306,,,,,0,0,0,0
1650448595.5614686,public.usertable,249760,55316,350191616,16893,public,usertable,1,0,485450,1874693,282651,26068,32891,9757,249760,55316,341610,282651,,,,,0,0,0,0
1650448596.5922105,public.usertable,250072,55384,350601216,16893,public,usertable,1,0,486349,1876826,282992,26108,32920,9776,250072,55384,342020,282992,,,,,0,0,0,0
1650448597.6209388,public.usertable,250373,55438,350969856,16893,public,usertable,1,0,487099,1878723,283324,26132,32951,9786,250373,55438,342407,283324,,,,,0,0,0,0
1650448598.6500933,public.usertable,250745,55523,351346688,16893,public,usertable,1,0,488203,1881139,283750,26167,33005,9805,250745,55523,342922,283750,,,,,0,0,0,0
1650448599.6800835,public.usertable,251021,55598,351764480,16893,public,usertable,1,0,489058,1881976,284071,26203,33050,9816,251021,55598,343324,284071,,,,,0,0,0,0
1650448600.7087922,public.usertable,251321,55662,352182272,16893,public,usertable,1,0,490017,1882899,284404,26239,33083,9827,251321,55662,343726,284404,,,,,0,0,0,0
1650448601.7392879,public.usertable,251569,55725,352550912,16893,public,usertable,1,0,490854,1884279,284694,26269,33125,9842,251569,55725,344088,284694,,,,,0,0,0,0
1650448602.7710028,public.usertable,251855,55783,352944128,16893,public,usertable,1,0,491732,1887083,285021,26292,33166,9856,251855,55783,344479,285021,,,,,0,0,0,0
1650448603.8012712,public.usertable,252158,55845,353386496,16893,public,usertable,1,0,492689,1889572,285367,26322,33209,9872,252158,55845,344898,285367,,,,,0,0,0,0
1650448604.8351896,public.usertable,252459,55906,353820672,16893,public,usertable,1,0,493680,1891402,285707,26349,33248,9886,252459,55906,345304,285707,,,,,0,0,0,0
1650448605.8634083,public.usertable,252790,55964,354263040,16893,public,usertable,1,0,494679,1893998,286072,26381,33282,9908,252790,55964,345735,286072,,,,,0,0,0,0
1650448606.8937366,public.usertable,253122,56017,354713600,16893,public,usertable,1,0,495552,1896911,286430,26414,33308,9928,253122,56017,346152,286430,,,,,0,0,0,0
1650448607.9253063,public.usertable,253428,56081,355147776,16893,public,usertable,1,0,496448,1899193,286776,26442,33348,9943,253428,56081,346566,286776,,,,,0,0,0,0
1650448608.9555023,public.usertable,253759,56126,355590144,16893,public,usertable,1,0,497408,1901651,287137,26467,33378,9952,253759,56126,346982,287137,,,,,0,0,0,0
1650448609.9869006,public.usertable,254079,56185,356024320,16893,public,usertable,1,0,498380,1902818,287492,26500,33413,9967,254079,56185,347405,287492,,,,,0,0,0,0
1650448611.017028,public.usertable,254333,56221,356368384,16893,public,usertable,1,0,499104,1904839,287771,26520,33438,9974,254333,56221,347729,287771,,,,,0,0,0,0
1650448612.045118,public.usertable,254591,56257,356704256,16893,public,usertable,1,0,499850,1906387,288052,26541,33461,9988,254591,56257,348054,288052,,,,,0,0,0,0
1650448613.0738063,public.usertable,254806,56317,356990976,16893,public,usertable,1,0,500468,1907537,288299,26570,33493,10003,254806,56317,348362,288299,,,,,0,0,0,0
1650448614.1024492,public.usertable,254966,56364,357187584,16893,public,usertable,1,0,501018,1908318,288485,26592,33519,10016,254966,56364,348596,288485,,,,,0,0,0,0
1650448615.1319532,public.usertable,255140,56405,357474304,16893,public,usertable,1,0,501530,1909643,288678,26614,33538,10027,255140,56405,348830,288678,,,,,0,0,0,0
1650448616.1604564,public.usertable,255320,56453,357752832,16893,public,usertable,1,0,502123,1911700,288881,26642,33561,10038,255320,56453,349084,288881,,,,,0,0,0,0
1650448617.1907294,public.usertable,255548,56491,358096896,16893,public,usertable,1,0,502739,1913493,289133,26659,33585,10043,255548,56491,349377,289133,,,,,0,0,0,0
1650448618.221414,public.usertable,255777,56530,358408192,16893,public,usertable,1,0,503388,1914773,289388,26674,33611,10050,255777,56530,349673,289388,,,,,0,0,0,0
1650448619.2515194,public.usertable,256120,56606,358719488,16893,public,usertable,1,0,504347,1916477,289775,26713,33655,10074,256120,56606,350143,289775,,,,,0,0,0,0
1650448620.2804294,public.usertable,256346,56640,359038976,16893,public,usertable,1,0,505014,1918456,290026,26731,33680,10083,256346,56640,350437,290026,,,,,0,0,0,0
1650448621.3095171,public.usertable,256592,56690,359374848,16893,public,usertable,1,0,505674,1920645,290297,26762,33705,10096,256592,56690,350764,290297,,,,,0,0,0,0
1650448622.3377383,public.usertable,256819,56734,359694336,16893,public,usertable,1,0,506390,1922762,290554,26782,33735,10104,256819,56734,351071,290554,,,,,0,0,0,0
1650448623.3668792,public.usertable,257099,56801,360120320,16893,public,usertable,1,0,507232,1925799,290874,26814,33775,10121,257099,56801,351463,290874,,,,,0,0,0,0
1650448624.3969529,public.usertable,257424,56863,360554496,16893,public,usertable,1,0,508179,1926886,291226,26853,33802,10144,257424,56863,351881,291226,,,,,0,0,0,0
1650448625.4269443,public.usertable,257756,56909,361029632,16893,public,usertable,1,0,509188,1930163,291598,26876,33842,10153,257756,56909,352316,291598,,,,,0,0,0,0
1650448626.4583564,public.usertable,258100,56979,361504768,16893,public,usertable,1,0,510123,1931382,291980,26914,33880,10174,258100,56979,352774,291980,,,,,0,0,0,0
1650448627.4880223,public.usertable,258422,57050,361979904,16893,public,usertable,1,0,511164,1933017,292353,26942,33931,10188,258422,57050,353226,292353,,,,,0,0,0,0
1650448628.5189779,public.usertable,258798,57111,362487808,16893,public,usertable,1,0,512212,1934821,292770,26965,33972,10202,258798,57111,353707,292770,,,,,0,0,0,0
1650448629.5501146,public.usertable,259127,57189,362962944,16893,public,usertable,1,0,513074,1937368,293143,27004,34016,10221,259127,57189,354163,293143,,,,,0,0,0,0
1650448630.5794575,public.usertable,259472,57260,363429888,16893,public,usertable,1,0,514159,1938375,293533,27033,34061,10233,259472,57260,354627,293533,,,,,0,0,0,0
1650448631.6086748,public.usertable,259808,57322,363896832,16893,public,usertable,1,0,515143,1941477,293903,27072,34095,10257,259808,57322,355070,293903,,,,,0,0,0,0
1650448632.6371975,public.usertable,260109,57398,364331008,16893,public,usertable,1,0,516115,1942778,294246,27107,34137,10273,260109,57398,355490,294246,,,,,0,0,0,0
1650448633.6667647,public.usertable,260432,57463,364806144,16893,public,usertable,1,0,517051,1944377,294608,27139,34176,10290,260432,57463,355923,294608,,,,,0,0,0,0
1650448634.695606,public.usertable,260773,57524,365273088,16893,public,usertable,1,0,518084,1947273,294989,27171,34216,10306,260773,57524,356376,294989,,,,,0,0,0,0
1650448635.7315361,public.usertable,261044,57627,365715456,16893,public,usertable,1,0,519044,1949206,295328,27209,34284,10323,261044,57627,356821,295328,,,,,0,0,0,0
1650448636.7607222,public.usertable,261373,57698,366190592,16893,public,usertable,1,0,519958,1951012,295693,27247,34320,10341,261373,57698,357260,295693,,,,,0,0,0,0
1650448637.789857,public.usertable,261865,57804,366632960,16893,public,usertable,1,0,521415,1952673,296248,27295,34383,10365,261865,57804,357926,296248,,,,,0,0,0,0
1650448638.8194346,public.usertable,262150,57890,367075328,16893,public,usertable,1,0,522388,1954423,296581,27340,34431,10387,262150,57890,358352,296581,,,,,0,0,0,0
1650448639.8495104,public.usertable,262501,57945,367542272,16893,public,usertable,1,0,523402,1957212,296965,27374,34464,10406,262501,57945,358803,296965,,,,,0,0,0,0
1650448640.8782356,public.usertable,262809,58009,367984640,16893,public,usertable,1,0,524404,1960102,297310,27411,34501,10427,262809,58009,359222,297310,,,,,0,0,0,0
1650448641.9137156,public.usertable,263143,58068,368459776,16893,public,usertable,1,0,525486,1962262,297685,27440,34542,10438,263143,58068,359667,297685,,,,,0,0,0,0
1650448642.942044,public.usertable,263480,58128,368926720,16893,public,usertable,1,0,526528,1963298,298058,27471,34578,10455,263480,58128,360107,298058,,,,,0,0,0,0
1650448643.9728634,public.usertable,263765,58188,369319936,16893,public,usertable,1,0,527368,1964510,298378,27500,34613,10469,263765,58188,360491,298378,,,,,0,0,0,0
1650448645.0016074,public.usertable,264069,58251,369754112,16893,public,usertable,1,0,528323,1966633,298718,27535,34649,10484,264069,58251,360902,298718,,,,,0,0,0,0
1650448646.033774,public.usertable,264376,58316,370188288,16893,public,usertable,1,0,529176,1967927,299063,27563,34687,10496,264376,58316,361313,299063,,,,,0,0,0,0
1650448647.062073,public.usertable,264708,58379,370655232,16893,public,usertable,1,0,530151,1969456,299436,27588,34728,10509,264708,58379,361752,299436,,,,,0,0,0,0
1650448648.0931864,public.usertable,265024,58433,371089408,16893,public,usertable,1,0,531051,1972509,299785,27620,34761,10524,265024,58433,362166,299785,,,,,0,0,0,0
1650448649.1229563,public.usertable,265335,58482,371539968,16893,public,usertable,1,0,531929,1974743,300130,27641,34795,10532,265335,58482,362566,300130,,,,,0,0,0,0
1650448650.1529796,public.usertable,265663,58534,371974144,16893,public,usertable,1,0,532845,1977098,300488,27667,34825,10544,265663,58534,362980,300488,,,,,0,0,0,0
1650448651.1826675,public.usertable,265953,58591,372367360,16893,public,usertable,1,0,533747,1979803,300819,27692,34866,10554,265953,58591,363377,300819,,,,,0,0,0,0
1650448652.213336,public.usertable,266228,58630,372744192,16893,public,usertable,1,0,534590,1982033,301125,27714,34897,10561,266228,58630,363736,301125,,,,,0,0,0,0
1650448653.2441072,public.usertable,266498,58675,373112832,16893,public,usertable,1,0,535373,1984166,301424,27740,34926,10571,266498,58675,364090,301424,,,,,0,0,0,0
1650448654.272424,public.usertable,266745,58746,373506048,16893,public,usertable,1,0,536243,1985408,301714,27769,34969,10585,266745,58746,364452,301714,,,,,0,0,0,0
1650448655.3038287,public.usertable,267043,58766,373907456,16893,public,usertable,1,0,537039,1987803,302031,27786,34988,10589,267043,58766,364805,302031,,,,,0,0,0,0
1650448656.3334012,public.usertable,267323,58825,374267904,16893,public,usertable,1,0,537928,1990578,302345,27816,35022,10608,267323,58825,365183,302345,,,,,0,0,0,0
1650448657.3649416,public.usertable,267719,58894,374652928,16893,public,usertable,1,0,539016,1995360,302788,27848,35069,10622,267719,58894,365705,302788,,,,,0,0,0,0
1650448658.3936882,public.usertable,267980,58958,375021568,16893,public,usertable,1,0,539884,1996892,303083,27883,35103,10636,267980,58958,366069,303083,,,,,0,0,0,0
1650448659.4216604,public.usertable,268233,59019,375406592,16893,public,usertable,1,0,540660,1998120,303373,27912,35140,10647,268233,59019,366425,303373,,,,,0,0,0,0
1650448660.4520397,public.usertable,268503,59070,375791616,16893,public,usertable,1,0,541488,1999527,303677,27936,35174,10653,268503,59070,366787,303677,,,,,0,0,0,0
1650448661.4815345,public.usertable,268751,59128,376135680,16893,public,usertable,1,0,542271,2000694,303953,27969,35202,10667,268751,59128,367124,303953,,,,,0,0,0,0
1650448662.5125713,public.usertable,269030,59188,376537088,16893,public,usertable,1,0,543169,2002265,304269,27999,35239,10679,269030,59188,367507,304269,,,,,0,0,0,0
1650448663.5408664,public.usertable,269312,59221,376905728,16893,public,usertable,1,0,543993,2003879,304573,28015,35261,10692,269312,59221,367849,304573,,,,,0,0,0,0
1650448664.5716283,public.usertable,269613,59278,377364480,16893,public,usertable,1,0,544965,2006426,304917,28047,35304,10704,269613,59278,368268,304917,,,,,0,0,0,0
1650448665.6001246,public.usertable,269964,59334,377839616,16893,public,usertable,1,0,545935,2007993,305294,28080,35330,10721,269964,59334,368704,305294,,,,,0,0,0,0
1650448666.6309626,public.usertable,270311,59395,378314752,16893,public,usertable,1,0,546843,2010133,305674,28113,35363,10736,270311,59395,369150,305674,,,,,0,0,0,0
1650448667.6613507,public.usertable,270606,59462,378773504,16893,public,usertable,1,0,547737,2015218,306023,28142,35417,10753,270606,59462,369582,306023,,,,,0,0,0,0
1650448668.6924098,public.usertable,270958,59522,379232256,16893,public,usertable,1,0,548733,2019183,306410,28177,35452,10767,270958,59522,370039,306410,,,,,0,0,0,0
1650448669.72139,public.usertable,271263,59582,379658240,16893,public,usertable,1,0,549767,2021413,306751,28206,35488,10783,271263,59582,370445,306751,,,,,0,0,0,0
1650448670.7513945,public.usertable,271574,59636,380100608,16893,public,usertable,1,0,550744,2023573,307093,28233,35519,10796,271574,59636,370845,307093,,,,,0,0,0,0
1650448671.7832017,public.usertable,271897,59706,380526592,16893,public,usertable,1,0,551737,2024626,307456,28264,35559,10811,271897,59706,371279,307456,,,,,0,0,0,0
1650448672.8142912,public.usertable,272202,59760,380977152,16893,public,usertable,1,0,552643,2026115,307794,28288,35592,10825,272202,59760,371674,307794,,,,,0,0,0,0
1650448673.843992,public.usertable,272513,59808,381370368,16893,public,usertable,1,0,553550,2028303,308142,28310,35629,10831,272513,59808,372081,308142,,,,,0,0,0,0
1650448674.8734853,public.usertable,272975,59880,381820928,16893,public,usertable,1,0,554828,2030677,308645,28346,35670,10841,272975,59880,372661,308645,,,,,0,0,0,0
1650448675.9062684,public.usertable,273280,59931,382238720,16893,public,usertable,1,0,555676,2032083,308979,28371,35699,10851,273280,59931,373049,308979,,,,,0,0,0,0
1650448676.9349926,public.usertable,273558,60001,382640128,16893,public,usertable,1,0,556592,2032461,309303,28398,35745,10864,273558,60001,373446,309303,,,,,0,0,0,0
1650448677.9643552,public.usertable,273845,60053,383057920,16893,public,usertable,1,0,557465,2034276,309625,28428,35780,10874,273845,60053,373833,309625,,,,,0,0,0,0
1650448678.9934814,public.usertable,274144,60098,383459328,16893,public,usertable,1,0,558308,2037514,309950,28453,35806,10886,274144,60098,374209,309950,,,,,0,0,0,0
1650448680.023044,public.usertable,274415,60154,383852544,16893,public,usertable,1,0,559145,2039869,310252,28480,35837,10900,274415,60154,374569,310252,,,,,0,0,0,0
1650448681.0515895,public.usertable,274704,60231,384270336,16893,public,usertable,1,0,560113,2041429,310589,28510,35885,10915,274704,60231,374984,310589,,,,,0,0,0,0
1650448682.08474,public.usertable,275027,60276,384704512,16893,public,usertable,1,0,561045,2045072,310944,28533,35917,10923,275027,60276,375394,310944,,,,,0,0,0,0
1650448683.1145318,public.usertable,275310,60319,385097728,16893,public,usertable,1,0,561859,2047661,311258,28555,35948,10935,275310,60319,375761,311258,,,,,0,0,0,0
1650448684.1442287,public.usertable,275595,60381,385499136,16893,public,usertable,1,0,562647,2048904,311584,28579,35989,10951,275595,60381,376152,311584,,,,,0,0,0,0
1650448685.1744835,public.usertable,275874,60441,385908736,16893,public,usertable,1,0,563494,2050852,311904,28604,36030,10964,275874,60441,376538,311904,,,,,0,0,0,0
1650448686.2040482,public.usertable,276193,60497,386326528,16893,public,usertable,1,0,564392,2052137,312257,28630,36064,10978,276193,60497,376951,312257,,,,,0,0,0,0
1650448687.234281,public.usertable,276479,60564,386760704,16893,public,usertable,1,0,565356,2053516,312584,28662,36105,10993,276479,60564,377351,312584,,,,,0,0,0,0
1650448688.264111,public.usertable,276769,60637,387194880,16893,public,usertable,1,0,566341,2055697,312919,28696,36150,11010,276769,60637,377765,312919,,,,,0,0,0,0
1650448689.2984052,public.usertable,277053,60692,387588096,16893,public,usertable,1,0,567223,2057713,313238,28730,36185,11021,277053,60692,378153,313238,,,,,0,0,0,0
1650448690.3286445,public.usertable,277349,60737,388014080,16893,public,usertable,1,0,568066,2060280,313562,28754,36213,11031,277349,60737,378529,313562,,,,,0,0,0,0
1650448691.3577292,public.usertable,277662,60802,388464640,16893,public,usertable,1,0,569089,2061438,313922,28775,36260,11041,277662,60802,378957,313922,,,,,0,0,0,0
1650448692.388478,public.usertable,277971,60874,388898816,16893,public,usertable,1,0,570079,2062456,314278,28805,36307,11058,277971,60874,379390,314278,,,,,0,0,0,0
1650448693.4169352,public.usertable,278442,60972,389357568,16893,public,usertable,1,0,571452,2065533,314810,28851,36368,11075,278442,60972,380029,314810,,,,,0,0,0,0
1650448694.446374,public.usertable,278766,61024,389799936,16893,public,usertable,1,0,572428,2068653,315171,28875,36405,11088,278766,61024,380451,315171,,,,,0,0,0,0
1650448695.47488,public.usertable,279095,61086,390266880,16893,public,usertable,1,0,573416,2069099,315540,28900,36445,11100,279095,61086,380885,315540,,,,,0,0,0,0
1650448696.5088305,public.usertable,279419,61140,390701056,16893,public,usertable,1,0,574436,2071259,315902,28923,36483,11115,279419,61140,381308,315902,,,,,0,0,0,0
1650448697.5368986,public.usertable,279731,61198,391127040,16893,public,usertable,1,0,575423,2073662,316251,28953,36520,11131,279731,61198,381724,316251,,,,,0,0,0,0
1650448698.56472,public.usertable,280009,61247,391512064,16893,public,usertable,1,0,576304,2076115,316565,28969,36556,11140,280009,61247,382090,316565,,,,,0,0,0,0
1650448699.595856,public.usertable,280322,61303,391938048,16893,public,usertable,1,0,577137,2077585,316911,28996,36589,11150,280322,61303,382496,316911,,,,,0,0,0,0
1650448700.6275628,public.usertable,280612,61368,392364032,16893,public,usertable,1,0,578031,2079079,317239,29029,36627,11170,280612,61368,382895,317239,,,,,0,0,0,0
1650448701.658015,public.usertable,280919,61410,392781824,16893,public,usertable,1,0,578905,2081782,317578,29054,36659,11183,280919,61410,383291,317578,,,,,0,0,0,0
1650448702.686768,public.usertable,281207,61478,393216000,16893,public,usertable,1,0,579727,2084270,317908,29083,36701,11199,281207,61478,383692,317908,,,,,0,0,0,0
1650448703.7182453,public.usertable,281512,61531,393625600,16893,public,usertable,1,0,580692,2085832,318250,29106,36738,11205,281512,61531,384094,318250,,,,,0,0,0,0
1650448704.747574,public.usertable,281761,61589,393961472,16893,public,usertable,1,0,581497,2087869,318538,29127,36777,11216,281761,61589,384442,318538,,,,,0,0,0,0
1650448705.7759802,public.usertable,282030,61626,394338304,16893,public,usertable,1,0,582306,2090119,318826,29156,36796,11235,282030,61626,384778,318826,,,,,0,0,0,0
1650448706.8051257,public.usertable,282346,61684,394788864,16893,public,usertable,1,0,583279,2091393,319178,29181,36832,11245,282346,61684,385191,319178,,,,,0,0,0,0
1650448707.8335826,public.usertable,282661,61746,395239424,16893,public,usertable,1,0,584265,2092914,319532,29207,36871,11259,282661,61746,385610,319532,,,,,0,0,0,0
1650448708.865972,public.usertable,282983,61801,395665408,16893,public,usertable,1,0,585220,2094852,319880,29239,36897,11276,282983,61801,386016,319880,,,,,0,0,0,0
1650448709.8950617,public.usertable,283286,61868,396091392,16893,public,usertable,1,0,586184,2096664,320220,29271,36934,11294,283286,61868,386425,320220,,,,,0,0,0,0
1650448710.9274344,public.usertable,283600,61916,396533760,16893,public,usertable,1,0,587018,2098077,320565,29296,36965,11305,283600,61916,386826,320565,,,,,0,0,0,0
1650448711.957607,public.usertable,283931,61981,396984320,16893,public,usertable,1,0,587925,2099783,320934,29323,37003,11320,283931,61981,387260,320934,,,,,0,0,0,0
1650448712.9858255,public.usertable,284247,62027,397410304,16893,public,usertable,1,0,588869,2101750,321280,29347,37033,11334,284247,62027,387660,321280,,,,,0,0,0,0
1650448714.0141044,public.usertable,284730,62116,397869056,16893,public,usertable,1,0,590387,2105697,321823,29388,37093,11356,284730,62116,388304,321823,,,,,0,0,0,0
1650448715.0418408,public.usertable,285063,62191,398336000,16893,public,usertable,1,0,591392,2107779,322191,29429,37128,11378,285063,62191,388748,322191,,,,,0,0,0,0
1650448716.0724587,public.usertable,285404,62250,398811136,16893,public,usertable,1,0,592388,2110661,322568,29457,37164,11393,285404,62250,389189,322568,,,,,0,0,0,0
1650448717.1026232,public.usertable,285707,62318,399253504,16893,public,usertable,1,0,593481,2112087,322919,29482,37212,11404,285707,62318,389613,322919,,,,,0,0,0,0
1650448718.132871,public.usertable,286027,62383,399695872,16893,public,usertable,1,0,594473,2114107,323279,29511,37252,11417,286027,62383,390042,323279,,,,,0,0,0,0
1650448719.162008,public.usertable,286382,62445,400211968,16893,public,usertable,1,0,595454,2116539,323677,29537,37295,11429,286382,62445,390509,323677,,,,,0,0,0,0
1650448720.1922987,public.usertable,286769,62508,400728064,16893,public,usertable,1,0,596583,2118018,324097,29569,37328,11443,286769,62508,390994,324097,,,,,0,0,0,0
1650448721.22123,public.usertable,287159,62569,401268736,16893,public,usertable,1,0,597720,2119467,324520,29598,37361,11456,287159,62569,391479,324520,,,,,0,0,0,0
1650448722.2514725,public.usertable,287510,62640,401760256,16893,public,usertable,1,0,598803,2120946,324915,29627,37405,11470,287510,62640,391947,324915,,,,,0,0,0,0
1650448723.2834442,public.usertable,287888,62693,402268160,16893,public,usertable,1,0,599823,2123274,325322,29657,37434,11482,287888,62693,392413,325322,,,,,0,0,0,0
1650448724.312449,public.usertable,288239,62740,402735104,16893,public,usertable,1,0,600828,2124620,325707,29675,37468,11490,288239,62740,392850,325707,,,,,0,0,0,0
1650448725.3420467,public.usertable,288579,62813,403202048,16893,public,usertable,1,0,601811,2125625,326084,29717,37505,11510,288579,62813,393306,326084,,,,,0,0,0,0
1650448726.3722057,public.usertable,288893,62885,403668992,16893,public,usertable,1,0,602817,2128836,326439,29754,37546,11527,288893,62885,393739,326439,,,,,0,0,0,0
1650448727.4022024,public.usertable,289252,62940,404176896,16893,public,usertable,1,0,603904,2130419,326829,29789,37577,11543,289252,62940,394195,326829,,,,,0,0,0,0
1650448728.4328494,public.usertable,289596,63007,404652032,16893,public,usertable,1,0,604980,2132589,327211,29825,37615,11557,289596,63007,394651,327211,,,,,0,0,0,0
1650448729.4635167,public.usertable,289959,63057,405094400,16893,public,usertable,1,0,606020,2134429,327606,29846,37647,11572,289959,63057,395099,327606,,,,,0,0,0,0
1650448730.492813,public.usertable,290225,63107,405479424,16893,public,usertable,1,0,606862,2136531,327895,29876,37670,11588,290225,63107,395441,327895,,,,,0,0,0,0
1650448731.5218508,public.usertable,290715,63190,405929984,16893,public,usertable,1,0,608327,2139270,328434,29919,37719,11610,290715,63190,396072,328434,,,,,0,0,0,0
1650448732.5527341,public.usertable,291013,63240,406339584,16893,public,usertable,1,0,609180,2140585,328761,29943,37748,11620,291013,63240,396452,328761,,,,,0,0,0,0
1650448733.58062,public.usertable,291274,63300,406724608,16893,public,usertable,1,0,610145,2141728,329063,29970,37789,11632,291274,63300,396822,329063,,,,,0,0,0,0
1650448734.610336,public.usertable,291558,63347,407109632,16893,public,usertable,1,0,611028,2144223,329379,29997,37821,11646,291558,63347,397197,329379,,,,,0,0,0,0
1650448735.643941,public.usertable,291821,63403,407486464,16893,public,usertable,1,0,611853,2144937,329676,30023,37855,11663,291821,63403,397554,329676,,,,,0,0,0,0
1650448736.672932,public.usertable,292109,63448,407896064,16893,public,usertable,1,0,612732,2146812,329996,30045,37887,11673,292109,63448,397928,329996,,,,,0,0,0,0
1650448737.70127,public.usertable,292400,63516,408289280,16893,public,usertable,1,0,613572,2147114,330330,30071,37930,11687,292400,63516,398331,330330,,,,,0,0,0,0
1650448738.7298782,public.usertable,292643,63562,408641536,16893,public,usertable,1,0,614288,2148355,330596,30099,37953,11702,292643,63562,398648,330596,,,,,0,0,0,0
1650448739.7584941,public.usertable,292903,63607,408969216,16893,public,usertable,1,0,615019,2150125,330883,30121,37980,11716,292903,63607,398984,330883,,,,,0,0,0,0
1650448740.7886877,public.usertable,293114,63660,409288704,16893,public,usertable,1,0,615687,2151004,331123,30146,38009,11724,293114,63660,399278,331123,,,,,0,0,0,0
1650448741.817558,public.usertable,293343,63696,409567232,16893,public,usertable,1,0,616432,2152565,331378,30161,38035,11733,293343,63696,399574,331378,,,,,0,0,0,0
1650448742.8450432,public.usertable,293508,63733,409796608,16893,public,usertable,1,0,616955,2153734,331560,30181,38052,11741,293508,63733,399793,331560,,,,,0,0,0,0
1650448743.87316,public.usertable,293695,63763,410050560,16893,public,usertable,1,0,617477,2156486,331769,30193,38074,11747,293695,63763,400036,331769,,,,,0,0,0,0
1650448744.903776,public.usertable,293963,63801,410484736,16893,public,usertable,1,0,618287,2157481,332063,30214,38100,11757,293963,63801,400377,332063,,,,,0,0,0,0
1650448745.9348316,public.usertable,294333,63841,410984448,16893,public,usertable,1,0,619342,2160540,332461,30239,38128,11774,294333,63841,400828,332461,,,,,0,0,0,0
1650448746.96562,public.usertable,294678,63900,411459584,16893,public,usertable,1,0,620284,2162729,332843,30268,38165,11787,294678,63900,401276,332843,,,,,0,0,0,0
1650448747.9945374,public.usertable,295022,63981,411942912,16893,public,usertable,1,0,621303,2164449,333234,30305,38212,11804,295022,63981,401751,333234,,,,,0,0,0,0
1650448749.0251517,public.usertable,295368,64047,412434432,16893,public,usertable,1,0,622255,2165148,333617,30335,38249,11820,295368,64047,402201,333617,,,,,0,0,0,0
1650448750.0541003,public.usertable,295722,64092,412876800,16893,public,usertable,1,0,623278,2166981,334002,30360,38280,11833,295722,64092,402642,334002,,,,,0,0,0,0
1650448751.0833607,public.usertable,296016,64141,413261824,16893,public,usertable,1,0,624143,2168518,334326,30385,38310,11844,296016,64141,403021,334326,,,,,0,0,0,0
1650448752.11342,public.usertable,296319,64187,413687808,16893,public,usertable,1,0,625007,2170165,334653,30411,38334,11859,296319,64187,403398,334653,,,,,0,0,0,0
1650448753.1430635,public.usertable,296767,64260,414097408,16893,public,usertable,1,0,626311,2174259,335148,30449,38381,11876,296767,64260,403978,335148,,,,,0,0,0,0
1650448754.1751432,public.usertable,297076,64307,414523392,16893,public,usertable,1,0,627185,2175642,335492,30470,38416,11885,297076,64307,404378,335492,,,,,0,0,0,0
1650448755.2047043,public.usertable,297375,64355,414941184,16893,public,usertable,1,0,628050,2177393,335822,30492,38447,11895,297375,64355,404761,335822,,,,,0,0,0,0
1650448756.2358334,public.usertable,297656,64420,415350784,16893,public,usertable,1,0,629002,2178754,336149,30515,38493,11902,297656,64420,405157,336149,,,,,0,0,0,0
1650448757.2669015,public.usertable,297944,64484,415760384,16893,public,usertable,1,0,629917,2179360,336466,30550,38522,11921,297944,64484,405538,336466,,,,,0,0,0,0
1650448758.301082,public.usertable,298216,64544,416145408,16893,public,usertable,1,0,630769,2182344,336776,30577,38560,11932,298216,64544,405913,336776,,,,,0,0,0,0
1650448759.3301008,public.usertable,298496,64596,416530432,16893,public,usertable,1,0,631554,2184988,337082,30607,38586,11947,298496,64596,406275,337082,,,,,0,0,0,0
1650448760.360339,public.usertable,298818,64666,417013760,16893,public,usertable,1,0,632456,2186760,337447,30644,38629,11965,298818,64666,406720,337447,,,,,0,0,0,0
1650448761.3900273,public.usertable,299158,64730,417480704,16893,public,usertable,1,0,633533,2189232,337821,30680,38663,11978,299158,64730,407164,337821,,,,,0,0,0,0
1650448762.419204,public.usertable,299501,64790,417947648,16893,public,usertable,1,0,634485,2191419,338194,30712,38693,11998,299501,64790,407599,338194,,,,,0,0,0,0
1650448763.4479141,public.usertable,299845,64845,418439168,16893,public,usertable,1,0,635452,2192788,338568,30739,38723,12009,299845,64845,408030,338568,,,,,0,0,0,0
1650448764.4775543,public.usertable,300200,64901,418889728,16893,public,usertable,1,0,636463,2194356,338960,30763,38760,12018,300200,64901,408483,338960,,,,,0,0,0,0
1650448765.5057306,public.usertable,300508,64964,419315712,16893,public,usertable,1,0,637376,2196133,339304,30802,38796,12040,300508,64964,408902,339304,,,,,0,0,0,0
1650448766.5350356,public.usertable,300805,65020,419766272,16893,public,usertable,1,0,638206,2198148,339634,30829,38829,12057,300805,65020,409292,339634,,,,,0,0,0,0
1650448767.56406,public.usertable,301158,65077,420241408,16893,public,usertable,1,0,639199,2200733,340029,30859,38871,12071,301158,65077,409759,340029,,,,,0,0,0,0
1650448768.5918918,public.usertable,301507,65127,420708352,16893,public,usertable,1,0,640078,2201733,340407,30882,38900,12084,301507,65127,410189,340407,,,,,0,0,0,0
1650448769.622242,public.usertable,301842,65177,421167104,16893,public,usertable,1,0,641048,2204950,340773,30910,38931,12094,301842,65177,410614,340773,,,,,0,0,0,0
1650448770.653944,public.usertable,302178,65223,421617664,16893,public,usertable,1,0,641959,2206530,341141,30933,38963,12107,302178,65223,411037,341141,,,,,0,0,0,0
1650448771.6851673,public.usertable,302681,65317,422084608,16893,public,usertable,1,0,643314,2207905,341695,30981,39014,12135,302681,65317,411690,341695,,,,,0,0,0,0
1650448772.713454,public.usertable,303000,65373,422526976,16893,public,usertable,1,0,644293,2209690,342048,31010,39048,12150,303000,65373,412106,342048,,,,,0,0,0,0
1650448773.7430024,public.usertable,303331,65421,422977536,16893,public,usertable,1,0,645232,2212048,342411,31042,39080,12166,303331,65421,412533,342411,,,,,0,0,0,0
1650448774.7718208,public.usertable,303680,65475,423460864,16893,public,usertable,1,0,646212,2213709,342792,31074,39112,12183,303680,65475,412978,342792,,,,,0,0,0,0
1650448775.8022864,public.usertable,304021,65543,423936000,16893,public,usertable,1,0,647224,2214945,343168,31112,39147,12206,304021,65543,413427,343168,,,,,0,0,0,0
1650448776.8329937,public.usertable,304351,65589,424378368,16893,public,usertable,1,0,648177,2216949,343525,31137,39174,12218,304351,65589,413836,343525,,,,,0,0,0,0
1650448777.8621042,public.usertable,304678,65646,424828928,16893,public,usertable,1,0,649209,2218412,343885,31165,39207,12233,304678,65646,414257,343885,,,,,0,0,0,0
1650448778.8931766,public.usertable,305023,65711,425304064,16893,public,usertable,1,0,650229,2220348,344266,31197,39243,12246,305023,65711,414706,344266,,,,,0,0,0,0
1650448779.924591,public.usertable,305351,65774,425754624,16893,public,usertable,1,0,651205,2222014,344633,31225,39282,12264,305351,65774,415140,344633,,,,,0,0,0,0
1650448780.9546013,public.usertable,305688,65834,426221568,16893,public,usertable,1,0,652172,2223167,345007,31253,39319,12279,305688,65834,415579,345007,,,,,0,0,0,0
1650448781.9839265,public.usertable,306009,65895,426672128,16893,public,usertable,1,0,653215,2226434,345368,31283,39359,12296,306009,65895,416010,345368,,,,,0,0,0,0
1650448783.0135214,public.usertable,306338,65943,427147264,16893,public,usertable,1,0,654240,2229345,345736,31300,39398,12305,306338,65943,416434,345736,,,,,0,0,0,0
1650448784.0418956,public.usertable,306730,65995,427663360,16893,public,usertable,1,0,655332,2230933,346159,31324,39429,12314,306730,65995,416912,346159,,,,,0,0,0,0
1650448785.0707526,public.usertable,307081,66046,428146688,16893,public,usertable,1,0,656498,2234375,346543,31356,39462,12328,307081,66046,417361,346543,,,,,0,0,0,0
1650448786.1019,public.usertable,307423,66103,428613632,16893,public,usertable,1,0,657474,2236258,346920,31381,39497,12338,307423,66103,417798,346920,,,,,0,0,0,0
1650448787.1328917,public.usertable,307711,66165,428982272,16893,public,usertable,1,0,658384,2237070,347248,31404,39537,12352,307711,66165,418189,347248,,,,,0,0,0,0
1650448788.162779,public.usertable,307969,66201,429285376,16893,public,usertable,1,0,659042,2237967,347526,31422,39557,12357,307969,66201,418505,347526,,,,,0,0,0,0
1650448789.1916127,public.usertable,308190,66224,429596672,16893,public,usertable,1,0,659599,2240151,347759,31434,39569,12364,308190,66224,418762,347759,,,,,0,0,0,0
1650448790.2195387,public.usertable,308441,66270,429940736,16893,public,usertable,1,0,660452,2241756,348039,31456,39598,12376,308441,66270,419093,348039,,,,,0,0,0,0
1650448791.2491574,public.usertable,308857,66361,430366720,16893,public,usertable,1,0,661842,2243811,348516,31494,39659,12396,308857,66361,419669,348516,,,,,0,0,0,0
1650448792.2775502,public.usertable,309151,66425,430776320,16893,public,usertable,1,0,662777,2246729,348850,31520,39699,12407,309151,66425,420069,348850,,,,,0,0,0,0
1650448793.3072817,public.usertable,309406,66452,431128576,16893,public,usertable,1,0,663584,2248330,349127,31535,39721,12415,309406,66452,420383,349127,,,,,0,0,0,0
1650448794.3377163,public.usertable,309653,66475,431439872,16893,public,usertable,1,0,664228,2249994,349387,31553,39734,12426,309653,66475,420674,349387,,,,,0,0,0,0
1650448795.3726912,public.usertable,309870,66510,431742976,16893,public,usertable,1,0,664961,2250878,349619,31575,39749,12434,309870,66510,420943,349619,,,,,0,0,0,0
1650448796.400735,public.usertable,310117,66550,432095232,16893,public,usertable,1,0,665728,2252132,349894,31589,39777,12440,310117,66550,421260,349894,,,,,0,0,0,0
1650448797.4315908,public.usertable,310408,66605,432504832,16893,public,usertable,1,0,666596,2253523,350222,31617,39814,12454,310408,66605,421653,350222,,,,,0,0,0,0
1650448798.4610584,public.usertable,310732,66656,432963584,16893,public,usertable,1,0,667477,2255809,350572,31648,39840,12468,310732,66656,422060,350572,,,,,0,0,0,0
1650448799.4927847,public.usertable,311094,66714,433430528,16893,public,usertable,1,0,668495,2258099,350959,31683,39865,12483,311094,66714,422507,350959,,,,,0,0,0,0
1650448800.5236142,public.usertable,311403,66762,433872896,16893,public,usertable,1,0,669391,2259136,351300,31708,39897,12496,311403,66762,422905,351300,,,,,0,0,0,0
1650448801.5551329,public.usertable,311729,66824,434356224,16893,public,usertable,1,0,670372,2262490,351670,31742,39941,12512,311729,66824,423353,351670,,,,,0,0,0,0
1650448802.587048,public.usertable,312064,66879,434823168,16893,public,usertable,1,0,671492,2265860,352043,31774,39979,12525,312064,66879,423796,352043,,,,,0,0,0,0
1650448803.6168184,public.usertable,312398,66931,435281920,16893,public,usertable,1,0,672513,2268833,352414,31800,40016,12541,312398,66931,424230,352414,,,,,0,0,0,0
1650448804.6457403,public.usertable,312719,66992,435732480,16893,public,usertable,1,0,673528,2271247,352770,31837,40051,12556,312719,66992,424658,352770,,,,,0,0,0,0
1650448805.6739824,public.usertable,313045,67055,436183040,16893,public,usertable,1,0,674529,2272749,353134,31867,40089,12566,313045,67055,425090,353134,,,,,0,0,0,0
1650448806.703061,public.usertable,313369,67113,436649984,16893,public,usertable,1,0,675600,2275241,353501,31891,40132,12574,313369,67113,425524,353501,,,,,0,0,0,0
1650448807.7315495,public.usertable,313710,67184,437141504,16893,public,usertable,1,0,676668,2276694,353880,31930,40170,12593,313710,67184,425980,353880,,,,,0,0,0,0
1650448808.761044,public.usertable,314069,67238,437624832,16893,public,usertable,1,0,677651,2277854,354264,31960,40195,12600,314069,67238,426419,354264,,,,,0,0,0,0
1650448809.790514,public.usertable,314575,67314,438075392,16893,public,usertable,1,0,679193,2280397,354814,32006,40239,12623,314575,67314,427059,354814,,,,,0,0,0,0
1650448810.820491,public.usertable,314914,67366,438534144,16893,public,usertable,1,0,680156,2281718,355183,32030,40269,12635,314914,67366,427482,355183,,,,,0,0,0,0
1650448811.849195,public.usertable,315265,67422,439025664,16893,public,usertable,1,0,681082,2284365,355568,32058,40303,12646,315265,67422,427929,355568,,,,,0,0,0,0
1650448812.8777335,public.usertable,315621,67481,439508992,16893,public,usertable,1,0,682084,2287018,355959,32088,40338,12663,315621,67481,428385,355959,,,,,0,0,0,0
1650448813.909218,public.usertable,315992,67524,440000512,16893,public,usertable,1,0,683180,2288181,356357,32114,40365,12675,315992,67524,428836,356357,,,,,0,0,0,0
1650448814.940352,public.usertable,316342,67579,440475648,16893,public,usertable,1,0,684292,2289122,356736,32144,40394,12690,316342,67579,429274,356736,,,,,0,0,0,0
1650448815.969509,public.usertable,316678,67643,440950784,16893,public,usertable,1,0,685250,2291293,357111,32173,40433,12704,316678,67643,429717,357111,,,,,0,0,0,0
1650448817.0004663,public.usertable,317021,67698,441417728,16893,public,usertable,1,0,686194,2292965,357488,32201,40467,12715,317021,67698,430156,357488,,,,,0,0,0,0
1650448818.0291684,public.usertable,317349,67753,441876480,16893,public,usertable,1,0,687223,2295397,357854,32223,40505,12725,317349,67753,430582,357854,,,,,0,0,0,0
1650448819.0594678,public.usertable,317687,67800,442327040,16893,public,usertable,1,0,688122,2298038,358225,32248,40538,12735,317687,67800,431011,358225,,,,,0,0,0,0
1650448820.0910976,public.usertable,318022,67864,442802176,16893,public,usertable,1,0,689169,2299669,358595,32279,40573,12750,318022,67864,431447,358595,,,,,0,0,0,0
1650448821.1216257,public.usertable,318379,67927,443285504,16893,public,usertable,1,0,690234,2301769,358983,32317,40604,12771,318379,67927,431904,358983,,,,,0,0,0,0
1650448822.1533136,public.usertable,318717,67980,443752448,16893,public,usertable,1,0,691167,2303903,359353,32341,40636,12782,318717,67980,432330,359353,,,,,0,0,0,0
1650448823.183351,public.usertable,319045,68049,444211200,16893,public,usertable,1,0,692128,2305355,359719,32373,40674,12798,319045,68049,432766,359719,,,,,0,0,0,0
1650448824.211323,public.usertable,319379,68119,444710912,16893,public,usertable,1,0,693251,2307672,360094,32410,40715,12823,319379,68119,433219,360094,,,,,0,0,0,0
1650448825.2416487,public.usertable,319761,68175,445177856,16893,public,usertable,1,0,694211,2308770,360506,32438,40745,12833,319761,68175,433689,360506,,,,,0,0,0,0
1650448826.2715836,public.usertable,320086,68235,445669376,16893,public,usertable,1,0,695173,2312425,360869,32468,40783,12845,320086,68235,434120,360869,,,,,0,0,0,0
1650448827.3000133,public.usertable,320478,68284,446177280,16893,public,usertable,1,0,696283,2313352,361293,32494,40815,12859,320478,68284,434602,361293,,,,,0,0,0,0
1650448828.330494,public.usertable,320812,68340,446578688,16893,public,usertable,1,0,697369,2314597,361658,32525,40846,12875,320812,68340,435029,361658,,,,,0,0,0,0
1650448829.3659334,public.usertable,321148,68394,447029248,16893,public,usertable,1,0,698280,2315441,362023,32551,40875,12891,321148,68394,435449,362023,,,,,0,0,0,0
1650448830.3951323,public.usertable,321468,68448,447488000,16893,public,usertable,1,0,699314,2316898,362382,32573,40914,12902,321468,68448,435869,362382,,,,,0,0,0,0
1650448831.4273276,public.usertable,321970,68525,447930368,16893,public,usertable,1,0,700655,2319417,362925,32614,40955,12923,321970,68525,436494,362925,,,,,0,0,0,0
1650448832.4584796,public.usertable,322302,68561,448364544,16893,public,usertable,1,0,701712,2321984,363280,32640,40978,12940,322302,68561,436898,363280,,,,,0,0,0,0
1650448833.489166,public.usertable,322634,68606,448806912,16893,public,usertable,1,0,702704,2323582,363638,32662,41004,12955,322634,68606,437304,363638,,,,,0,0,0,0
1650448834.5183892,public.usertable,322946,68659,449241088,16893,public,usertable,1,0,703651,2325735,363983,32691,41037,12972,322946,68659,437711,363983,,,,,0,0,0,0
1650448835.5476704,public.usertable,323275,68711,449708032,16893,public,usertable,1,0,704753,2327490,364347,32716,41072,12982,323275,68711,438135,364347,,,,,0,0,0,0
1650448836.583487,public.usertable,323629,68758,450166784,16893,public,usertable,1,0,705775,2329132,364732,32740,41103,12994,323629,68758,438575,364732,,,,,0,0,0,0
1650448837.6143248,public.usertable,323944,68815,450609152,16893,public,usertable,1,0,706772,2330553,365076,32777,41132,13012,323944,68815,438985,365076,,,,,0,0,0,0
1650448838.6433885,public.usertable,324293,68860,451076096,16893,public,usertable,1,0,707712,2332622,365445,32806,41152,13030,324293,68860,439403,365445,,,,,0,0,0,0
1650448839.6726213,public.usertable,324642,68923,451567616,16893,public,usertable,1,0,708853,2334143,365825,32841,41183,13045,324642,68923,439849,365825,,,,,0,0,0,0
1650448840.7033396,public.usertable,324961,68974,451985408,16893,public,usertable,1,0,709825,2335725,366172,32869,41211,13054,324961,68974,440252,366172,,,,,0,0,0,0
1650448841.735074,public.usertable,325306,69029,452468736,16893,public,usertable,1,0,710816,2337692,366552,32893,41246,13068,325306,69029,440691,366552,,,,,0,0,0,0
1650448842.764931,public.usertable,325634,69080,452894720,16893,public,usertable,1,0,711771,2338495,366914,32912,41280,13075,325634,69080,441106,366914,,,,,0,0,0,0
1650448843.795338,public.usertable,325943,69131,453320704,16893,public,usertable,1,0,712824,2341686,367257,32938,41314,13089,325943,69131,441509,367257,,,,,0,0,0,0
1650448844.825332,public.usertable,326237,69208,453771264,16893,public,usertable,1,0,713841,2343196,367603,32969,41366,13101,326237,69208,441938,367603,,,,,0,0,0,0
1650448845.855592,public.usertable,326584,69261,454246400,16893,public,usertable,1,0,714864,2344903,367982,32993,41398,13114,326584,69261,442373,367982,,,,,0,0,0,0
1650448846.8844793,public.usertable,326935,69312,454729728,16893,public,usertable,1,0,715781,2346026,368372,33014,41437,13124,326935,69312,442823,368372,,,,,0,0,0,0
1650448847.9132466,public.usertable,327282,69351,455180288,16893,public,usertable,1,0,716696,2347883,368750,33036,41468,13137,327282,69351,443254,368750,,,,,0,0,0,0
1650448848.9491,public.usertable,327782,69429,455639040,16893,public,usertable,1,0,718162,2350077,369286,33082,41504,13162,327782,69429,443872,369286,,,,,0,0,0,0
1650448849.980008,public.usertable,328102,69480,456073216,16893,public,usertable,1,0,719091,2352142,369643,33100,41541,13173,328102,69480,444284,369643,,,,,0,0,0,0
1650448851.0093734,public.usertable,328420,69534,456507392,16893,public,usertable,1,0,720087,2352952,369991,33127,41571,13184,328420,69534,444689,369991,,,,,0,0,0,0
1650448852.0407605,public.usertable,328738,69600,456957952,16893,public,usertable,1,0,721056,2353814,370346,33160,41608,13201,328738,69600,445114,370346,,,,,0,0,0,0
1650448853.0697649,public.usertable,329069,69654,457408512,16893,public,usertable,1,0,722033,2355317,370708,33188,41639,13217,329069,69654,445535,370708,,,,,0,0,0,0
1650448854.0989864,public.usertable,329386,69715,457834496,16893,public,usertable,1,0,723027,2357695,371061,33216,41675,13231,329386,69715,445952,371061,,,,,0,0,0,0
1650448855.12807,public.usertable,329689,69764,458260480,16893,public,usertable,1,0,723938,2358826,371399,33238,41710,13244,329689,69764,446347,371399,,,,,0,0,0,0
1650448856.1596913,public.usertable,330017,69816,458719232,16893,public,usertable,1,0,724907,2361547,371755,33263,41738,13253,330017,69816,446756,371755,,,,,0,0,0,0
1650448857.1882863,public.usertable,330380,69879,459210752,16893,public,usertable,1,0,725949,2364336,372152,33298,41772,13271,330380,69879,447222,372152,,,,,0,0,0,0
1650448858.2180011,public.usertable,330719,69934,459636736,16893,public,usertable,1,0,726908,2366477,372523,33332,41804,13291,330719,69934,447659,372523,,,,,0,0,0,0
1650448859.245965,public.usertable,331009,70001,460120064,16893,public,usertable,1,0,727846,2367829,372859,33357,41850,13298,331009,70001,448066,372859,,,,,0,0,0,0
1650448860.2742274,public.usertable,331371,70061,460595200,16893,public,usertable,1,0,728927,2369609,373248,33396,41877,13318,331371,70061,448521,373248,,,,,0,0,0,0
1650448861.3044772,public.usertable,331725,70113,461094912,16893,public,usertable,1,0,729941,2371084,373634,33422,41909,13334,331725,70113,448965,373634,,,,,0,0,0,0
1650448862.3379948,public.usertable,332082,70170,461570048,16893,public,usertable,1,0,730925,2373391,374032,33447,41950,13344,332082,70170,449429,374032,,,,,0,0,0,0
1650448863.3696992,public.usertable,332434,70222,462077952,16893,public,usertable,1,0,731930,2375498,374423,33466,41989,13352,332434,70222,449878,374423,,,,,0,0,0,0
1650448864.4012442,public.usertable,332812,70283,462581760,16893,public,usertable,1,0,732982,2377868,374832,33509,42020,13377,332812,70283,450361,374832,,,,,0,0,0,0
1650448865.4302685,public.usertable,333160,70360,463060992,16893,public,usertable,1,0,734092,2379573,375226,33541,42066,13392,333160,70360,450833,375226,,,,,0,0,0,0
1650448866.459274,public.usertable,333517,70402,463560704,16893,public,usertable,1,0,735071,2381939,375611,33562,42094,13398,333517,70402,451267,375611,,,,,0,0,0,0
1650448867.4876935,public.usertable,334076,70484,464060416,16893,public,usertable,1,0,736584,2383401,376217,33598,42141,13414,334076,70484,451956,376217,,,,,0,0,0,0
1650448868.5167553,public.usertable,334423,70536,464527360,16893,public,usertable,1,0,737638,2384727,376599,33620,42176,13424,334423,70536,452395,376599,,,,,0,0,0,0
1650448869.5476289,public.usertable,334785,70579,465010688,16893,public,usertable,1,0,738641,2386672,376990,33644,42205,13436,334785,70579,452839,376990,,,,,0,0,0,0
1650448870.579242,public.usertable,335118,70655,465502208,16893,public,usertable,1,0,739708,2389712,377378,33674,42260,13451,335118,70655,453312,377378,,,,,0,0,0,0
1650448871.60797,public.usertable,335492,70713,466001920,16893,public,usertable,1,0,740779,2391905,377785,33706,42293,13466,335492,70713,453784,377785,,,,,0,0,0,0
1650448872.6399913,public.usertable,335831,70782,466485248,16893,public,usertable,1,0,741807,2393434,378158,33741,42327,13478,335831,70782,454226,378158,,,,,0,0,0,0
1650448873.6704288,public.usertable,336189,70829,466976768,16893,public,usertable,1,0,742785,2395519,378547,33770,42358,13491,336189,70829,454675,378547,,,,,0,0,0,0
1650448874.700134,public.usertable,336528,70892,467460096,16893,public,usertable,1,0,743848,2399845,378930,33806,42402,13510,336528,70892,455138,378930,,,,,0,0,0,0
1650448875.7291763,public.usertable,336886,70947,467959808,16893,public,usertable,1,0,744861,2402756,379327,33831,42441,13522,336886,70947,455599,379327,,,,,0,0,0,0
1650448876.7614164,public.usertable,337234,71010,468443136,16893,public,usertable,1,0,745914,2404985,379718,33855,42484,13533,337234,71010,456057,379718,,,,,0,0,0,0
1650448877.7904446,public.usertable,337620,71057,468967424,16893,public,usertable,1,0,747023,2406428,380137,33875,42517,13544,337620,71057,456529,380137,,,,,0,0,0,0
1650448878.821029,public.usertable,338017,71104,469483520,16893,public,usertable,1,0,748153,2408549,380564,33902,42547,13554,338017,71104,457013,380564,,,,,0,0,0,0
1650448879.8502283,public.usertable,338401,71160,470016000,16893,public,usertable,1,0,749213,2410532,380984,33929,42583,13569,338401,71160,457496,380984,,,,,0,0,0,0
1650448880.8809128,public.usertable,338773,71208,470507520,16893,public,usertable,1,0,750272,2413879,381391,33954,42618,13581,338773,71208,457963,381391,,,,,0,0,0,0
1650448881.9108522,public.usertable,339126,71260,470990848,16893,public,usertable,1,0,751216,2415243,381788,33971,42662,13589,339126,71260,458421,381788,,,,,0,0,0,0
1650448882.9408689,public.usertable,339483,71316,471490560,16893,public,usertable,1,0,752352,2418159,382175,34004,42692,13599,339483,71316,458871,382175,,,,,0,0,0,0
1650448883.9699183,public.usertable,339839,71367,471965696,16893,public,usertable,1,0,753493,2419788,382563,34031,42724,13609,339839,71367,459318,382563,,,,,0,0,0,0
1650448884.999914,public.usertable,340175,71425,472449024,16893,public,usertable,1,0,754509,2420972,382926,34066,42751,13627,340175,71425,459743,382926,,,,,0,0,0,0
1650448886.0356083,public.usertable,340716,71503,472932352,16893,public,usertable,1,0,755981,2422893,383518,34104,42802,13640,340716,71503,460424,383518,,,,,0,0,0,0
1650448887.0738451,public.usertable,341079,71552,473432064,16893,public,usertable,1,0,757021,2426022,383915,34126,42836,13647,341079,71552,460877,383915,,,,,0,0,0,0
1650448888.1032574,public.usertable,341439,71588,473907200,16893,public,usertable,1,0,758027,2429626,384307,34144,42868,13653,341439,71588,461319,384307,,,,,0,0,0,0
1650448889.1321278,public.usertable,341755,71640,474349568,16893,public,usertable,1,0,759012,2430265,384657,34167,42902,13664,341755,71640,461726,384657,,,,,0,0,0,0
1650448890.163767,public.usertable,342097,71702,474824704,16893,public,usertable,1,0,760025,2432459,385041,34194,42944,13678,342097,71702,462179,385041,,,,,0,0,0,0
1650448891.1950872,public.usertable,342456,71757,475324416,16893,public,usertable,1,0,760940,2434565,385435,34217,42979,13689,342456,71757,462631,385435,,,,,0,0,0,0
1650448892.224193,public.usertable,342807,71804,475799552,16893,public,usertable,1,0,761964,2437279,385823,34245,43016,13703,342807,71804,463084,385823,,,,,0,0,0,0
1650448893.25354,public.usertable,343142,71863,476250112,16893,public,usertable,1,0,763041,2438253,386192,34273,43050,13719,343142,71863,463515,386192,,,,,0,0,0,0
1650448894.2830021,public.usertable,343495,71930,476749824,16893,public,usertable,1,0,764013,2440941,386574,34315,43079,13740,343495,71930,463968,386574,,,,,0,0,0,0
1650448895.3142931,public.usertable,343837,71988,477216768,16893,public,usertable,1,0,765010,2441893,386950,34340,43113,13751,343837,71988,464403,386950,,,,,0,0,0,0
1650448896.3475752,public.usertable,344204,72033,477691904,16893,public,usertable,1,0,765898,2445258,387345,34365,43141,13768,344204,72033,464851,387345,,,,,0,0,0,0
1650448897.3785918,public.usertable,344552,72096,478191616,16893,public,usertable,1,0,766833,2446687,387730,34393,43178,13776,344552,72096,465301,387730,,,,,0,0,0,0
1650448898.408534,public.usertable,344924,72131,478691328,16893,public,usertable,1,0,767879,2449985,388134,34418,43210,13790,344924,72131,465762,388134,,,,,0,0,0,0
1650448899.4392068,public.usertable,345279,72188,479141888,16893,public,usertable,1,0,768871,2451185,388525,34440,43246,13805,345279,72188,466211,388525,,,,,0,0,0,0
1650448900.469075,public.usertable,345595,72248,479600640,16893,public,usertable,1,0,769772,2453181,388883,34465,43288,13820,345595,72248,466636,388883,,,,,0,0,0,0
1650448901.5019407,public.usertable,345924,72316,480051200,16893,public,usertable,1,0,770792,2455670,389250,34498,43326,13833,345924,72316,467074,389250,,,,,0,0,0,0
1650448902.531119,public.usertable,346246,72361,480493568,16893,public,usertable,1,0,771754,2457658,389604,34513,43358,13840,346246,72361,467475,389604,,,,,0,0,0,0
1650448903.560129,public.usertable,346575,72419,480952320,16893,public,usertable,1,0,772629,2459400,389977,34528,43402,13847,346575,72419,467907,389977,,,,,0,0,0,0
1650448904.5888822,public.usertable,346888,72477,481370112,16893,public,usertable,1,0,773597,2460455,390321,34559,43433,13861,346888,72477,468313,390321,,,,,0,0,0,0
1650448905.618296,public.usertable,347373,72560,481828864,16893,public,usertable,1,0,775031,2462719,390866,34589,43493,13878,347373,72560,468948,390866,,,,,0,0,0,0
1650448906.6472445,public.usertable,347722,72617,482295808,16893,public,usertable,1,0,776028,2463310,391247,34616,43525,13896,347722,72617,469388,391247,,,,,0,0,0,0
1650448907.6779158,public.usertable,348061,72691,482770944,16893,public,usertable,1,0,777061,2464322,391631,34648,43570,13914,348061,72691,469849,391631,,,,,0,0,0,0
1650448908.7088006,public.usertable,348389,72743,483221504,16893,public,usertable,1,0,777927,2466295,391981,34685,43592,13937,348389,72743,470258,391981,,,,,0,0,0,0
1650448909.7381358,public.usertable,348725,72808,483688448,16893,public,usertable,1,0,778944,2467181,392361,34708,43636,13947,348725,72808,470705,392361,,,,,0,0,0,0
1650448910.7669513,public.usertable,349081,72865,484171776,16893,public,usertable,1,0,779892,2468990,392752,34737,43671,13963,349081,72865,471160,392752,,,,,0,0,0,0
1650448911.802,public.usertable,349436,72914,484638720,16893,public,usertable,1,0,780902,2471307,393133,34766,43697,13980,349436,72914,471596,393133,,,,,0,0,0,0
1650448912.8313534,public.usertable,349800,72970,485146624,16893,public,usertable,1,0,781863,2473332,393528,34793,43728,13998,349800,72970,472049,393528,,,,,0,0,0,0
1650448913.8675342,public.usertable,350171,73012,485613568,16893,public,usertable,1,0,782860,2474660,393921,34820,43750,14015,350171,73012,472491,393921,,,,,0,0,0,0
1650448914.896868,public.usertable,350531,73056,486105088,16893,public,usertable,1,0,783925,2477312,394312,34845,43781,14027,350531,73056,472938,394312,,,,,0,0,0,0
1650448915.9267895,public.usertable,350906,73116,486612992,16893,public,usertable,1,0,784997,2478780,394718,34879,43812,14041,350906,73116,473409,394718,,,,,0,0,0,0
1650448916.9598222,public.usertable,351273,73171,487104512,16893,public,usertable,1,0,786034,2481052,395116,34906,43843,14056,351273,73171,473865,395116,,,,,0,0,0,0
1650448917.9916956,public.usertable,351639,73223,487596032,16893,public,usertable,1,0,787094,2484387,395513,34936,43874,14072,351639,73223,474323,395513,,,,,0,0,0,0
1650448919.0200186,public.usertable,352011,73268,488095744,16893,public,usertable,1,0,788095,2486539,395911,34963,43900,14087,352011,73268,474774,395911,,,,,0,0,0,0
1650448920.049545,public.usertable,352334,73320,488554496,16893,public,usertable,1,0,789066,2487523,396266,34986,43932,14099,352334,73320,475184,396266,,,,,0,0,0,0
1650448921.0778868,public.usertable,352715,73380,489054208,16893,public,usertable,1,0,790148,2488725,396675,35019,43960,14112,352715,73380,475654,396675,,,,,0,0,0,0
1650448922.1071687,public.usertable,353080,73430,489537536,16893,public,usertable,1,0,791143,2490769,397069,35044,43989,14126,353080,73430,476102,397069,,,,,0,0,0,0
1650448923.1358488,public.usertable,353444,73485,490029056,16893,public,usertable,1,0,792166,2492738,397468,35069,44024,14137,353444,73485,476561,397468,,,,,0,0,0,0
1650448924.1647828,public.usertable,353968,73565,490487808,16893,public,usertable,1,0,793739,2494996,398035,35109,44067,14159,353968,73565,477211,398035,,,,,0,0,0,0
1650448925.194366,public.usertable,354319,73600,490962944,16893,public,usertable,1,0,794626,2497846,398410,35131,44091,14170,354319,73600,477632,398410,,,,,0,0,0,0
1650448926.2233508,public.usertable,354655,73659,491429888,16893,public,usertable,1,0,795675,2499099,398791,35148,44136,14175,354655,73659,478075,398791,,,,,0,0,0,0
1650448927.2527754,public.usertable,355005,73699,491905024,16893,public,usertable,1,0,796669,2502317,399171,35166,44166,14188,355005,73699,478503,399171,,,,,0,0,0,0
1650448928.281993,public.usertable,355366,73750,492388352,16893,public,usertable,1,0,797695,2504550,399556,35200,44190,14200,355366,73750,478946,399556,,,,,0,0,0,0
1650448929.3105986,public.usertable,355685,73793,492781568,16893,public,usertable,1,0,798632,2507080,399908,35221,44223,14213,355685,73793,479352,399908,,,,,0,0,0,0
1650448930.3392816,public.usertable,355912,73844,493142016,16893,public,usertable,1,0,799287,2507940,400164,35245,44252,14225,355912,73844,479661,400164,,,,,0,0,0,0
1650448931.374727,public.usertable,356213,73879,493535232,16893,public,usertable,1,0,800237,2509555,400489,35262,44276,14233,356213,73879,480027,400489,,,,,0,0,0,0
1650448932.4034188,public.usertable,356475,73906,493879296,16893,public,usertable,1,0,801044,2512061,400775,35279,44300,14241,356475,73906,480354,400775,,,,,0,0,0,0
1650448933.4363902,public.usertable,356716,73951,494206976,16893,public,usertable,1,0,801802,2513888,401044,35297,44328,14248,356716,73951,480669,401044,,,,,0,0,0,0
1650448934.4697487,public.usertable,356973,73982,494559232,16893,public,usertable,1,0,802558,2515209,401321,35311,44348,14256,356973,73982,480980,401321,,,,,0,0,0,0
1650448935.507085,public.usertable,357197,74016,494854144,16893,public,usertable,1,0,803156,2516317,401572,35324,44375,14262,357197,74016,481271,401572,,,,,0,0,0,0
1650448936.5397873,public.usertable,357437,74060,495222784,16893,public,usertable,1,0,803813,2516866,401834,35347,44397,14274,357437,74060,481578,401834,,,,,0,0,0,0
1650448937.568197,public.usertable,357745,74094,495607808,16893,public,usertable,1,0,804693,2519332,402165,35365,44420,14282,357745,74094,481950,402165,,,,,0,0,0,0
1650448938.5969896,public.usertable,358022,74139,495968256,16893,public,usertable,1,0,805478,2520615,402463,35389,44441,14290,358022,74139,482293,402463,,,,,0,0,0,0
1650448939.6274734,public.usertable,358305,74183,496402432,16893,public,usertable,1,0,806366,2521881,402776,35412,44471,14304,358305,74183,482659,402776,,,,,0,0,0,0
1650448940.6601996,public.usertable,358615,74215,496795648,16893,public,usertable,1,0,807270,2524295,403111,35431,44496,14315,358615,74215,483038,403111,,,,,0,0,0,0
1650448941.6916745,public.usertable,358935,74264,497229824,16893,public,usertable,1,0,808118,2526289,403458,35458,44523,14331,358935,74264,483439,403458,,,,,0,0,0,0
1650448942.720761,public.usertable,359225,74316,497639424,16893,public,usertable,1,0,808975,2527076,403781,35478,44556,14342,359225,74316,483815,403781,,,,,0,0,0,0
1650448943.749187,public.usertable,359761,74372,498139136,16893,public,usertable,1,0,810431,2531759,404355,35517,44594,14363,359761,74372,484466,404355,,,,,0,0,0,0
1650448944.7793257,public.usertable,360111,74424,498614272,16893,public,usertable,1,0,811424,2533102,404731,35550,44620,14380,360111,74424,484901,404731,,,,,0,0,0,0
1650448945.8099465,public.usertable,360437,74482,499064832,16893,public,usertable,1,0,812364,2534939,405093,35574,44656,14392,360437,74482,485323,405093,,,,,0,0,0,0
1650448946.8394418,public.usertable,360790,74533,499531776,16893,public,usertable,1,0,813433,2536757,405477,35599,44687,14404,360790,74533,485763,405477,,,,,0,0,0,0
1650448947.870528,public.usertable,361142,74591,500015104,16893,public,usertable,1,0,814472,2538582,405861,35628,44719,14413,361142,74591,486208,405861,,,,,0,0,0,0
1650448948.8992586,public.usertable,361485,74640,500498432,16893,public,usertable,1,0,815516,2539587,406236,35650,44751,14423,361485,74640,486637,406236,,,,,0,0,0,0
1650448949.931136,public.usertable,361847,74684,500957184,16893,public,usertable,1,0,816626,2541572,406626,35682,44779,14437,361847,74684,487087,406626,,,,,0,0,0,0
1650448950.959587,public.usertable,362166,74731,501391360,16893,public,usertable,1,0,817531,2543250,406980,35699,44814,14441,362166,74731,487493,406980,,,,,0,0,0,0
1650448951.9915574,public.usertable,362501,74782,501858304,16893,public,usertable,1,0,818537,2544974,407346,35724,44845,14460,362501,74782,487915,407346,,,,,0,0,0,0
1650448953.0203936,public.usertable,362859,74823,502325248,16893,public,usertable,1,0,819547,2546403,407735,35743,44876,14470,362859,74823,488354,407735,,,,,0,0,0,0
1650448954.0504344,public.usertable,363210,74866,502800384,16893,public,usertable,1,0,820537,2548652,408115,35767,44905,14479,363210,74866,488787,408115,,,,,0,0,0,0
1650448955.080932,public.usertable,363601,74907,503316480,16893,public,usertable,1,0,821650,2550632,408535,35790,44934,14491,363601,74907,489259,408535,,,,,0,0,0,0
1650448956.111916,public.usertable,363927,74970,503783424,16893,public,usertable,1,0,822688,2552426,408901,35818,44974,14508,363927,74970,489693,408901,,,,,0,0,0,0
1650448957.140364,public.usertable,364303,75027,504274944,16893,public,usertable,1,0,823760,2553460,409306,35847,45003,14523,364303,75027,490156,409306,,,,,0,0,0,0
1650448958.1696253,public.usertable,364655,75084,504750080,16893,public,usertable,1,0,824828,2555288,409699,35865,45044,14533,364655,75084,490608,409699,,,,,0,0,0,0
1650448959.1980715,public.usertable,364981,75137,505184256,16893,public,usertable,1,0,825763,2556623,410053,35893,45072,14550,364981,75137,491018,410053,,,,,0,0,0,0
1650448960.2269084,public.usertable,365315,75201,505643008,16893,public,usertable,1,0,826692,2558636,410423,35922,45108,14570,365315,75201,491453,410423,,,,,0,0,0,0
1650448961.258342,public.usertable,365676,75247,506109952,16893,public,usertable,1,0,827630,2559906,410813,35940,45137,14580,365676,75247,491890,410813,,,,,0,0,0,0
1650448962.2868571,public.usertable,366004,75304,506535936,16893,public,usertable,1,0,828713,2561161,411181,35963,45177,14591,366004,75304,492321,411181,,,,,0,0,0,0
1650448963.3159106,public.usertable,366306,75356,507011072,16893,public,usertable,1,0,829648,2562003,411523,35982,45217,14603,366306,75356,492722,411523,,,,,0,0,0,0
1650448964.3460345,public.usertable,366796,75428,507437056,16893,public,usertable,1,0,831121,2562785,412055,36014,45259,14618,366796,75428,493328,412055,,,,,0,0,0,0
1650448965.3766909,public.usertable,367118,75478,507871232,16893,public,usertable,1,0,832050,2564051,412411,36032,45293,14626,367118,75478,493736,412411,,,,,0,0,0,0
1650448966.40775,public.usertable,367440,75531,508321792,16893,public,usertable,1,0,833064,2565127,412767,36055,45327,14636,367440,75531,494149,412767,,,,,0,0,0,0
1650448967.4364657,public.usertable,367802,75578,508805120,16893,public,usertable,1,0,834137,2567373,413159,36085,45357,14656,367802,75578,494601,413159,,,,,0,0,0,0
1650448968.467445,public.usertable,368130,75634,509255680,16893,public,usertable,1,0,835159,2569248,413519,36114,45389,14674,368130,75634,495022,413519,,,,,0,0,0,0
1650448969.4977837,public.usertable,368461,75689,509698048,16893,public,usertable,1,0,836128,2570535,413885,36135,45424,14686,368461,75689,495444,413885,,,,,0,0,0,0
1650448970.5352533,public.usertable,368793,75741,510148608,16893,public,usertable,1,0,837080,2572300,414244,36160,45451,14696,368793,75741,495855,414244,,,,,0,0,0,0
1650448971.567096,public.usertable,369155,75785,510664704,16893,public,usertable,1,0,838030,2573231,414638,36181,45483,14703,369155,75785,496302,414638,,,,,0,0,0,0
1650448972.5964766,public.usertable,369524,75830,511131648,16893,public,usertable,1,0,839053,2574647,415033,36203,45509,14715,369524,75830,496745,415033,,,,,0,0,0,0
1650448973.6249824,public.usertable,369871,75883,511590400,16893,public,usertable,1,0,840020,2575120,415405,36231,45534,14734,369871,75883,497170,415405,,,,,0,0,0,0
1650448974.6535928,public.usertable,370233,75931,512073728,16893,public,usertable,1,0,841074,2575945,415795,36253,45562,14746,370233,75931,497610,415795,,,,,0,0,0,0
1650448975.6817572,public.usertable,370596,75983,512557056,16893,public,usertable,1,0,842071,2578333,416191,36276,45595,14754,370596,75983,498062,416191,,,,,0,0,0,0
1650448976.71092,public.usertable,370926,76039,513007616,16893,public,usertable,1,0,843202,2582228,416558,36302,45632,14771,370926,76039,498492,416558,,,,,0,0,0,0
1650448977.7405136,public.usertable,371270,76086,513466368,16893,public,usertable,1,0,844200,2582738,416934,36319,45664,14781,371270,76086,498917,416934,,,,,0,0,0,0
1650448978.7729595,public.usertable,371616,76136,513949696,16893,public,usertable,1,0,845215,2583658,417315,36342,45699,14792,371616,76136,499356,417315,,,,,0,0,0,0
1650448979.8038888,public.usertable,371976,76190,514433024,16893,public,usertable,1,0,846325,2585963,417706,36368,45730,14810,371976,76190,499804,417706,,,,,0,0,0,0
1650448980.832265,public.usertable,372340,76234,514899968,16893,public,usertable,1,0,847385,2588728,418093,36394,45753,14821,372340,76234,500240,418093,,,,,0,0,0,0
1650448981.8624918,public.usertable,372634,76279,515334144,16893,public,usertable,1,0,848306,2590295,418420,36415,45786,14830,372634,76279,500621,418420,,,,,0,0,0,0
1650448982.89469,public.usertable,373155,76369,515801088,16893,public,usertable,1,0,849793,2591915,418993,36458,45838,14851,373155,76369,501289,418993,,,,,0,0,0,0
1650448983.9234912,public.usertable,373491,76414,516251648,16893,public,usertable,1,0,850849,2592513,419358,36475,45867,14860,373491,76414,501700,419358,,,,,0,0,0,0
1650448984.9518156,public.usertable,373837,76452,516710400,16893,public,usertable,1,0,851878,2594732,419731,36493,45894,14869,373837,76452,502118,419731,,,,,0,0,0,0
1650448985.9806406,public.usertable,374173,76490,517160960,16893,public,usertable,1,0,852834,2597048,420097,36512,45924,14877,374173,76490,502533,420097,,,,,0,0,0,0
1650448987.0116634,public.usertable,374524,76534,517636096,16893,public,usertable,1,0,853846,2599391,420470,36540,45946,14888,374524,76534,502956,420470,,,,,0,0,0,0
1650448988.0446143,public.usertable,374861,76572,518078464,16893,public,usertable,1,0,854764,2600413,420833,36565,45972,14899,374861,76572,503370,420833,,,,,0,0,0,0
1650448989.0752766,public.usertable,375195,76613,518529024,16893,public,usertable,1,0,855704,2602951,421195,36589,46000,14912,375195,76613,503784,421195,,,,,0,0,0,0
1650448990.1034913,public.usertable,375530,76666,518971392,16893,public,usertable,1,0,856630,2604993,421566,36607,46036,14925,375530,76666,504209,421566,,,,,0,0,0,0
1650448991.1320896,public.usertable,375867,76710,519454720,16893,public,usertable,1,0,857559,2606896,421928,36632,46061,14938,375867,76710,504621,421928,,,,,0,0,0,0
1650448992.16074,public.usertable,376204,76759,519880704,16893,public,usertable,1,0,858615,2607681,422292,36657,46088,14953,376204,76759,505037,422292,,,,,0,0,0,0
1650448993.1915655,public.usertable,376521,76810,520306688,16893,public,usertable,1,0,859605,2609036,422638,36683,46117,14966,376521,76810,505438,422638,,,,,0,0,0,0
1650448994.2220392,public.usertable,376842,76863,520749056,16893,public,usertable,1,0,860525,2610290,422981,36714,46139,14978,376842,76863,505834,422981,,,,,0,0,0,0
1650448995.251852,public.usertable,377174,76901,521199616,16893,public,usertable,1,0,861504,2612922,423337,36737,46163,14987,377174,76901,506237,423337,,,,,0,0,0,0
1650448996.2806377,public.usertable,377519,76948,521658368,16893,public,usertable,1,0,862522,2614586,423710,36758,46191,14999,377519,76948,506659,423710,,,,,0,0,0,0
1650448997.3091207,public.usertable,377856,76988,522076160,16893,public,usertable,1,0,863495,2616943,424071,36780,46215,15011,377856,76988,507066,424071,,,,,0,0,0,0
1650448998.3383448,public.usertable,378163,77026,522502144,16893,public,usertable,1,0,864394,2618912,424403,36799,46240,15016,378163,77026,507442,424403,,,,,0,0,0,0
1650448999.37164,public.usertable,378483,77055,522887168,16893,public,usertable,1,0,865195,2619982,424738,36817,46255,15025,378483,77055,507810,424738,,,,,0,0,0,0
1650449000.4008288,public.usertable,378749,77089,523247616,16893,public,usertable,1,0,865998,2620998,425022,36834,46273,15032,378749,77089,508129,425022,,,,,0,0,0,0
1650449001.4298456,public.usertable,379015,77131,523599872,16893,public,usertable,1,0,866774,2621449,425313,36851,46298,15038,379015,77131,508462,425313,,,,,0,0,0,0
1650449002.459384,public.usertable,379398,77202,523952128,16893,public,usertable,1,0,868071,2625139,425744,36883,46346,15053,379398,77202,508973,425744,,,,,0,0,0,0
1650449003.4880555,public.usertable,379692,77235,524353536,16893,public,usertable,1,0,868891,2626627,426063,36900,46371,15063,379692,77235,509334,426063,,,,,0,0,0,0
1650449004.5191312,public.usertable,380042,77272,524820480,16893,public,usertable,1,0,869915,2627892,426440,36917,46398,15071,380042,77272,509755,426440,,,,,0,0,0,0
1650449005.5508342,public.usertable,380318,77317,525197312,16893,public,usertable,1,0,870848,2628425,426749,36933,46431,15079,380318,77317,510113,426749,,,,,0,0,0,0
1650449006.579122,public.usertable,380631,77365,525623296,16893,public,usertable,1,0,871706,2629461,427087,36957,46456,15092,380631,77365,510500,427087,,,,,0,0,0,0
1650449007.6077387,public.usertable,381021,77414,526147584,16893,public,usertable,1,0,872768,2630933,427506,36983,46485,15108,381021,77414,510974,427506,,,,,0,0,0,0
1650449008.6368296,public.usertable,381396,77463,526639104,16893,public,usertable,1,0,873881,2632523,427913,37005,46517,15117,381396,77463,511435,427913,,,,,0,0,0,0
1650449009.665931,public.usertable,381767,77513,527147008,16893,public,usertable,1,0,874916,2633088,428312,37029,46545,15123,381767,77513,511886,428312,,,,,0,0,0,0
1650449010.6964672,public.usertable,382112,77564,527605760,16893,public,usertable,1,0,875918,2634254,428692,37052,46580,15136,382112,77564,512324,428692,,,,,0,0,0,0
1650449011.7269568,public.usertable,382462,77607,528023552,16893,public,usertable,1,0,876915,2635336,429068,37074,46606,15150,382462,77607,512748,429068,,,,,0,0,0,0
1650449012.7556288,public.usertable,382777,77668,528506880,16893,public,usertable,1,0,877880,2636291,429426,37094,46649,15160,382777,77668,513169,429426,,,,,0,0,0,0
1650449013.7841358,public.usertable,383115,77724,528990208,16893,public,usertable,1,0,878840,2637621,429796,37124,46681,15177,383115,77724,513601,429796,,,,,0,0,0,0
1650449014.812705,public.usertable,383480,77765,529465344,16893,public,usertable,1,0,879854,2639286,430189,37146,46709,15195,383480,77765,514044,430189,,,,,0,0,0,0
1650449015.8504179,public.usertable,383863,77828,529981440,16893,public,usertable,1,0,880877,2640151,430606,37175,46743,15214,383863,77828,514524,430606,,,,,0,0,0,0
1650449016.8787704,public.usertable,384235,77885,530464768,16893,public,usertable,1,0,882010,2642036,431010,37204,46775,15233,384235,77885,514989,431010,,,,,0,0,0,0
1650449017.9069345,public.usertable,384595,77944,530972672,16893,public,usertable,1,0,883053,2643759,431401,37233,46806,15244,384595,77944,515440,431401,,,,,0,0,0,0
1650449018.9414783,public.usertable,384967,78000,531464192,16893,public,usertable,1,0,884213,2645470,431808,37260,46841,15255,384967,78000,515909,431808,,,,,0,0,0,0
1650449019.970393,public.usertable,385343,78051,531980288,16893,public,usertable,1,0,885185,2646640,432217,37278,46874,15268,385343,78051,516369,432217,,,,,0,0,0,0
1650449020.999685,public.usertable,385909,78125,532480000,16893,public,usertable,1,0,886745,2649324,432830,37317,46921,15287,385909,78125,517068,432830,,,,,0,0,0,0
1650449022.028321,public.usertable,386282,78176,532987904,16893,public,usertable,1,0,887875,2650936,433234,37344,46952,15301,386282,78176,517530,433234,,,,,0,0,0,0
1650449023.0576043,public.usertable,386649,78229,533471232,16893,public,usertable,1,0,888876,2652944,433624,37382,46975,15322,386649,78229,517981,433624,,,,,0,0,0,0
1650449024.0868723,public.usertable,386981,78290,533938176,16893,public,usertable,1,0,889911,2654286,433991,37413,47010,15334,386981,78290,518414,433991,,,,,0,0,0,0
1650449025.1199968,public.usertable,387302,78350,534388736,16893,public,usertable,1,0,890893,2655521,434347,37439,47045,15347,387302,78350,518831,434347,,,,,0,0,0,0
1650449026.149395,public.usertable,387671,78397,534896640,16893,public,usertable,1,0,891941,2656781,434744,37466,47073,15360,387671,78397,519283,434744,,,,,0,0,0,0
1650449027.1792097,public.usertable,388033,78440,535363584,16893,public,usertable,1,0,892984,2659070,435139,37482,47106,15369,388033,78440,519727,435139,,,,,0,0,0,0
1650449028.2082741,public.usertable,388402,78487,535867392,16893,public,usertable,1,0,894047,2660315,435538,37509,47136,15382,388402,78487,520183,435538,,,,,0,0,0,0
1650449029.236734,public.usertable,388779,78539,536371200,16893,public,usertable,1,0,895176,2661813,435946,37533,47167,15395,388779,78539,520646,435946,,,,,0,0,0,0
1650449030.265431,public.usertable,389160,78584,536879104,16893,public,usertable,1,0,896266,2663833,436357,37561,47197,15412,389160,78584,521115,436357,,,,,0,0,0,0
1650449031.2943287,public.usertable,389528,78625,537370624,16893,public,usertable,1,0,897423,2665858,436751,37585,47223,15422,389528,78625,521559,436751,,,,,0,0,0,0
1650449032.324769,public.usertable,389907,78666,537878528,16893,public,usertable,1,0,898466,2668359,437157,37607,47250,15433,389907,78666,522014,437157,,,,,0,0,0,0
1650449033.3537104,public.usertable,390264,78713,538361856,16893,public,usertable,1,0,899569,2671573,437548,37631,47284,15447,390264,78713,522463,437548,,,,,0,0,0,0
1650449034.3842738,public.usertable,390652,78757,538869760,16893,public,usertable,1,0,900661,2673681,437960,37655,47308,15460,390652,78757,522923,437960,,,,,0,0,0,0
1650449035.4129736,public.usertable,391021,78812,539361280,16893,public,usertable,1,0,901631,2674732,438368,37673,47347,15468,391021,78812,523388,438368,,,,,0,0,0,0
1650449036.4442089,public.usertable,391402,78848,539869184,16893,public,usertable,1,0,902616,2676836,438776,37693,47374,15480,391402,78848,523843,438776,,,,,0,0,0,0
1650449037.4727573,public.usertable,391788,78888,540368896,16893,public,usertable,1,0,903651,2677972,439190,37714,47402,15495,391788,78888,524306,439190,,,,,0,0,0,0
1650449038.5017505,public.usertable,392151,78943,540860416,16893,public,usertable,1,0,904754,2679292,439590,37740,47439,15510,392151,78943,524769,439590,,,,,0,0,0,0
1650449039.5298471,public.usertable,392515,78988,541335552,16893,public,usertable,1,0,905883,2682551,439979,37778,47464,15531,392515,78988,525221,439979,,,,,0,0,0,0
1650449040.558354,public.usertable,393046,79061,541818880,16893,public,usertable,1,0,907614,2684839,440569,37802,47523,15548,393046,79061,525894,440569,,,,,0,0,0,0
1650449041.5870206,public.usertable,393410,79118,542310400,16893,public,usertable,1,0,908704,2685654,440964,37830,47554,15566,393410,79118,526348,440964,,,,,0,0,0,0
1650449042.6152775,public.usertable,393742,79159,542752768,16893,public,usertable,1,0,909604,2686435,441319,37852,47577,15576,393742,79159,526748,441319,,,,,0,0,0,0
1650449043.643693,public.usertable,394097,79208,543236096,16893,public,usertable,1,0,910774,2688129,441710,37870,47613,15582,394097,79208,527193,441710,,,,,0,0,0,0
1650449044.679335,public.usertable,394451,79254,543711232,16893,public,usertable,1,0,911831,2689542,442090,37899,47639,15598,394451,79254,527628,442090,,,,,0,0,0,0
1650449045.7103167,public.usertable,394827,79299,544210944,16893,public,usertable,1,0,912848,2691655,442498,37918,47671,15608,394827,79299,528087,442498,,,,,0,0,0,0
1650449046.7390404,public.usertable,395205,79347,544718848,16893,public,usertable,1,0,914025,2693665,442908,37937,47703,15616,395205,79347,528548,442908,,,,,0,0,0,0
1650449047.7684085,public.usertable,395588,79390,545218560,16893,public,usertable,1,0,915105,2693911,443314,37960,47726,15629,395588,79390,529000,443314,,,,,0,0,0,0
1650449048.799519,public.usertable,395949,79444,545710080,16893,public,usertable,1,0,916178,2695832,443709,37988,47760,15644,395949,79444,529457,443709,,,,,0,0,0,0
1650449049.8283901,public.usertable,396346,79476,546226176,16893,public,usertable,1,0,917278,2699021,444128,38010,47782,15657,396346,79476,529920,444128,,,,,0,0,0,0
1650449050.8568437,public.usertable,396720,79521,546734080,16893,public,usertable,1,0,918426,2701753,444530,38040,47810,15670,396720,79521,530380,444530,,,,,0,0,0,0
1650449051.8872302,public.usertable,397102,79573,547250176,16893,public,usertable,1,0,919444,2703171,444945,38060,47843,15681,397102,79573,530848,444945,,,,,0,0,0,0
1650449052.9172366,public.usertable,397465,79616,547717120,16893,public,usertable,1,0,920564,2705633,445335,38080,47870,15691,397465,79616,531285,445335,,,,,0,0,0,0
1650449053.9459734,public.usertable,397828,79659,548216832,16893,public,usertable,1,0,921678,2708286,445732,38098,47904,15699,397828,79659,531734,445732,,,,,0,0,0,0
1650449054.9759538,public.usertable,398208,79702,548683776,16893,public,usertable,1,0,922663,2710881,446139,38119,47931,15711,398208,79702,532189,446139,,,,,0,0,0,0
1650449056.004515,public.usertable,398545,79749,549150720,16893,public,usertable,1,0,923704,2712370,446504,38139,47959,15723,398545,79749,532602,446504,,,,,0,0,0,0
1650449057.0337698,public.usertable,398909,79796,549625856,16893,public,usertable,1,0,924812,2714754,446901,38161,47992,15735,398909,79796,533054,446901,,,,,0,0,0,0
1650449058.062639,public.usertable,399257,79842,550109184,16893,public,usertable,1,0,925865,2716927,447282,38182,48025,15744,399257,79842,533489,447282,,,,,0,0,0,0
1650449059.0908968,public.usertable,399747,79900,550526976,16893,public,usertable,1,0,927276,2718049,447813,38209,48066,15757,399747,79900,534088,447813,,,,,0,0,0,0
1650449060.1239963,public.usertable,400107,79953,551010304,16893,public,usertable,1,0,928365,2718976,448204,38232,48097,15765,400107,79953,534533,448204,,,,,0,0,0,0
1650449061.155428,public.usertable,400452,80007,551501824,16893,public,usertable,1,0,929564,2720377,448584,38261,48132,15775,400452,80007,534977,448584,,,,,0,0,0,0
1650449062.1840754,public.usertable,400786,80038,551927808,16893,public,usertable,1,0,930445,2722406,448943,38274,48157,15783,400786,80038,535374,448943,,,,,0,0,0,0
1650449063.2167046,public.usertable,401078,80078,552329216,16893,public,usertable,1,0,931265,2722990,449260,38289,48182,15789,401078,80078,535731,449260,,,,,0,0,0,0
1650449064.247175,public.usertable,401356,80117,552689664,16893,public,usertable,1,0,932107,2724494,449559,38311,48203,15800,401356,80117,536073,449559,,,,,0,0,0,0
1650449065.2764168,public.usertable,401691,80155,553156608,16893,public,usertable,1,0,932955,2725382,449919,38327,48228,15808,401691,80155,536474,449919,,,,,0,0,0,0
1650449066.3061986,public.usertable,402053,80196,553615360,16893,public,usertable,1,0,933997,2727236,450306,38344,48253,15820,402053,80196,536903,450306,,,,,0,0,0,0
1650449067.337958,public.usertable,402362,80248,554057728,16893,public,usertable,1,0,934901,2729920,450647,38366,48285,15831,402362,80248,537298,450647,,,,,0,0,0,0
1650449068.3703015,public.usertable,402680,80287,554500096,16893,public,usertable,1,0,935850,2730908,450996,38378,48316,15835,402680,80287,537690,450996,,,,,0,0,0,0
1650449069.4009764,public.usertable,403089,80324,555032576,16893,public,usertable,1,0,936995,2731849,451428,38401,48339,15848,403089,80324,538168,451428,,,,,0,0,0,0
1650449070.4313483,public.usertable,403474,80365,555532288,16893,public,usertable,1,0,938093,2735134,451844,38423,48370,15856,403474,80365,538637,451844,,,,,0,0,0,0
1650449071.4597878,public.usertable,403848,80416,556040192,16893,public,usertable,1,0,939227,2736662,452250,38446,48402,15868,403848,80416,539098,452250,,,,,0,0,0,0
1650449072.4908566,public.usertable,404213,80463,556515328,16893,public,usertable,1,0,940367,2739213,452643,38473,48430,15881,404213,80463,539546,452643,,,,,0,0,0,0
1650449073.5190241,public.usertable,404565,80505,556982272,16893,public,usertable,1,0,941455,2740181,453024,38495,48459,15892,404565,80505,539978,453024,,,,,0,0,0,0
1650449074.5486355,public.usertable,404915,80563,557481984,16893,public,usertable,1,0,942467,2741524,453411,38518,48496,15905,404915,80563,540425,453411,,,,,0,0,0,0
1650449075.5772874,public.usertable,405296,80602,557981696,16893,public,usertable,1,0,943571,2742537,453815,38541,48519,15916,405296,80602,540875,453815,,,,,0,0,0,0
1650449076.6077445,public.usertable,405875,80682,558505984,16893,public,usertable,1,0,945257,2744403,454440,38578,48565,15931,405875,80682,541583,454440,,,,,0,0,0,0
1650449077.6373436,public.usertable,406252,80734,559005696,16893,public,usertable,1,0,946281,2745846,454846,38605,48594,15946,406252,80734,542045,454846,,,,,0,0,0,0
1650449078.6659455,public.usertable,406660,80772,559529984,16893,public,usertable,1,0,947340,2747573,455275,38625,48615,15955,406660,80772,542515,455275,,,,,0,0,0,0
1650449079.6955805,public.usertable,407038,80829,560046080,16893,public,usertable,1,0,948396,2748581,455688,38649,48650,15968,407038,80829,542987,455688,,,,,0,0,0,0
1650449080.7252946,public.usertable,407427,80881,560562176,16893,public,usertable,1,0,949427,2750965,456103,38678,48676,15982,407427,80881,543457,456103,,,,,0,0,0,0
1650449081.755014,public.usertable,407810,80920,561053696,16893,public,usertable,1,0,950466,2752381,456511,38702,48701,15996,407810,80920,543914,456511,,,,,0,0,0,0
1650449082.783995,public.usertable,408180,80972,561545216,16893,public,usertable,1,0,951539,2753944,456907,38733,48727,16013,408180,80972,544367,456907,,,,,0,0,0,0
1650449083.812731,public.usertable,408577,81021,562069504,16893,public,usertable,1,0,952652,2755470,457331,38760,48754,16028,408577,81021,544845,457331,,,,,0,0,0,0
1650449084.8417447,public.usertable,408952,81078,562593792,16893,public,usertable,1,0,953721,2756312,457743,38785,48791,16038,408952,81078,545319,457743,,,,,0,0,0,0
1650449085.869754,public.usertable,409340,81120,563101696,16893,public,usertable,1,0,954844,2759020,458158,38807,48818,16051,409340,81120,545783,458158,,,,,0,0,0,0
1650449086.898377,public.usertable,409711,81183,563601408,16893,public,usertable,1,0,956046,2760864,458562,38839,48851,16069,409711,81183,546252,458562,,,,,0,0,0,0
1650449087.92653,public.usertable,410089,81217,564084736,16893,public,usertable,1,0,957165,2763470,458963,38862,48874,16081,410089,81217,546699,458963,,,,,0,0,0,0
1650449088.9564722,public.usertable,410446,81272,564584448,16893,public,usertable,1,0,958284,2764560,459360,38879,48914,16087,410446,81272,547153,459360,,,,,0,0,0,0
1650449089.984876,public.usertable,410845,81310,565108736,16893,public,usertable,1,0,959390,2765056,459779,38902,48934,16099,410845,81310,547615,459779,,,,,0,0,0,0
1650449091.015577,public.usertable,411202,81360,565583872,16893,public,usertable,1,0,960395,2765575,460161,38929,48959,16114,411202,81360,548049,460161,,,,,0,0,0,0
1650449092.044703,public.usertable,411557,81409,566075392,16893,public,usertable,1,0,961467,2767624,460543,38959,48986,16126,411557,81409,548488,460543,,,,,0,0,0,0
1650449093.0769424,public.usertable,411933,81444,566517760,16893,public,usertable,1,0,962427,2770718,460941,38976,49008,16131,411933,81444,548925,460941,,,,,0,0,0,0
1650449094.1058052,public.usertable,412254,81473,566878208,16893,public,usertable,1,0,963314,2772603,461283,38989,49029,16139,412254,81473,549301,461283,,,,,0,0,0,0
1650449095.1345677,public.usertable,412455,81506,567164928,16893,public,usertable,1,0,963999,2773030,461507,39000,49052,16144,412455,81506,549559,461507,,,,,0,0,0,0
1650449096.1643038,public.usertable,412822,81554,567508992,16893,public,usertable,1,0,964988,2774051,461904,39022,49082,16157,412822,81554,550008,461904,,,,,0,0,0,0
1650449097.1933284,public.usertable,413067,81573,567828480,16893,public,usertable,1,0,965637,2774880,462162,39034,49095,16163,413067,81573,550291,462162,,,,,0,0,0,0
1650449098.2226572,public.usertable,413279,81607,568098816,16893,public,usertable,1,0,966236,2775536,462391,39055,49112,16175,413279,81607,550558,462391,,,,,0,0,0,0
1650449099.2519493,public.usertable,413545,81640,568467456,16893,public,usertable,1,0,966917,2776491,462675,39070,49130,16181,413545,81640,550875,462675,,,,,0,0,0,0
1650449100.281161,public.usertable,413795,81668,568786944,16893,public,usertable,1,0,967587,2777037,462940,39088,49145,16190,413795,81668,551173,462940,,,,,0,0,0,0
1650449101.311135,public.usertable,414042,81694,569090048,16893,public,usertable,1,0,968308,2778593,463205,39102,49163,16196,414042,81694,551470,463205,,,,,0,0,0,0
1650449102.3397446,public.usertable,414271,81718,569409536,16893,public,usertable,1,0,968983,2778972,463448,39114,49177,16204,414271,81718,551739,463448,,,,,0,0,0,0
1650449103.3687983,public.usertable,414599,81752,569860096,16893,public,usertable,1,0,969924,2780157,463803,39132,49204,16212,414599,81752,552139,463803,,,,,0,0,0,0
1650449104.4052858,public.usertable,414934,81787,570318848,16893,public,usertable,1,0,970746,2781784,464163,39153,49229,16223,414934,81787,552545,464163,,,,,0,0,0,0
1650449105.4337814,public.usertable,415340,81821,570851328,16893,public,usertable,1,0,971781,2782724,464594,39168,49254,16229,415340,81821,553016,464594,,,,,0,0,0,0
1650449106.463573,public.usertable,415746,81863,571359232,16893,public,usertable,1,0,972876,2783935,465025,39189,49279,16241,415746,81863,553493,465025,,,,,0,0,0,0
1650449107.4951458,public.usertable,416122,81911,571858944,16893,public,usertable,1,0,973925,2784436,465426,39217,49304,16257,416122,81911,553947,465426,,,,,0,0,0,0
1650449108.5241275,public.usertable,416489,81963,572358656,16893,public,usertable,1,0,975099,2786149,465821,39247,49332,16273,416489,81963,554400,465821,,,,,0,0,0,0
1650449109.5549986,public.usertable,416874,82001,572858368,16893,public,usertable,1,0,976154,2788162,466240,39261,49366,16280,416874,82001,554867,466240,,,,,0,0,0,0
1650449110.5840473,public.usertable,417266,82045,573382656,16893,public,usertable,1,0,977270,2789032,466659,39278,49393,16290,417266,82045,555330,466659,,,,,0,0,0,0
1650449111.613195,public.usertable,417626,82099,573865984,16893,public,usertable,1,0,978279,2789392,467052,39301,49426,16301,417626,82099,555779,467052,,,,,0,0,0,0
1650449112.6434858,public.usertable,417961,82139,574251008,16893,public,usertable,1,0,979311,2791040,467414,39323,49453,16312,417961,82139,556190,467414,,,,,0,0,0,0
1650449113.673362,public.usertable,418200,82169,574570496,16893,public,usertable,1,0,979978,2791772,467671,39335,49471,16316,418200,82169,556477,467671,,,,,0,0,0,0
1650449114.7034616,public.usertable,418460,82197,574898176,16893,public,usertable,1,0,980771,2792174,467953,39344,49493,16320,418460,82197,556790,467953,,,,,0,0,0,0
1650449115.7323732,public.usertable,418743,82223,575283200,16893,public,usertable,1,0,981509,2793449,468251,39357,49508,16326,418743,82223,557116,468251,,,,,0,0,0,0
1650449116.7652466,public.usertable,418985,82257,575610880,16893,public,usertable,1,0,982332,2794908,468517,39369,49532,16332,418985,82257,557418,468517,,,,,0,0,0,0
1650449117.794243,public.usertable,419414,82299,576004096,16893,public,usertable,1,0,983538,2797367,468975,39397,49561,16342,419414,82299,557933,468975,,,,,0,0,0,0
1650449118.8283658,public.usertable,419676,82326,576339968,16893,public,usertable,1,0,984169,2798306,469254,39411,49578,16349,419676,82326,558243,469254,,,,,0,0,0,0
1650449119.8586931,public.usertable,419895,82356,576643072,16893,public,usertable,1,0,984759,2799210,469493,39426,49598,16359,419895,82356,558517,469493,,,,,0,0,0,0
1650449120.8872933,public.usertable,420139,82381,576954368,16893,public,usertable,1,0,985389,2800619,469752,39439,49613,16364,420139,82381,558804,469752,,,,,0,0,0,0
1650449121.9167218,public.usertable,420437,82421,577380352,16893,public,usertable,1,0,986131,2802406,470077,39458,49640,16373,420437,82421,559175,470077,,,,,0,0,0,0
1650449122.9451108,public.usertable,420781,82472,577839104,16893,public,usertable,1,0,987140,2803643,470449,39481,49668,16385,420781,82472,559598,470449,,,,,0,0,0,0
1650449123.9745352,public.usertable,421157,82516,578347008,16893,public,usertable,1,0,988257,2805556,470851,39506,49694,16399,421157,82516,560051,470851,,,,,0,0,0,0
1650449125.0051043,public.usertable,421543,82554,578838528,16893,public,usertable,1,0,989342,2807490,471258,39528,49715,16408,421543,82554,560501,471258,,,,,0,0,0,0
1650449126.0363426,public.usertable,421911,82604,579354624,16893,public,usertable,1,0,990545,2809170,471660,39552,49749,16418,421911,82604,560961,471660,,,,,0,0,0,0
1650449127.06917,public.usertable,422259,82660,579821568,16893,public,usertable,1,0,991700,2810661,472041,39577,49782,16434,422259,82660,561400,472041,,,,,0,0,0,0
1650449128.098354,public.usertable,422634,82712,580313088,16893,public,usertable,1,0,992798,2812725,472452,39598,49818,16444,422634,82712,561868,472452,,,,,0,0,0,0
1650449129.1275012,public.usertable,423003,82753,580820992,16893,public,usertable,1,0,993827,2815377,472853,39614,49850,16453,423003,82753,562317,472853,,,,,0,0,0,0
1650449130.157987,public.usertable,423359,82809,581287936,16893,public,usertable,1,0,994937,2816622,473248,39635,49889,16462,423359,82809,562772,473248,,,,,0,0,0,0
1650449131.1889098,public.usertable,423705,82860,581779456,16893,public,usertable,1,0,996034,2818358,473627,39661,49922,16475,423705,82860,563210,473627,,,,,0,0,0,0
1650449132.2201083,public.usertable,424081,82899,582287360,16893,public,usertable,1,0,997029,2820102,474030,39677,49949,16484,424081,82899,563656,474030,,,,,0,0,0,0
1650449133.2517273,public.usertable,424467,82937,582778880,16893,public,usertable,1,0,998005,2822739,474441,39692,49974,16491,424467,82937,564107,474441,,,,,0,0,0,0
1650449134.282106,public.usertable,424842,82974,583254016,16893,public,usertable,1,0,999023,2823795,474836,39715,49994,16503,424842,82974,564545,474836,,,,,0,0,0,0
1650449135.311212,public.usertable,425186,82999,583712768,16893,public,usertable,1,0,999985,2826651,475202,39734,50016,16513,425186,82999,564952,475202,,,,,0,0,0,0
1650449136.3404734,public.usertable,425758,83061,584220672,16893,public,usertable,1,0,1001583,2828404,475817,39760,50059,16528,425758,83061,565636,475817,,,,,0,0,0,0
1650449137.3694217,public.usertable,426131,83102,584720384,16893,public,usertable,1,0,1002666,2831182,476220,39786,50089,16542,426131,83102,566095,476220,,,,,0,0,0,0
1650449138.397728,public.usertable,426532,83147,585244672,16893,public,usertable,1,0,1003753,2832547,476654,39804,50122,16552,426532,83147,566580,476654,,,,,0,0,0,0
1650449139.429589,public.usertable,426889,83202,585728000,16893,public,usertable,1,0,1004788,2833986,477034,39842,50145,16569,426889,83202,567021,477034,,,,,0,0,0,0
1650449140.4582827,public.usertable,427263,83245,586227712,16893,public,usertable,1,0,1005822,2836297,477445,39854,50182,16575,427263,83245,567481,477445,,,,,0,0,0,0
1650449141.4892356,public.usertable,427647,83283,586735616,16893,public,usertable,1,0,1006923,2837682,477852,39871,50205,16584,427647,83283,567928,477852,,,,,0,0,0,0
1650449142.518886,public.usertable,427988,83324,587177984,16893,public,usertable,1,0,1007842,2839520,478219,39888,50231,16592,427988,83324,568338,478219,,,,,0,0,0,0
1650449143.5473776,public.usertable,428344,83387,587669504,16893,public,usertable,1,0,1008902,2839878,478610,39920,50266,16614,428344,83387,568796,478610,,,,,0,0,0,0
1650449144.5758073,public.usertable,428720,83430,588152832,16893,public,usertable,1,0,1009939,2841089,479014,39937,50294,16623,428720,83430,569245,479014,,,,,0,0,0,0
1650449145.607082,public.usertable,429079,83478,588652544,16893,public,usertable,1,0,1010992,2843013,479409,39959,50330,16636,429079,83478,569698,479409,,,,,0,0,0,0
1650449146.6355765,public.usertable,429450,83524,589144064,16893,public,usertable,1,0,1012108,2844599,479808,39983,50358,16648,429450,83524,570149,479808,,,,,0,0,0,0
1650449147.6654902,public.usertable,429817,83568,589635584,16893,public,usertable,1,0,1013154,2845578,480206,40000,50389,16657,429817,83568,570595,480206,,,,,0,0,0,0
1650449148.6958125,public.usertable,430193,83602,590127104,16893,public,usertable,1,0,1014133,2846999,480610,40013,50417,16661,430193,83602,571040,480610,,,,,0,0,0,0
1650449149.725729,public.usertable,430575,83649,590651392,16893,public,usertable,1,0,1015187,2848119,481022,40033,50447,16671,430575,83649,571502,481022,,,,,0,0,0,0
1650449150.7546008,public.usertable,430982,83701,591216640,16893,public,usertable,1,0,1016337,2849657,481458,40069,50476,16688,430982,83701,572003,481458,,,,,0,0,0,0
1650449151.7841976,public.usertable,431415,83748,591765504,16893,public,usertable,1,0,1017493,2851768,481919,40097,50504,16700,431415,83748,572520,481919,,,,,0,0,0,0
1650449152.8129349,public.usertable,431803,83795,592265216,16893,public,usertable,1,0,1018609,2853203,482338,40121,50535,16710,431803,83795,572994,482338,,,,,0,0,0,0
1650449153.8418539,public.usertable,432157,83837,592732160,16893,public,usertable,1,0,1019711,2854911,482721,40145,50564,16722,432157,83837,573430,482721,,,,,0,0,0,0
1650449154.871159,public.usertable,432468,83877,593166336,16893,public,usertable,1,0,1020658,2857610,483061,40160,50593,16728,432468,83877,573814,483061,,,,,0,0,0,0
1650449155.8995636,public.usertable,432939,83927,593543168,16893,public,usertable,1,0,1022063,2860471,483563,40197,50624,16745,432939,83927,574384,483563,,,,,0,0,0,0
1650449156.9294026,public.usertable,433280,83961,593977344,16893,public,usertable,1,0,1023085,2861577,483919,40218,50639,16760,433280,83961,574776,483919,,,,,0,0,0,0
1650449157.9600582,public.usertable,433603,84002,594427904,16893,public,usertable,1,0,1024124,2864093,484271,40239,50668,16772,433603,84002,575178,484271,,,,,0,0,0,0
1650449158.9892254,public.usertable,433978,84038,594903040,16893,public,usertable,1,0,1025183,2864875,484666,40259,50688,16782,433978,84038,575613,484666,,,,,0,0,0,0
1650449160.0181353,public.usertable,434341,84076,595369984,16893,public,usertable,1,0,1026194,2866820,485054,40278,50713,16792,434341,84076,576045,485054,,,,,0,0,0,0
1650449161.0471187,public.usertable,434688,84115,595853312,16893,public,usertable,1,0,1027228,2868749,485427,40302,50739,16803,434688,84115,576468,485427,,,,,0,0,0,0
1650449162.0765646,public.usertable,435081,84161,596361216,16893,public,usertable,1,0,1028277,2870078,485845,40325,50764,16816,435081,84161,576934,485845,,,,,0,0,0,0
1650449163.1062946,public.usertable,435446,84220,596844544,16893,public,usertable,1,0,1029372,2871028,486245,40354,50799,16836,435446,84220,577398,486245,,,,,0,0,0,0
1650449164.1350837,public.usertable,435815,84255,597327872,16893,public,usertable,1,0,1030265,2872305,486633,40372,50818,16845,435815,84255,577823,486633,,,,,0,0,0,0
1650449165.1702254,public.usertable,436134,84304,597704704,16893,public,usertable,1,0,1031288,2872918,486981,40396,50847,16857,436134,84304,578224,486981,,,,,0,0,0,0
1650449166.2014658,public.usertable,436407,84338,598122496,16893,public,usertable,1,0,1032097,2874087,487277,40411,50870,16861,436407,84338,578558,487277,,,,,0,0,0,0
1650449167.231591,public.usertable,436724,84380,598556672,16893,public,usertable,1,0,1033038,2875173,487622,40427,50898,16870,436724,84380,578947,487622,,,,,0,0,0,0
1650449168.261086,public.usertable,437041,84404,598966272,16893,public,usertable,1,0,1033885,2879249,487961,40445,50920,16879,437041,84404,579326,487961,,,,,0,0,0,0
1650449169.289979,public.usertable,437372,84453,599465984,16893,public,usertable,1,0,1034872,2881209,488329,40462,50957,16885,437372,84453,579748,488329,,,,,0,0,0,0
1650449170.3223639,public.usertable,437779,84491,599965696,16893,public,usertable,1,0,1035845,2881852,488756,40480,50977,16895,437779,84491,580213,488756,,,,,0,0,0,0
1650449171.3530035,public.usertable,438137,84541,600432640,16893,public,usertable,1,0,1036872,2883752,489143,40503,51006,16908,438137,84541,580652,489143,,,,,0,0,0,0
1650449172.3813436,public.usertable,438509,84594,600956928,16893,public,usertable,1,0,1037907,2885155,489547,40529,51038,16926,438509,84594,581114,489547,,,,,0,0,0,0
1650449173.41018,public.usertable,438889,84641,601456640,16893,public,usertable,1,0,1039009,2886097,489957,40549,51068,16934,438889,84641,581574,489957,,,,,0,0,0,0
1650449174.4382684,public.usertable,439450,84703,601948160,16893,public,usertable,1,0,1040628,2887931,490558,40581,51108,16950,439450,84703,582247,490558,,,,,0,0,0,0
1650449175.4689407,public.usertable,439817,84742,602423296,16893,public,usertable,1,0,1041727,2889299,490946,40601,51129,16961,439817,84742,582676,490946,,,,,0,0,0,0
1650449176.5004065,public.usertable,440184,84791,602923008,16893,public,usertable,1,0,1042858,2890832,491347,40620,51163,16970,440184,84791,583130,491347,,,,,0,0,0,0
1650449177.531806,public.usertable,440587,84826,603447296,16893,public,usertable,1,0,1043902,2891882,491773,40637,51186,16975,440587,84826,583596,491773,,,,,0,0,0,0
1650449178.560343,public.usertable,440962,84853,603938816,16893,public,usertable,1,0,1044970,2894283,492174,40652,51212,16987,440962,84853,584038,492174,,,,,0,0,0,0
1650449179.588972,public.usertable,441327,84902,604413952,16893,public,usertable,1,0,1046017,2895172,492569,40672,51242,17002,441327,84902,584483,492569,,,,,0,0,0,0
1650449180.6177263,public.usertable,441701,84953,604913664,16893,public,usertable,1,0,1047112,2896455,492971,40695,51270,17019,441701,84953,584936,492971,,,,,0,0,0,0
1650449181.6473813,public.usertable,442096,84995,605429760,16893,public,usertable,1,0,1048150,2897525,493389,40716,51293,17030,442096,84995,585398,493389,,,,,0,0,0,0
1650449182.6764796,public.usertable,442470,85038,605937664,16893,public,usertable,1,0,1049279,2899920,493795,40742,51325,17045,442470,85038,585862,493795,,,,,0,0,0,0
1650449183.7069438,public.usertable,442869,85091,606461952,16893,public,usertable,1,0,1050355,2902297,494226,40769,51357,17057,442869,85091,586352,494226,,,,,0,0,0,0
1650449184.7367876,public.usertable,443283,85128,606994432,16893,public,usertable,1,0,1051394,2903574,494660,40787,51377,17069,443283,85128,586824,494660,,,,,0,0,0,0
1650449185.7706428,public.usertable,443677,85171,607502336,16893,public,usertable,1,0,1052528,2903990,495074,40811,51397,17082,443677,85171,587282,495074,,,,,0,0,0,0
1650449186.7991104,public.usertable,444043,85214,608018432,16893,public,usertable,1,0,1053644,2906283,495472,40833,51429,17096,444043,85214,587734,495472,,,,,0,0,0,0
1650449187.829061,public.usertable,444437,85269,608509952,16893,public,usertable,1,0,1054824,2907685,495899,40858,51462,17107,444437,85269,588219,495899,,,,,0,0,0,0
1650449188.8584423,public.usertable,444817,85316,609026048,16893,public,usertable,1,0,1055886,2909210,496311,40880,51494,17120,444817,85316,588685,496311,,,,,0,0,0,0
1650449189.88892,public.usertable,445188,85375,609525760,16893,public,usertable,1,0,1056990,2910194,496716,40910,51528,17137,445188,85375,589154,496716,,,,,0,0,0,0
1650449190.9175363,public.usertable,445554,85429,610041856,16893,public,usertable,1,0,1058013,2911225,497115,40934,51561,17148,445554,85429,589610,497115,,,,,0,0,0,0
1650449191.9485734,public.usertable,445932,85476,610516992,16893,public,usertable,1,0,1059030,2912108,497521,40955,51589,17160,445932,85476,590065,497521,,,,,0,0,0,0
1650449192.9793854,public.usertable,446514,85546,611041280,16893,public,usertable,1,0,1060649,2914321,498148,40983,51634,17175,446514,85546,590765,498148,,,,,0,0,0,0
1650449194.0076892,public.usertable,446895,85594,611549184,16893,public,usertable,1,0,1061821,2915821,498558,41005,51663,17187,446895,85594,591226,498558,,,,,0,0,0,0
1650449195.0436764,public.usertable,447274,85639,612065280,16893,public,usertable,1,0,1062915,2918588,498970,41028,51696,17196,447274,85639,591694,498970,,,,,0,0,0,0
1650449196.0736845,public.usertable,447611,85687,612466688,16893,public,usertable,1,0,1063921,2919791,499338,41045,51727,17205,447611,85687,592110,499338,,,,,0,0,0,0
1650449197.1023562,public.usertable,447941,85732,612933632,16893,public,usertable,1,0,1064919,2922068,499698,41069,51757,17216,447941,85732,592524,499698,,,,,0,0,0,0
1650449198.1313236,public.usertable,448300,85773,613408768,16893,public,usertable,1,0,1066004,2923040,500081,41093,51781,17233,448300,85773,592955,500081,,,,,0,0,0,0
1650449199.159658,public.usertable,448657,85816,613883904,16893,public,usertable,1,0,1066932,2924144,500461,41119,51804,17247,448657,85816,593384,500461,,,,,0,0,0,0
1650449200.1889222,public.usertable,449030,85846,614342656,16893,public,usertable,1,0,1067962,2925842,500850,41140,51820,17261,449030,85846,593810,500850,,,,,0,0,0,0
1650449201.21716,public.usertable,449412,85879,614834176,16893,public,usertable,1,0,1069003,2926878,501251,41160,51839,17272,449412,85879,594250,501251,,,,,0,0,0,0
1650449202.2459679,public.usertable,449799,85910,615342080,16893,public,usertable,1,0,1069923,2928125,501656,41176,51857,17280,449799,85910,594689,501656,,,,,0,0,0,0
1650449203.2746742,public.usertable,450172,85946,615817216,16893,public,usertable,1,0,1071016,2929618,502054,41192,51882,17289,450172,85946,595128,502054,,,,,0,0,0,0
1650449204.30564,public.usertable,450538,85980,616300544,16893,public,usertable,1,0,1071998,2931638,502447,41206,51909,17296,450538,85980,595562,502447,,,,,0,0,0,0
1650449205.3395877,public.usertable,450846,86048,616751104,16893,public,usertable,1,0,1073039,2933107,502795,41235,51949,17315,450846,86048,595979,502795,,,,,0,0,0,0
1650449206.367967,public.usertable,451239,86088,617259008,16893,public,usertable,1,0,1074090,2934389,503208,41260,51969,17324,451239,86088,596437,503208,,,,,0,0,0,0
1650449207.3962085,public.usertable,451604,86124,617742336,16893,public,usertable,1,0,1075156,2935795,503599,41284,51995,17334,451604,86124,596878,503599,,,,,0,0,0,0
1650449208.424637,public.usertable,451951,86162,618192896,16893,public,usertable,1,0,1076105,2937445,503967,41303,52016,17348,451951,86162,597286,503967,,,,,0,0,0,0
1650449209.453453,public.usertable,452307,86200,618618880,16893,public,usertable,1,0,1077148,2938946,504352,41320,52045,17357,452307,86200,597717,504352,,,,,0,0,0,0
1650449210.4877925,public.usertable,452588,86233,618962944,16893,public,usertable,1,0,1077917,2939239,504656,41332,52068,17367,452588,86233,598056,504656,,,,,0,0,0,0
1650449211.5176022,public.usertable,452826,86263,619249664,16893,public,usertable,1,0,1078570,2940025,504910,41349,52084,17374,452826,86263,598343,504910,,,,,0,0,0,0
1650449212.5455718,public.usertable,453031,86281,619520000,16893,public,usertable,1,0,1079106,2941127,505128,41358,52097,17377,453031,86281,598583,505128,,,,,0,0,0,0
1650449213.573375,public.usertable,453269,86308,619896832,16893,public,usertable,1,0,1079803,2942659,505386,41370,52117,17386,453269,86308,598873,505386,,,,,0,0,0,0
1650449214.6035745,public.usertable,453660,86354,620208128,16893,public,usertable,1,0,1080804,2942951,505804,41389,52144,17396,453660,86354,599337,505804,,,,,0,0,0,0
1650449215.637611,public.usertable,453904,86387,620535808,16893,public,usertable,1,0,1081564,2943420,506066,41404,52162,17404,453904,86387,599632,506066,,,,,0,0,0,0
1650449216.6680076,public.usertable,454163,86415,620871680,16893,public,usertable,1,0,1082366,2944021,506345,41413,52182,17411,454163,86415,599940,506345,,,,,0,0,0,0
1650449217.6968374,public.usertable,454418,86438,621215744,16893,public,usertable,1,0,1083149,2945535,506618,41425,52200,17413,454418,86438,600243,506618,,,,,0,0,0,0
1650449218.7285259,public.usertable,454748,86470,621649920,16893,public,usertable,1,0,1084249,2947203,506972,41442,52224,17422,454748,86470,600638,506972,,,,,0,0,0,0
1650449219.75816,public.usertable,455070,86506,622084096,16893,public,usertable,1,0,1085180,2948213,507319,41455,52249,17429,455070,86506,601023,507319,,,,,0,0,0,0
1650449220.7877402,public.usertable,455464,86547,622592000,16893,public,usertable,1,0,1086311,2949538,507741,41470,52277,17438,455464,86547,601488,507741,,,,,0,0,0,0
1650449221.8182795,public.usertable,455840,86595,623083520,16893,public,usertable,1,0,1087329,2951293,508140,41499,52300,17450,455840,86595,601939,508140,,,,,0,0,0,0
1650449222.8460174,public.usertable,456164,86630,623517696,16893,public,usertable,1,0,1088221,2952608,508490,41520,52326,17463,456164,86630,602336,508490,,,,,0,0,0,0
1650449223.8763864,public.usertable,456493,86673,623960064,16893,public,usertable,1,0,1089253,2953069,508848,41534,52355,17472,456493,86673,602737,508848,,,,,0,0,0,0
1650449224.9066074,public.usertable,456854,86705,624427008,16893,public,usertable,1,0,1090234,2954152,509228,41551,52374,17484,456854,86705,603153,509228,,,,,0,0,0,0
1650449225.938595,public.usertable,457216,86736,624885760,16893,public,usertable,1,0,1091226,2956476,509611,41569,52395,17495,457216,86736,603575,509611,,,,,0,0,0,0
1650449226.9671135,public.usertable,457576,86759,625319936,16893,public,usertable,1,0,1092252,2959015,510000,41581,52424,17502,457576,86759,604005,510000,,,,,0,0,0,0
1650449227.995859,public.usertable,457894,86793,625778688,16893,public,usertable,1,0,1093227,2960790,510338,41601,52444,17510,457894,86793,604383,510338,,,,,0,0,0,0
1650449229.0271065,public.usertable,458243,86834,626253824,16893,public,usertable,1,0,1094231,2961385,510716,41613,52473,17514,458243,86834,604802,510716,,,,,0,0,0,0
1650449230.0561457,public.usertable,458611,86874,626745344,16893,public,usertable,1,0,1095247,2962177,511110,41628,52499,17523,458611,86874,605237,511110,,,,,0,0,0,0
1650449231.0863817,public.usertable,458982,86927,627236864,16893,public,usertable,1,0,1096415,2962834,511510,41653,52528,17539,458982,86927,605691,511510,,,,,0,0,0,0
1650449232.1195111,public.usertable,459359,86973,627728384,16893,public,usertable,1,0,1097500,2964291,511911,41677,52552,17550,459359,86973,606140,511911,,,,,0,0,0,0
1650449233.1499722,public.usertable,459913,87032,628211712,16893,public,usertable,1,0,1099061,2966050,512502,41703,52589,17565,459913,87032,606794,512502,,,,,0,0,0,0
1650449234.1798167,public.usertable,460266,87080,628678656,16893,public,usertable,1,0,1100085,2966959,512886,41720,52620,17577,460266,87080,607226,512886,,,,,0,0,0,0
1650449235.208891,public.usertable,460596,87133,629129216,16893,public,usertable,1,0,1101156,2967564,513257,41735,52661,17586,460596,87133,607653,513257,,,,,0,0,0,0
1650449236.2391157,public.usertable,460929,87176,629571584,16893,public,usertable,1,0,1102182,2969686,513615,41760,52686,17599,460929,87176,608061,513615,,,,,0,0,0,0
1650449237.2674782,public.usertable,461252,87224,630022144,16893,public,usertable,1,0,1103235,2971202,513971,41784,52719,17612,461252,87224,608474,513971,,,,,0,0,0,0
1650449238.297083,public.usertable,461613,87254,630489088,16893,public,usertable,1,0,1104219,2971922,514348,41800,52735,17617,461613,87254,608883,514348,,,,,0,0,0,0
1650449239.3259325,public.usertable,461953,87292,630931456,16893,public,usertable,1,0,1105206,2974835,514714,41820,52761,17629,461953,87292,609295,514714,,,,,0,0,0,0
1650449240.3545647,public.usertable,462273,87318,631324672,16893,public,usertable,1,0,1106147,2976152,515049,41836,52776,17636,462273,87318,609661,515049,,,,,0,0,0,0
1650449241.3847766,public.usertable,462524,87356,631676928,16893,public,usertable,1,0,1106890,2977250,515324,41857,52800,17648,462524,87356,609981,515324,,,,,0,0,0,0
1650449242.416031,public.usertable,462749,87393,631947264,16893,public,usertable,1,0,1107549,2978422,515567,41879,52818,17660,462749,87393,610264,515567,,,,,0,0,0,0
1650449243.4452379,public.usertable,463010,87421,632332288,16893,public,usertable,1,0,1108327,2979204,515845,41894,52835,17673,463010,87421,610574,515845,,,,,0,0,0,0
1650449244.4738066,public.usertable,463339,87443,632766464,16893,public,usertable,1,0,1109251,2982286,516193,41908,52854,17680,463339,87443,610955,516193,,,,,0,0,0,0
1650449245.501722,public.usertable,463651,87466,633167872,16893,public,usertable,1,0,1110077,2982869,516518,41919,52867,17688,463651,87466,611304,516518,,,,,0,0,0,0
1650449246.5300317,public.usertable,463995,87500,633618432,16893,public,usertable,1,0,1110918,2983473,516882,41933,52887,17694,463995,87500,611702,516882,,,,,0,0,0,0
1650449247.5594397,public.usertable,464291,87534,633962496,16893,public,usertable,1,0,1111792,2983946,517200,41945,52909,17698,464291,87534,612054,517200,,,,,0,0,0,0
1650449248.5889661,public.usertable,464543,87557,634331136,16893,public,usertable,1,0,1112564,2986673,517467,41962,52924,17703,464543,87557,612353,517467,,,,,0,0,0,0
1650449249.616711,public.usertable,464871,87590,634781696,16893,public,usertable,1,0,1113528,2987403,517821,41974,52950,17711,464871,87590,612745,517821,,,,,0,0,0,0
1650449250.647771,public.usertable,465216,87623,635248640,16893,public,usertable,1,0,1114453,2989764,518187,41993,52971,17721,465216,87623,613151,518187,,,,,0,0,0,0
1650449251.678971,public.usertable,465553,87674,635691008,16893,public,usertable,1,0,1115629,2991407,518560,42014,53007,17734,465553,87674,613581,518560,,,,,0,0,0,0
1650449252.7087553,public.usertable,466099,87733,636190720,16893,public,usertable,1,0,1117036,2992579,519140,42048,53041,17747,466099,87733,614229,519140,,,,,0,0,0,0
1650449253.7385006,public.usertable,466463,87767,636657664,16893,public,usertable,1,0,1118017,2993563,519524,42063,53061,17752,466463,87767,614648,519524,,,,,0,0,0,0
1650449254.7701144,public.usertable,466806,87805,637108224,16893,public,usertable,1,0,1118925,2994302,519886,42083,53080,17765,466806,87805,615049,519886,,,,,0,0,0,0
1650449255.7999191,public.usertable,467153,87857,637583360,16893,public,usertable,1,0,1119951,2995970,520258,42113,53105,17779,467153,87857,615476,520258,,,,,0,0,0,0
1650449256.830952,public.usertable,467515,87894,638042112,16893,public,usertable,1,0,1121021,2998002,520648,42132,53133,17789,467515,87894,615913,520648,,,,,0,0,0,0
1650449257.859245,public.usertable,467831,87929,638468096,16893,public,usertable,1,0,1121930,2999667,520984,42147,53153,17796,467831,87929,616284,520984,,,,,0,0,0,0
1650449258.887775,public.usertable,468178,87969,638926848,16893,public,usertable,1,0,1122915,3001798,521355,42169,53177,17805,468178,87969,616701,521355,,,,,0,0,0,0
1650449259.9176195,public.usertable,468557,88009,639418368,16893,public,usertable,1,0,1123930,3002611,521750,42196,53193,17814,468557,88009,617139,521750,,,,,0,0,0,0
1650449260.9463053,public.usertable,468949,88028,639918080,16893,public,usertable,1,0,1124923,3004989,522159,42213,53210,17826,468949,88028,617582,522159,,,,,0,0,0,0
1650449261.977418,public.usertable,469306,88053,640385024,16893,public,usertable,1,0,1125961,3006031,522539,42230,53233,17833,469306,88053,618002,522539,,,,,0,0,0,0
1650449263.0052607,public.usertable,469678,88087,640860160,16893,public,usertable,1,0,1127197,3007657,522933,42253,53255,17844,469678,88087,618441,522933,,,,,0,0,0,0
1650449264.03532,public.usertable,470051,88130,641343488,16893,public,usertable,1,0,1128162,3008954,523330,42273,53279,17854,470051,88130,618882,523330,,,,,0,0,0,0
1650449265.0635777,public.usertable,470401,88168,641818624,16893,public,usertable,1,0,1129215,3011206,523696,42298,53295,17870,470401,88168,619289,523696,,,,,0,0,0,0
1650449266.0939035,public.usertable,470746,88202,642236416,16893,public,usertable,1,0,1130171,3011771,524059,42315,53313,17880,470746,88202,619687,524059,,,,,0,0,0,0
1650449267.122827,public.usertable,471080,88247,642686976,16893,public,usertable,1,0,1131148,3013557,524422,42338,53342,17893,471080,88247,620102,524422,,,,,0,0,0,0
1650449268.1520624,public.usertable,471411,88280,643129344,16893,public,usertable,1,0,1132045,3014464,524771,42356,53360,17903,471411,88280,620487,524771,,,,,0,0,0,0
1650449269.1801982,public.usertable,471784,88314,643596288,16893,public,usertable,1,0,1132984,3016061,525159,42377,53375,17914,471784,88314,620911,525159,,,,,0,0,0,0
1650449270.2133038,public.usertable,472137,88347,643989504,16893,public,usertable,1,0,1133859,3017009,525527,42398,53390,17925,472137,88347,621315,525527,,,,,0,0,0,0
1650449271.2414417,public.usertable,472405,88382,644399104,16893,public,usertable,1,0,1134649,3018406,525816,42417,53411,17932,472405,88382,621644,525816,,,,,0,0,0,0
1650449272.2707956,public.usertable,472713,88408,644800512,16893,public,usertable,1,0,1135512,3021074,526144,42431,53431,17940,472713,88408,622006,526144,,,,,0,0,0,0
1650449273.2991452,public.usertable,473153,88445,645160960,16893,public,usertable,1,0,1136656,3022344,526610,42451,53457,17954,473153,88445,622518,526610,,,,,0,0,0,0
1650449274.329634,public.usertable,473420,88461,645505024,16893,public,usertable,1,0,1137334,3024157,526890,42466,53470,17962,473420,88461,622826,526890,,,,,0,0,0,0
1650449275.3585904,public.usertable,473703,88496,645857280,16893,public,usertable,1,0,1138079,3025073,527192,42488,53489,17973,473703,88496,623169,527192,,,,,0,0,0,0
1650449276.3892505,public.usertable,473945,88517,646176768,16893,public,usertable,1,0,1138746,3026236,527446,42497,53501,17977,473945,88517,623444,527446,,,,,0,0,0,0
1650449277.420176,public.usertable,474194,88549,646520832,16893,public,usertable,1,0,1139510,3027347,527721,42508,53527,17984,474194,88549,623756,527721,,,,,0,0,0,0
1650449278.4525008,public.usertable,474465,88584,646889472,16893,public,usertable,1,0,1140309,3027656,528014,42521,53549,17992,474465,88584,624084,528014,,,,,0,0,0,0
1650449279.482051,public.usertable,474727,88614,647225344,16893,public,usertable,1,0,1141100,3028274,528293,42535,53566,17999,474727,88614,624394,528293,,,,,0,0,0,0
1650449280.5113041,public.usertable,475005,88654,647593984,16893,public,usertable,1,0,1141877,3028845,528586,42560,53581,18008,475005,88654,624727,528586,,,,,0,0,0,0
1650449281.5405812,public.usertable,475290,88688,647995392,16893,public,usertable,1,0,1142678,3030269,528890,42581,53600,18017,475290,88688,625071,528890,,,,,0,0,0,0
1650449282.569651,public.usertable,475558,88721,648314880,16893,public,usertable,1,0,1143526,3033133,529184,42592,53626,18022,475558,88721,625402,529184,,,,,0,0,0,0
1650449283.600671,public.usertable,475838,88742,648708096,16893,public,usertable,1,0,1144261,3034049,529477,42610,53639,18027,475838,88742,625726,529477,,,,,0,0,0,0
1650449284.6297908,public.usertable,476120,88770,649084928,16893,public,usertable,1,0,1144999,3034450,529775,42624,53655,18033,476120,88770,626054,529775,,,,,0,0,0,0
1650449285.6577208,public.usertable,476407,88797,649453568,16893,public,usertable,1,0,1145936,3035231,530082,42638,53675,18040,476407,88797,626395,530082,,,,,0,0,0,0
1650449286.686788,public.usertable,476722,88825,649879552,16893,public,usertable,1,0,1146851,3036724,530413,42662,53691,18054,476722,88825,626766,530413,,,,,0,0,0,0
1650449287.7161155,public.usertable,476998,88864,650240000,16893,public,usertable,1,0,1147774,3037920,530714,42679,53716,18063,476998,88864,627109,530714,,,,,0,0,0,0
1650449288.7462442,public.usertable,477275,88894,650625024,16893,public,usertable,1,0,1148559,3038424,531009,42692,53734,18067,477275,88894,627435,531009,,,,,0,0,0,0
1650449289.7779245,public.usertable,477519,88920,650887168,16893,public,usertable,1,0,1149151,3038873,531272,42703,53753,18074,477519,88920,627728,531272,,,,,0,0,0,0
1650449290.805727,public.usertable,477726,88937,651141120,16893,public,usertable,1,0,1149719,3039698,531494,42713,53768,18083,477726,88937,627975,531494,,,,,0,0,0,0
1650449291.8335268,public.usertable,478016,88960,651386880,16893,public,usertable,1,0,1150513,3041150,531799,42721,53783,18085,478016,88960,628303,531799,,,,,0,0,0,0
1650449292.8618324,public.usertable,478203,88979,651632640,16893,public,usertable,1,0,1151009,3042521,531998,42730,53795,18087,478203,88979,628523,531998,,,,,0,0,0,0
1650449293.8924775,public.usertable,478497,89006,652009472,16893,public,usertable,1,0,1151883,3043915,532312,42744,53815,18095,478497,89006,628871,532312,,,,,0,0,0,0
1650449294.9208527,public.usertable,478839,89049,652476416,16893,public,usertable,1,0,1152919,3045231,532681,42766,53842,18110,478839,89049,629289,532681,,,,,0,0,0,0
1650449295.9521723,public.usertable,479190,89092,652943360,16893,public,usertable,1,0,1153952,3046181,533062,42782,53872,18119,479190,89092,629716,533062,,,,,0,0,0,0
1650449296.9823039,public.usertable,479530,89132,653393920,16893,public,usertable,1,0,1154952,3047169,533426,42803,53896,18130,479530,89132,630125,533426,,,,,0,0,0,0
1650449298.01164,public.usertable,479879,89166,653852672,16893,public,usertable,1,0,1155913,3048303,533797,42818,53918,18134,479879,89166,630533,533797,,,,,0,0,0,0
1650449299.040592,public.usertable,480224,89191,654303232,16893,public,usertable,1,0,1156957,3049924,534158,42839,53934,18145,480224,89191,630931,534158,,,,,0,0,0,0
1650449300.072682,public.usertable,480568,89223,654770176,16893,public,usertable,1,0,1157951,3051491,534524,42859,53956,18154,480568,89223,631339,534524,,,,,0,0,0,0
1650449301.1022038,public.usertable,480938,89255,655228928,16893,public,usertable,1,0,1158880,3052492,534915,42877,53977,18164,480938,89255,631769,534915,,,,,0,0,0,0
1650449302.1309905,public.usertable,481304,89299,655704064,16893,public,usertable,1,0,1159841,3053454,535304,42898,54000,18175,481304,89299,632202,535304,,,,,0,0,0,0
1650449303.1620967,public.usertable,481663,89343,656195584,16893,public,usertable,1,0,1160909,3054207,535691,42915,54028,18183,481663,89343,632634,535691,,,,,0,0,0,0
1650449304.1933556,public.usertable,481999,89381,656621568,16893,public,usertable,1,0,1161842,3056667,536052,42939,54053,18195,481999,89381,633044,536052,,,,,0,0,0,0
1650449305.2223432,public.usertable,482302,89425,657039360,16893,public,usertable,1,0,1162789,3057940,536384,42958,54082,18204,482302,89425,633424,536384,,,,,0,0,0,0
1650449306.2528625,public.usertable,482646,89467,657489920,16893,public,usertable,1,0,1163676,3058322,536760,42968,54114,18213,482646,89467,633842,536760,,,,,0,0,0,0
1650449307.2821178,public.usertable,482925,89499,657801216,16893,public,usertable,1,0,1164468,3059442,537059,42985,54134,18225,482925,89499,634178,537059,,,,,0,0,0,0
1650449308.3126507,public.usertable,483143,89525,658137088,16893,public,usertable,1,0,1165235,3060677,537292,43001,54149,18235,483143,89525,634442,537292,,,,,0,0,0,0
1650449309.343874,public.usertable,483442,89555,658497536,16893,public,usertable,1,0,1166056,3061160,537609,43017,54167,18243,483442,89555,634793,537609,,,,,0,0,0,0
1650449310.3756924,public.usertable,483715,89582,658857984,16893,public,usertable,1,0,1166821,3062427,537899,43031,54184,18252,483715,89582,635114,537899,,,,,0,0,0,0
1650449311.4100509,public.usertable,483985,89618,659210240,16893,public,usertable,1,0,1167610,3062909,538188,43051,54203,18263,483985,89618,635442,538188,,,,,0,0,0,0
1650449312.4387622,public.usertable,484368,89644,659521536,16893,public,usertable,1,0,1168693,3063641,538591,43060,54223,18268,484368,89644,635874,538591,,,,,0,0,0,0
1650449313.467825,public.usertable,484588,89661,659824640,16893,public,usertable,1,0,1169310,3065144,538827,43073,54239,18274,484588,89661,636139,538827,,,,,0,0,0,0
1650449314.4962983,public.usertable,484871,89692,660193280,16893,public,usertable,1,0,1170057,3066911,539130,43089,54259,18283,484871,89692,636478,539130,,,,,0,0,0,0
1650449315.5257998,public.usertable,485192,89732,660619264,16893,public,usertable,1,0,1171056,3067825,539479,43103,54287,18289,485192,89732,636869,539479,,,,,0,0,0,0
1650449316.5549111,public.usertable,485508,89770,661045248,16893,public,usertable,1,0,1172038,3069879,539821,43116,54313,18293,485508,89770,637250,539821,,,,,0,0,0,0
1650449317.5858958,public.usertable,485841,89814,661495808,16893,public,usertable,1,0,1172982,3071167,540184,43135,54343,18306,485841,89814,637662,540184,,,,,0,0,0,0
1650449318.6165855,public.usertable,486217,89842,661995520,16893,public,usertable,1,0,1174016,3072662,540580,43149,54363,18312,486217,89842,638092,540580,,,,,0,0,0,0
1650449319.6454806,public.usertable,486561,89880,662437888,16893,public,usertable,1,0,1174957,3074629,540948,43164,54387,18320,486561,89880,638499,540948,,,,,0,0,0,0
1650449320.6761577,public.usertable,486923,89924,662913024,16893,public,usertable,1,0,1176088,3074889,541339,43181,54416,18330,486923,89924,638936,541339,,,,,0,0,0,0
1650449321.7071362,public.usertable,487273,89967,663379968,16893,public,usertable,1,0,1177257,3077069,541712,43212,54439,18350,487273,89967,639363,541712,,,,,0,0,0,0
1650449322.7356849,public.usertable,487621,90012,663830528,16893,public,usertable,1,0,1178366,3079630,542085,43237,54464,18359,487621,90012,639786,542085,,,,,0,0,0,0
1650449323.7648,public.usertable,487946,90044,664272896,16893,public,usertable,1,0,1179277,3080667,542431,43254,54485,18368,487946,90044,640170,542431,,,,,0,0,0,0
1650449324.7945132,public.usertable,488293,90073,664723456,16893,public,usertable,1,0,1180094,3082136,542795,43272,54502,18377,488293,90073,640569,542795,,,,,0,0,0,0
1650449325.8231535,public.usertable,488634,90121,665174016,16893,public,usertable,1,0,1181123,3083542,543168,43291,54534,18384,488634,90121,640993,543168,,,,,0,0,0,0
1650449326.8518713,public.usertable,488942,90149,665550848,16893,public,usertable,1,0,1182009,3084373,543496,43304,54554,18390,488942,90149,641354,543496,,,,,0,0,0,0
1650449327.882599,public.usertable,489235,90182,665927680,16893,public,usertable,1,0,1182876,3085367,543810,43321,54575,18398,489235,90182,641706,543810,,,,,0,0,0,0
1650449328.914429,public.usertable,489538,90213,666345472,16893,public,usertable,1,0,1183695,3087172,544129,43342,54591,18411,489538,90213,642062,544129,,,,,0,0,0,0
1650449329.9450533,public.usertable,489872,90241,666771456,16893,public,usertable,1,0,1184577,3088019,544478,43360,54606,18424,489872,90241,642444,544478,,,,,0,0,0,0
1650449330.9735322,public.usertable,490222,90267,667262976,16893,public,usertable,1,0,1185525,3090845,544851,43376,54629,18431,490222,90267,642856,544851,,,,,0,0,0,0
1650449332.0024245,public.usertable,490740,90325,667705344,16893,public,usertable,1,0,1186932,3092207,545405,43403,54665,18442,490740,90325,643473,545405,,,,,0,0,0,0
1650449333.0314212,public.usertable,491050,90364,668123136,16893,public,usertable,1,0,1187815,3094108,545746,43413,54696,18446,491050,90364,643855,545746,,,,,0,0,0,0
1650449334.0629976,public.usertable,491389,90392,668573696,16893,public,usertable,1,0,1188720,3096207,546103,43434,54714,18456,491389,90392,644251,546103,,,,,0,0,0,0
1650449335.0921433,public.usertable,491699,90438,668991488,16893,public,usertable,1,0,1189658,3097076,546443,43455,54744,18466,491699,90438,644642,546443,,,,,0,0,0,0
1650449336.123393,public.usertable,492083,90469,669499392,16893,public,usertable,1,0,1190784,3099023,546856,43472,54773,18476,492083,90469,645101,546856,,,,,0,0,0,0
1650449337.1534657,public.usertable,492443,90517,669982720,16893,public,usertable,1,0,1191962,3100013,547245,43493,54802,18483,492443,90517,645540,547245,,,,,0,0,0,0
1650449338.1824393,public.usertable,492807,90561,670457856,16893,public,usertable,1,0,1192972,3101687,547636,43512,54829,18495,492807,90561,645977,547636,,,,,0,0,0,0
1650449339.2120986,public.usertable,493160,90591,670941184,16893,public,usertable,1,0,1194056,3102891,548011,43531,54851,18504,493160,90591,646393,548011,,,,,0,0,0,0
1650449340.2417011,public.usertable,493567,90626,671457280,16893,public,usertable,1,0,1195131,3104887,548436,43553,54869,18512,493567,90626,646858,548436,,,,,0,0,0,0
1650449341.271136,public.usertable,493947,90659,671948800,16893,public,usertable,1,0,1196149,3105383,548835,43573,54888,18523,493947,90659,647296,548835,,,,,0,0,0,0
1650449342.3005722,public.usertable,494336,90702,672440320,16893,public,usertable,1,0,1197145,3107067,549250,43593,54914,18539,494336,90702,647757,549250,,,,,0,0,0,0
1650449343.3303435,public.usertable,494720,90737,672948224,16893,public,usertable,1,0,1198251,3107960,549655,43612,54935,18548,494720,90737,648202,549655,,,,,0,0,0,0
1650449344.360185,public.usertable,495112,90764,673439744,16893,public,usertable,1,0,1199299,3108999,550067,43626,54955,18555,495112,90764,648648,550067,,,,,0,0,0,0
1650449345.3906183,public.usertable,495461,90820,673923072,16893,public,usertable,1,0,1200390,3110661,550450,43648,54989,18569,495461,90820,649087,550450,,,,,0,0,0,0
1650449346.4200416,public.usertable,495840,90861,674430976,16893,public,usertable,1,0,1201458,3112337,550865,43656,55025,18575,495840,90861,649546,550865,,,,,0,0,0,0
1650449347.452537,public.usertable,496257,90890,674971648,16893,public,usertable,1,0,1202591,3113279,551298,43671,55041,18581,496257,90890,650010,551298,,,,,0,0,0,0
1650449348.481517,public.usertable,496661,90928,675463168,16893,public,usertable,1,0,1203661,3113897,551732,43683,55071,18586,496661,90928,650486,551732,,,,,0,0,0,0
1650449349.5134552,public.usertable,497021,90961,675954688,16893,public,usertable,1,0,1204741,3115496,552114,43698,55093,18592,497021,90961,650905,552114,,,,,0,0,0,0
1650449350.5426154,public.usertable,497525,91010,676372480,16893,public,usertable,1,0,1206115,3117728,552654,43719,55129,18603,497525,91010,651502,552654,,,,,0,0,0,0
1650449351.5729046,public.usertable,497915,91058,676888576,16893,public,usertable,1,0,1207253,3119046,553077,43737,55162,18612,497915,91058,651976,553077,,,,,0,0,0,0
1650449352.6067,public.usertable,498266,91093,677355520,16893,public,usertable,1,0,1208190,3121529,553458,43753,55192,18624,498266,91093,652403,553458,,,,,0,0,0,0
1650449353.6349728,public.usertable,498657,91132,677863424,16893,public,usertable,1,0,1209221,3123852,553869,43775,55212,18637,498657,91132,652856,553869,,,,,0,0,0,0
1650449354.6639688,public.usertable,499044,91176,678371328,16893,public,usertable,1,0,1210287,3125351,554286,43800,55242,18650,499044,91176,653328,554286,,,,,0,0,0,0
1650449355.697572,public.usertable,499435,91207,678879232,16893,public,usertable,1,0,1211450,3127394,554698,43821,55263,18658,499435,91207,653782,554698,,,,,0,0,0,0
1650449356.728494,public.usertable,499800,91261,679370752,16893,public,usertable,1,0,1212510,3127853,555090,43848,55290,18666,499800,91261,654228,555090,,,,,0,0,0,0
1650449357.757542,public.usertable,500170,91297,679845888,16893,public,usertable,1,0,1213569,3128508,555484,43860,55314,18672,500170,91297,654658,555484,,,,,0,0,0,0
1650449358.7862031,public.usertable,500538,91345,680345600,16893,public,usertable,1,0,1214645,3129929,555875,43885,55337,18686,500538,91345,655097,555875,,,,,0,0,0,0
1650449359.815134,public.usertable,500940,91378,680861696,16893,public,usertable,1,0,1215799,3131123,556295,43905,55355,18698,500940,91378,655555,556295,,,,,0,0,0,0
1650449360.8453817,public.usertable,501337,91415,681385984,16893,public,usertable,1,0,1216794,3131775,556719,43918,55382,18706,501337,91415,656019,556719,,,,,0,0,0,0
1650449361.8757772,public.usertable,501718,91459,681877504,16893,public,usertable,1,0,1217872,3132612,557128,43937,55410,18715,501718,91459,656475,557128,,,,,0,0,0,0
1650449362.9047074,public.usertable,502108,91497,682377216,16893,public,usertable,1,0,1218982,3134131,557546,43950,55438,18723,502108,91497,656934,557546,,,,,0,0,0,0
1650449363.9331279,public.usertable,502500,91527,682909696,16893,public,usertable,1,0,1219986,3134606,557961,43965,55461,18729,502500,91527,657387,557961,,,,,0,0,0,0
1650449364.9629915,public.usertable,502910,91558,683433984,16893,public,usertable,1,0,1221072,3135511,558385,43986,55475,18742,502910,91558,657846,558385,,,,,0,0,0,0
1650449365.991703,public.usertable,503282,91604,683892736,16893,public,usertable,1,0,1222206,3136451,558786,44006,55504,18754,503282,91604,658296,558786,,,,,0,0,0,0
1650449367.0212066,public.usertable,503634,91630,684376064,16893,public,usertable,1,0,1223278,3137807,559163,44019,55529,18758,503634,91630,658711,559163,,,,,0,0,0,0
1650449368.0506256,public.usertable,504028,91668,684875776,16893,public,usertable,1,0,1224389,3138886,559577,44041,55549,18770,504028,91668,659167,559577,,,,,0,0,0,0
1650449369.0850687,public.usertable,504589,91726,685367296,16893,public,usertable,1,0,1225959,3141385,560172,44075,55583,18791,504589,91726,659830,560172,,,,,0,0,0,0
1650449370.1140327,public.usertable,504992,91759,685891584,16893,public,usertable,1,0,1227104,3142490,560601,44086,55609,18798,504992,91759,660296,560601,,,,,0,0,0,0
1650449371.1426985,public.usertable,505380,91800,686383104,16893,public,usertable,1,0,1228184,3143547,561016,44101,55636,18807,505380,91800,660753,561016,,,,,0,0,0,0
1650449372.171958,public.usertable,505776,91829,686907392,16893,public,usertable,1,0,1229161,3144163,561438,44112,55662,18813,505776,91829,661212,561438,,,,,0,0,0,0
1650449373.203664,public.usertable,506164,91868,687415296,16893,public,usertable,1,0,1230294,3144883,561852,44133,55688,18821,506164,91868,661673,561852,,,,,0,0,0,0
1650449374.2329645,public.usertable,506540,91909,687906816,16893,public,usertable,1,0,1231390,3146015,562257,44149,55717,18827,506540,91909,662123,562257,,,,,0,0,0,0
1650449375.2623792,public.usertable,506909,91938,688398336,16893,public,usertable,1,0,1232501,3147600,562643,44161,55734,18831,506909,91938,662538,562643,,,,,0,0,0,0
1650449376.2998254,public.usertable,507313,91968,688922624,16893,public,usertable,1,0,1233669,3151036,563073,44175,55760,18839,507313,91968,663008,563073,,,,,0,0,0,0
1650449377.3384578,public.usertable,507706,92011,689422336,16893,public,usertable,1,0,1234713,3151752,563492,44193,55786,18850,507706,92011,663471,563492,,,,,0,0,0,0
1650449378.3671176,public.usertable,508101,92040,689938432,16893,public,usertable,1,0,1235829,3153092,563904,44209,55803,18856,508101,92040,663916,563904,,,,,0,0,0,0
1650449379.3957865,public.usertable,508466,92083,690405376,16893,public,usertable,1,0,1236910,3154368,564294,44229,55828,18865,508466,92083,664351,564294,,,,,0,0,0,0
1650449380.425431,public.usertable,508849,92122,690864128,16893,public,usertable,1,0,1238004,3155558,564701,44248,55852,18875,508849,92122,664801,564701,,,,,0,0,0,0
1650449381.4542027,public.usertable,509186,92167,691372032,16893,public,usertable,1,0,1239007,3155828,565062,44269,55876,18885,509186,92167,665207,565062,,,,,0,0,0,0
1650449382.4860513,public.usertable,509549,92223,691871744,16893,public,usertable,1,0,1240097,3156766,565454,44296,55905,18899,509549,92223,665655,565454,,,,,0,0,0,0
1650449383.5157676,public.usertable,509922,92258,692346880,16893,public,usertable,1,0,1241102,3157594,565845,44316,55923,18909,509922,92258,666084,565845,,,,,0,0,0,0
1650449384.5455253,public.usertable,510304,92291,692830208,16893,public,usertable,1,0,1242151,3158885,566257,44326,55953,18915,510304,92291,666536,566257,,,,,0,0,0,0
1650449385.575549,public.usertable,510671,92325,693305344,16893,public,usertable,1,0,1243104,3159740,566647,44344,55976,18924,510671,92325,666967,566647,,,,,0,0,0,0
1650449386.6086464,public.usertable,511202,92380,693780480,16893,public,usertable,1,0,1244666,3161649,567213,44373,56011,18937,511202,92380,667597,567213,,,,,0,0,0,0
1650449387.6448486,public.usertable,511585,92401,694263808,16893,public,usertable,1,0,1245790,3164222,567611,44387,56026,18945,511585,92401,668024,567611,,,,,0,0,0,0
1650449388.6758926,public.usertable,511943,92436,694722560,16893,public,usertable,1,0,1246874,3165475,567983,44410,56040,18956,511943,92436,668433,567983,,,,,0,0,0,0
1650449389.7046568,public.usertable,512299,92474,695197696,16893,public,usertable,1,0,1247827,3165971,568362,44425,56063,18963,512299,92474,668850,568362,,,,,0,0,0,0
1650449390.7342453,public.usertable,512662,92512,695648256,16893,public,usertable,1,0,1248814,3167021,568743,44451,56081,18979,512662,92512,669275,568743,,,,,0,0,0,0
1650449391.7627702,public.usertable,513004,92544,696098816,16893,public,usertable,1,0,1249685,3167905,569099,44474,56095,18992,513004,92544,669668,569099,,,,,0,0,0,0
1650449392.7912836,public.usertable,513373,92576,696582144,16893,public,usertable,1,0,1250671,3168900,569485,44492,56112,19001,513373,92576,670089,569485,,,,,0,0,0,0
1650449393.8220084,public.usertable,513754,92609,697073664,16893,public,usertable,1,0,1251623,3169790,569886,44508,56132,19009,513754,92609,670526,569886,,,,,0,0,0,0
1650449394.8506324,public.usertable,514151,92647,697606144,16893,public,usertable,1,0,1252701,3171635,570310,44528,56159,19019,514151,92647,670997,570310,,,,,0,0,0,0
1650449395.8810296,public.usertable,514527,92695,698089472,16893,public,usertable,1,0,1253900,3172878,570714,44552,56187,19031,514527,92695,671453,570714,,,,,0,0,0,0
1650449396.912888,public.usertable,514912,92737,698589184,16893,public,usertable,1,0,1254960,3173248,571122,44572,56210,19047,514912,92737,671904,571122,,,,,0,0,0,0
1650449397.9418092,public.usertable,515289,92772,699088896,16893,public,usertable,1,0,1256081,3174641,571527,44591,56238,19056,515289,92772,672356,571527,,,,,0,0,0,0
1650449398.9715247,public.usertable,515668,92815,699580416,16893,public,usertable,1,0,1257105,3177281,571930,44613,56262,19071,515668,92815,672805,571930,,,,,0,0,0,0
1650449400.0016282,public.usertable,516041,92847,700071936,16893,public,usertable,1,0,1258194,3178206,572321,44635,56280,19081,516041,92847,673236,572321,,,,,0,0,0,0
1650449401.0305634,public.usertable,516420,92896,700579840,16893,public,usertable,1,0,1259332,3178943,572729,44658,56309,19092,516420,92896,673696,572729,,,,,0,0,0,0
1650449402.0616305,public.usertable,516807,92929,701087744,16893,public,usertable,1,0,1260298,3181026,573130,44680,56323,19100,516807,92929,674133,573130,,,,,0,0,0,0
1650449403.091418,public.usertable,517172,92966,701562880,16893,public,usertable,1,0,1261334,3182252,573517,44696,56345,19111,517172,92966,674558,573517,,,,,0,0,0,0
1650449404.1239629,public.usertable,517549,93008,702046208,16893,public,usertable,1,0,1262460,3183218,573921,44718,56372,19119,517549,93008,675011,573921,,,,,0,0,0,0
1650449405.1540155,public.usertable,518091,93066,702529536,16893,public,usertable,1,0,1263883,3184654,574504,44748,56413,19139,518091,93066,675665,574504,,,,,0,0,0,0
1650449406.1851037,public.usertable,518435,93103,702988288,16893,public,usertable,1,0,1264867,3187660,574876,44766,56441,19142,518435,93103,676083,574876,,,,,0,0,0,0
1650449407.216649,public.usertable,518792,93145,703471616,16893,public,usertable,1,0,1265841,3189694,575261,44785,56469,19151,518792,93145,676515,575261,,,,,0,0,0,0
1650449408.2467952,public.usertable,519184,93177,703971328,16893,public,usertable,1,0,1267101,3191541,575679,44799,56495,19157,519184,93177,676973,575679,,,,,0,0,0,0
1650449409.275524,public.usertable,519538,93217,704454656,16893,public,usertable,1,0,1268164,3192820,576059,44817,56521,19166,519538,93217,677397,576059,,,,,0,0,0,0
1650449410.3056602,public.usertable,519911,93250,704937984,16893,public,usertable,1,0,1269271,3194570,576457,44834,56546,19176,519911,93250,677837,576457,,,,,0,0,0,0
1650449411.3348286,public.usertable,520246,93291,705388544,16893,public,usertable,1,0,1270263,3195632,576820,44849,56574,19185,520246,93291,678243,576820,,,,,0,0,0,0
1650449412.3632386,public.usertable,520638,93327,705904640,16893,public,usertable,1,0,1271353,3197071,577235,44867,56597,19191,520638,93327,678699,577235,,,,,0,0,0,0
1650449413.3972096,public.usertable,521010,93369,706371584,16893,public,usertable,1,0,1272540,3198714,577635,44886,56625,19205,521010,93369,679146,577635,,,,,0,0,0,0
1650449414.425836,public.usertable,521379,93409,706871296,16893,public,usertable,1,0,1273570,3200711,578033,44906,56654,19218,521379,93409,679593,578033,,,,,0,0,0,0
1650449415.4553773,public.usertable,521760,93447,707379200,16893,public,usertable,1,0,1274712,3202182,578437,44925,56677,19232,521760,93447,680039,578437,,,,,0,0,0,0
1650449416.483849,public.usertable,522147,93468,707837952,16893,public,usertable,1,0,1275691,3202898,578836,44940,56689,19240,522147,93468,680465,578836,,,,,0,0,0,0
1650449417.5153003,public.usertable,522510,93508,708329472,16893,public,usertable,1,0,1276730,3204708,579227,44957,56717,19249,522510,93508,680901,579227,,,,,0,0,0,0
1650449418.5450351,public.usertable,522892,93549,708853760,16893,public,usertable,1,0,1277823,3205646,579639,44972,56747,19258,522892,93549,681358,579639,,,,,0,0,0,0
1650449419.5736172,public.usertable,523311,93586,709369856,16893,public,usertable,1,0,1278939,3206878,580077,44991,56766,19271,523311,93586,681834,580077,,,,,0,0,0,0
1650449420.605279,public.usertable,523679,93616,709844992,16893,public,usertable,1,0,1280032,3209257,580470,45003,56791,19275,523679,93616,682264,580470,,,,,0,0,0,0
1650449421.6346545,public.usertable,524041,93664,710328320,16893,public,usertable,1,0,1281211,3211067,580864,45028,56823,19288,524041,93664,682715,580864,,,,,0,0,0,0
1650449422.6632676,public.usertable,524415,93704,710811648,16893,public,usertable,1,0,1282190,3212588,581255,45053,56840,19301,524415,93704,683148,581255,,,,,0,0,0,0
1650449423.6937478,public.usertable,524973,93766,711311360,16893,public,usertable,1,0,1283887,3213850,581846,45085,56873,19312,524973,93766,683804,581846,,,,,0,0,0,0
1650449424.7239053,public.usertable,525343,93810,711802880,16893,public,usertable,1,0,1285021,3214620,582243,45103,56900,19319,525343,93810,684246,582243,,,,,0,0,0,0
1650449425.752711,public.usertable,525727,93854,712310784,16893,public,usertable,1,0,1286101,3216034,582648,45131,56921,19333,525727,93854,684700,582648,,,,,0,0,0,0
1650449426.784149,public.usertable,526151,93888,712851456,16893,public,usertable,1,0,1287191,3217326,583092,45146,56941,19339,526151,93888,685179,583092,,,,,0,0,0,0
1650449427.8125148,public.usertable,526528,93933,713342976,16893,public,usertable,1,0,1288281,3217677,583497,45169,56969,19350,526528,93933,685635,583497,,,,,0,0,0,0
1650449428.8406613,public.usertable,526909,93969,713842688,16893,public,usertable,1,0,1289377,3219056,583898,45187,56989,19360,526909,93969,686074,583898,,,,,0,0,0,0
1650449429.8712993,public.usertable,527289,94002,714334208,16893,public,usertable,1,0,1290485,3220202,584297,45201,57008,19368,527289,94002,686506,584297,,,,,0,0,0,0
1650449430.9001539,public.usertable,527654,94028,714784768,16893,public,usertable,1,0,1291477,3221858,584676,45219,57022,19377,527654,94028,686917,584676,,,,,0,0,0,0
1650449431.929406,public.usertable,527993,94071,715243520,16893,public,usertable,1,0,1292500,3223190,585041,45242,57048,19392,527993,94071,687331,585041,,,,,0,0,0,0
1650449432.959547,public.usertable,528354,94104,715694080,16893,public,usertable,1,0,1293519,3225750,585424,45261,57070,19406,528354,94104,687755,585424,,,,,0,0,0,0
1650449433.9894063,public.usertable,528738,94125,716193792,16893,public,usertable,1,0,1294464,3226872,585825,45278,57087,19415,528738,94125,688190,585825,,,,,0,0,0,0
1650449435.0181377,public.usertable,529059,94142,716562432,16893,public,usertable,1,0,1295337,3228279,586160,45285,57101,19418,529059,94142,688546,586160,,,,,0,0,0,0
1650449436.047136,public.usertable,529343,94165,716947456,16893,public,usertable,1,0,1296127,3229218,586460,45294,57117,19422,529343,94165,688871,586460,,,,,0,0,0,0
1650449437.076377,public.usertable,529570,94185,717209600,16893,public,usertable,1,0,1296843,3230090,586709,45302,57139,19426,529570,94185,689150,586709,,,,,0,0,0,0
1650449438.1055946,public.usertable,529804,94206,717504512,16893,public,usertable,1,0,1297502,3231331,586954,45315,57150,19432,529804,94206,689419,586954,,,,,0,0,0,0
1650449439.1353784,public.usertable,530022,94230,717799424,16893,public,usertable,1,0,1298044,3232032,587190,45322,57168,19437,530022,94230,689680,587190,,,,,0,0,0,0
1650449440.1653447,public.usertable,530255,94255,718118912,16893,public,usertable,1,0,1298754,3232655,587437,45335,57182,19445,530255,94255,689954,587437,,,,,0,0,0,0
1650449441.195362,public.usertable,530524,94283,718544896,16893,public,usertable,1,0,1299454,3233062,587726,45343,57202,19446,530524,94283,690271,587726,,,,,0,0,0,0
1650449442.2239282,public.usertable,530898,94310,719020032,16893,public,usertable,1,0,1300464,3234277,588120,45359,57222,19453,530898,94310,690701,588120,,,,,0,0,0,0
1650449443.2530885,public.usertable,531284,94345,719527936,16893,public,usertable,1,0,1301549,3236862,588535,45372,57251,19461,531284,94345,691158,588535,,,,,0,0,0,0
1650449444.281997,public.usertable,531856,94405,720027648,16893,public,usertable,1,0,1303061,3238397,589146,45398,57290,19475,531856,94405,691834,589146,,,,,0,0,0,0
1650449445.3117886,public.usertable,532237,94445,720519168,16893,public,usertable,1,0,1304192,3239492,589548,45417,57311,19486,532237,94445,692276,589548,,,,,0,0,0,0
1650449446.341591,public.usertable,532629,94482,721027072,16893,public,usertable,1,0,1305329,3240182,589962,45437,57333,19495,532629,94482,692732,589962,,,,,0,0,0,0
1650449447.3701067,public.usertable,533007,94526,721526784,16893,public,usertable,1,0,1306499,3242370,590371,45456,57364,19503,533007,94526,693191,590371,,,,,0,0,0,0
1650449448.399477,public.usertable,533389,94560,722026496,16893,public,usertable,1,0,1307630,3243483,590777,45473,57388,19508,533389,94560,693638,590777,,,,,0,0,0,0
1650449449.4285874,public.usertable,533763,94599,722518016,16893,public,usertable,1,0,1308679,3245151,591173,45493,57410,19523,533763,94599,694076,591173,,,,,0,0,0,0
1650449450.4582965,public.usertable,534120,94636,723001344,16893,public,usertable,1,0,1309757,3246762,591560,45510,57440,19532,534120,94636,694510,591560,,,,,0,0,0,0
1650449451.4892168,public.usertable,534494,94682,723501056,16893,public,usertable,1,0,1310919,3248189,591966,45530,57472,19543,534494,94682,694968,591966,,,,,0,0,0,0
1650449452.5178995,public.usertable,534850,94721,723935232,16893,public,usertable,1,0,1311957,3249372,592337,45554,57487,19561,534850,94721,695378,592337,,,,,0,0,0,0
1650449453.5464232,public.usertable,535183,94748,724377600,16893,public,usertable,1,0,1312784,3251058,592688,45571,57505,19570,535183,94748,695764,592688,,,,,0,0,0,0
1650449454.575889,public.usertable,535525,94780,724803584,16893,public,usertable,1,0,1313749,3251981,593050,45583,57525,19575,535525,94780,696158,593050,,,,,0,0,0,0
1650449455.608333,public.usertable,535855,94811,725262336,16893,public,usertable,1,0,1314717,3254044,593403,45599,57548,19586,535855,94811,696550,593403,,,,,0,0,0,0
1650449456.6393447,public.usertable,536177,94840,725647360,16893,public,usertable,1,0,1315656,3254568,593738,45615,57561,19592,536177,94840,696914,593738,,,,,0,0,0,0
1650449457.6680596,public.usertable,536516,94863,726097920,16893,public,usertable,1,0,1316536,3255387,594092,45628,57576,19600,536516,94863,697296,594092,,,,,0,0,0,0
1650449458.6964364,public.usertable,536847,94890,726523904,16893,public,usertable,1,0,1317414,3255726,594443,45637,57596,19607,536847,94890,697676,594443,,,,,0,0,0,0
1650449459.7297513,public.usertable,537194,94918,726958080,16893,public,usertable,1,0,1318380,3256663,594811,45647,57617,19612,537194,94918,698075,594811,,,,,0,0,0,0
1650449460.7580075,public.usertable,537517,94948,727318528,16893,public,usertable,1,0,1319377,3257490,595148,45664,57631,19622,537517,94948,698443,595148,,,,,0,0,0,0
1650449461.787323,public.usertable,537746,94973,727605248,16893,public,usertable,1,0,1320039,3258125,595389,45680,57643,19633,537746,94973,698712,595389,,,,,0,0,0,0
1650449462.8195734,public.usertable,538086,95010,727908352,16893,public,usertable,1,0,1321015,3259021,595754,45693,57668,19639,538086,95010,699115,595754,,,,,0,0,0,0
1650449463.8509026,public.usertable,538330,95030,728236032,16893,public,usertable,1,0,1321641,3259647,596012,45700,57682,19642,538330,95030,699394,596012,,,,,0,0,0,0
1650449464.8874164,public.usertable,538646,95064,728637440,16893,public,usertable,1,0,1322622,3260833,596349,45717,57703,19650,538646,95064,699769,596349,,,,,0,0,0,0
1650449465.9164495,public.usertable,538877,95102,728965120,16893,public,usertable,1,0,1323332,3261846,596608,45729,57731,19655,538877,95102,700068,596608,,,,,0,0,0,0
1650449466.9499583,public.usertable,539127,95120,729268224,16893,public,usertable,1,0,1324008,3262839,596871,45735,57744,19660,539127,95120,700350,596871,,,,,0,0,0,0
1650449467.979337,public.usertable,539373,95132,729571328,16893,public,usertable,1,0,1324626,3263538,597125,45739,57752,19663,539373,95132,700616,597125,,,,,0,0,0,0
1650449469.009101,public.usertable,539585,95162,729849856,16893,public,usertable,1,0,1325302,3264367,597352,45755,57767,19668,539585,95162,700874,597352,,,,,0,0,0,0
1650449470.0459998,public.usertable,539782,95186,730136576,16893,public,usertable,1,0,1325818,3264897,597563,45765,57781,19670,539782,95186,701109,597563,,,,,0,0,0,0
1650449471.0787275,public.usertable,540030,95200,730472448,16893,public,usertable,1,0,1326545,3266436,597825,45776,57795,19679,540030,95200,701396,597825,,,,,0,0,0,0
1650449472.107564,public.usertable,540366,95229,730914816,16893,public,usertable,1,0,1327330,3267537,598176,45794,57810,19690,540366,95229,701780,598176,,,,,0,0,0,0
1650449473.1362112,public.usertable,540745,95274,731414528,16893,public,usertable,1,0,1328375,3268834,598578,45818,57833,19697,540745,95274,702229,598578,,,,,0,0,0,0
1650449474.1661158,public.usertable,541130,95313,731930624,16893,public,usertable,1,0,1329459,3270187,598988,45838,57858,19705,541130,95313,702684,598988,,,,,0,0,0,0
1650449475.1950448,public.usertable,541501,95347,732413952,16893,public,usertable,1,0,1330519,3271279,599380,45857,57879,19717,541501,95347,703116,599380,,,,,0,0,0,0
1650449476.2259035,public.usertable,541889,95385,732913664,16893,public,usertable,1,0,1331616,3272037,599793,45872,57904,19723,541889,95385,703569,599793,,,,,0,0,0,0
1650449477.254429,public.usertable,542276,95425,733446144,16893,public,usertable,1,0,1332723,3273840,600207,45888,57931,19733,542276,95425,704026,600207,,,,,0,0,0,0
1650449478.288001,public.usertable,542691,95460,733978624,16893,public,usertable,1,0,1333845,3274932,600647,45903,57956,19739,542691,95460,704506,600647,,,,,0,0,0,0
1650449479.3166947,public.usertable,543100,95473,734494720,16893,public,usertable,1,0,1334969,3277254,601067,45914,57967,19743,543100,95473,704948,601067,,,,,0,0,0,0
1650449480.3470557,public.usertable,543501,95500,735002624,16893,public,usertable,1,0,1336105,3277937,601493,45927,57992,19747,543501,95500,705412,601493,,,,,0,0,0,0
1650449481.3779535,public.usertable,543859,95549,735494144,16893,public,usertable,1,0,1337269,3279275,601886,45947,58027,19762,543859,95549,705860,601886,,,,,0,0,0,0
1650449482.4066586,public.usertable,544433,95606,735993856,16893,public,usertable,1,0,1338829,3279936,602498,45975,58065,19775,544433,95606,706538,602498,,,,,0,0,0,0
1650449483.4344535,public.usertable,544822,95633,736493568,16893,public,usertable,1,0,1339892,3281403,602906,45987,58084,19779,544822,95633,706977,602906,,,,,0,0,0,0
1650449484.4632444,public.usertable,545195,95668,736976896,16893,public,usertable,1,0,1340875,3282606,603297,46007,58102,19788,545195,95668,707406,603297,,,,,0,0,0,0
1650449485.4934099,public.usertable,545589,95715,737476608,16893,public,usertable,1,0,1341954,3283303,603716,46030,58127,19802,545589,95715,707873,603716,,,,,0,0,0,0
1650449486.5235004,public.usertable,545962,95763,737959936,16893,public,usertable,1,0,1343149,3284856,604114,46057,58152,19816,545962,95763,708323,604114,,,,,0,0,0,0
1650449487.551965,public.usertable,546323,95814,738467840,16893,public,usertable,1,0,1344289,3285611,604509,46077,58186,19825,546323,95814,708772,604509,,,,,0,0,0,0
1650449488.581037,public.usertable,546726,95848,738983936,16893,public,usertable,1,0,1345441,3287844,604932,46102,58206,19838,546726,95848,709240,604932,,,,,0,0,0,0
1650449489.6096401,public.usertable,547101,95899,739483648,16893,public,usertable,1,0,1346597,3289117,605329,46131,58228,19855,547101,95899,709688,605329,,,,,0,0,0,0
1650449490.6380744,public.usertable,547486,95944,739975168,16893,public,usertable,1,0,1347736,3290508,605737,46154,58251,19869,547486,95944,710142,605737,,,,,0,0,0,0
1650449491.6678147,public.usertable,547845,95986,740458496,16893,public,usertable,1,0,1348924,3291604,606127,46169,58282,19877,547845,95986,710578,606127,,,,,0,0,0,0
1650449492.696475,public.usertable,548216,96018,740958208,16893,public,usertable,1,0,1349952,3292642,606523,46181,58307,19882,548216,96018,711011,606523,,,,,0,0,0,0
1650449493.7248654,public.usertable,548614,96040,741433344,16893,public,usertable,1,0,1350983,3293654,606941,46191,58327,19890,548614,96040,711459,606941,,,,,0,0,0,0
1650449494.7534513,public.usertable,548998,96076,741949440,16893,public,usertable,1,0,1352118,3294267,607344,46209,58346,19902,548998,96076,711899,607344,,,,,0,0,0,0
1650449495.7843173,public.usertable,549382,96106,742416384,16893,public,usertable,1,0,1353228,3296022,607750,46226,58368,19908,549382,96106,712344,607750,,,,,0,0,0,0
1650449496.813506,public.usertable,549738,96141,742899712,16893,public,usertable,1,0,1354194,3296845,608128,46241,58390,19916,549738,96141,712759,608128,,,,,0,0,0,0
1650449497.8475351,public.usertable,550090,96179,743333888,16893,public,usertable,1,0,1355205,3298205,608501,46259,58411,19926,550090,96179,713171,608501,,,,,0,0,0,0
1650449498.877437,public.usertable,550426,96220,743792640,16893,public,usertable,1,0,1356168,3299989,608864,46278,58438,19938,550426,96220,713580,608864,,,,,0,0,0,0
1650449499.9065418,public.usertable,550790,96242,744267776,16893,public,usertable,1,0,1357206,3300869,609243,46288,58453,19941,550790,96242,713984,609243,,,,,0,0,0,0
1650449500.9368148,public.usertable,551315,96297,744710144,16893,public,usertable,1,0,1358684,3301762,609806,46309,58491,19955,551315,96297,714606,609806,,,,,0,0,0,0
1650449501.9657655,public.usertable,551650,96338,745144320,16893,public,usertable,1,0,1359646,3302996,610164,46328,58514,19967,551650,96338,715006,610164,,,,,0,0,0,0
1650449503.0001192,public.usertable,551984,96372,745578496,16893,public,usertable,1,0,1360635,3304343,610514,46348,58530,19975,551984,96372,715392,610514,,,,,0,0,0,0
1650449504.028992,public.usertable,552250,96399,745947136,16893,public,usertable,1,0,1361375,3306074,610798,46365,58548,19981,552250,96399,715711,610798,,,,,0,0,0,0
1650449505.0595798,public.usertable,552572,96431,746373120,16893,public,usertable,1,0,1362285,3306268,611137,46384,58565,19987,552572,96431,716086,611137,,,,,0,0,0,0
1650449506.0931034,public.usertable,552917,96462,746807296,16893,public,usertable,1,0,1363259,3307425,611501,46402,58584,19997,552917,96462,716487,611501,,,,,0,0,0,0
1650449507.1221035,public.usertable,553290,96496,747290624,16893,public,usertable,1,0,1364309,3308437,611892,46418,58602,20007,553290,96496,716912,611892,,,,,0,0,0,0
1650449508.1521246,public.usertable,553645,96519,747765760,16893,public,usertable,1,0,1365296,3309311,612269,46433,58624,20016,553645,96519,717326,612269,,,,,0,0,0,0
1650449509.1809752,public.usertable,554015,96551,748232704,16893,public,usertable,1,0,1366320,3311372,612658,46452,58643,20024,554015,96551,717753,612658,,,,,0,0,0,0
1650449510.2104604,public.usertable,554372,96588,748691456,16893,public,usertable,1,0,1367382,3312444,613037,46469,58665,20032,554372,96588,718171,613037,,,,,0,0,0,0
1650449511.2388504,public.usertable,554734,96621,749166592,16893,public,usertable,1,0,1368407,3313145,613416,46489,58682,20045,554734,96621,718587,613416,,,,,0,0,0,0
1650449512.2728026,public.usertable,555095,96657,749633536,16893,public,usertable,1,0,1369554,3314749,613802,46500,58707,20054,555095,96657,719009,613802,,,,,0,0,0,0
1650449513.3022316,public.usertable,555477,96684,750108672,16893,public,usertable,1,0,1370478,3315347,614201,46514,58724,20063,555477,96684,719439,614201,,,,,0,0,0,0
1650449514.3315337,public.usertable,555834,96707,750575616,16893,public,usertable,1,0,1371459,3316868,614574,46530,58740,20074,555834,96707,719844,614574,,,,,0,0,0,0
1650449515.36129,public.usertable,556222,96730,751075328,16893,public,usertable,1,0,1372474,3317709,614976,46548,58754,20086,556222,96730,720278,614976,,,,,0,0,0,0
1650449516.3968558,public.usertable,556622,96762,751575040,16893,public,usertable,1,0,1373550,3318195,615393,46563,58771,20093,556622,96762,720727,615393,,,,,0,0,0,0
1650449517.4257255,public.usertable,557000,96804,752058368,16893,public,usertable,1,0,1374561,3318484,615789,46587,58789,20106,557000,96804,721165,615789,,,,,0,0,0,0
1650449518.4544702,public.usertable,557368,96833,752558080,16893,public,usertable,1,0,1375657,3319332,616183,46601,58815,20112,557368,96833,721599,616183,,,,,0,0,0,0
1650449519.4843044,public.usertable,557753,96863,753033216,16893,public,usertable,1,0,1376755,3320595,616589,46617,58836,20119,557753,96863,722042,616589,,,,,0,0,0,0
1650449520.514573,public.usertable,558120,96908,753508352,16893,public,usertable,1,0,1377727,3321315,616984,46634,58864,20127,558120,96908,722482,616984,,,,,0,0,0,0
1650449521.5453415,public.usertable,558657,96978,753991680,16893,public,usertable,1,0,1379355,3323170,617554,46675,58897,20149,558657,96978,723126,617554,,,,,0,0,0,0
1650449522.574884,public.usertable,559032,97003,754475008,16893,public,usertable,1,0,1380348,3323959,617948,46689,58916,20153,559032,97003,723553,617948,,,,,0,0,0,0
1650449523.603904,public.usertable,559413,97036,754958336,16893,public,usertable,1,0,1381332,3324920,618347,46706,58934,20162,559413,97036,723987,618347,,,,,0,0,0,0
1650449524.6347551,public.usertable,559740,97079,755392512,16893,public,usertable,1,0,1382336,3326276,618698,46726,58958,20170,559740,97079,724382,618698,,,,,0,0,0,0
1650449525.664805,public.usertable,560090,97121,755859456,16893,public,usertable,1,0,1383443,3327596,619071,46751,58981,20183,560090,97121,724803,619071,,,,,0,0,0,0
1650449526.696824,public.usertable,560465,97162,756367360,16893,public,usertable,1,0,1384439,3329324,619473,46765,59008,20188,560465,97162,725246,619473,,,,,0,0,0,0
1650449527.7271123,public.usertable,560833,97202,756834304,16893,public,usertable,1,0,1385581,3331481,619862,46785,59029,20197,560833,97202,725676,619862,,,,,0,0,0,0
1650449528.7569394,public.usertable,561171,97232,757260288,16893,public,usertable,1,0,1386570,3332747,620224,46801,59053,20209,561171,97232,726078,620224,,,,,0,0,0,0
1650449529.7861536,public.usertable,561542,97266,757760000,16893,public,usertable,1,0,1387652,3334096,620609,46825,59067,20225,561542,97266,726501,620609,,,,,0,0,0,0
1650449530.8150635,public.usertable,561930,97291,758267904,16893,public,usertable,1,0,1388600,3334720,621019,46833,59089,20230,561930,97291,726941,621019,,,,,0,0,0,0
1650449531.8438942,public.usertable,562317,97323,758734848,16893,public,usertable,1,0,1389619,3336049,621428,46849,59111,20237,562317,97323,727388,621428,,,,,0,0,0,0
1650449532.8730807,public.usertable,562670,97353,759209984,16893,public,usertable,1,0,1390673,3336633,621808,46856,59138,20241,562670,97353,727802,621808,,,,,0,0,0,0
1650449533.9014826,public.usertable,563026,97393,759652352,16893,public,usertable,1,0,1391639,3337789,622188,46875,59162,20253,563026,97393,728225,622188,,,,,0,0,0,0
1650449534.9335923,public.usertable,563346,97419,760102912,16893,public,usertable,1,0,1392525,3338198,622526,46887,59180,20259,563346,97419,728593,622526,,,,,0,0,0,0
1650449535.963112,public.usertable,563709,97460,760553472,16893,public,usertable,1,0,1393622,3338879,622911,46906,59202,20267,563709,97460,729019,622911,,,,,0,0,0,0
1650449536.9920797,public.usertable,564044,97494,761012224,16893,public,usertable,1,0,1394609,3339631,623264,46926,59220,20279,564044,97494,729410,623264,,,,,0,0,0,0
1650449538.0229032,public.usertable,564407,97529,761462784,16893,public,usertable,1,0,1395747,3340335,623646,46945,59239,20291,564407,97529,729830,623646,,,,,0,0,0,0
1650449539.0543916,public.usertable,564745,97574,761929728,16893,public,usertable,1,0,1396714,3341379,624014,46962,59269,20301,564745,97574,730245,624014,,,,,0,0,0,0
1650449540.083771,public.usertable,565104,97608,762363904,16893,public,usertable,1,0,1397690,3342458,624390,46979,59286,20310,565104,97608,730655,624390,,,,,0,0,0,0
1650449541.112568,public.usertable,565651,97650,762847232,16893,public,usertable,1,0,1399103,3344238,624968,47000,59317,20322,565651,97650,731285,624968,,,,,0,0,0,0
1650449542.1424503,public.usertable,565996,97681,763297792,16893,public,usertable,1,0,1399994,3344883,625332,47015,59336,20331,565996,97681,731683,625332,,,,,0,0,0,0
1650449543.1712327,public.usertable,566357,97704,763748352,16893,public,usertable,1,0,1401034,3345865,625709,47028,59352,20337,566357,97704,732089,625709,,,,,0,0,0,0
1650449544.201685,public.usertable,566690,97735,764182528,16893,public,usertable,1,0,1402052,3347121,626062,47049,59372,20350,566690,97735,732483,626062,,,,,0,0,0,0
1650449545.2317116,public.usertable,567035,97764,764641280,16893,public,usertable,1,0,1403049,3348043,626426,47061,59391,20355,567035,97764,732878,626426,,,,,0,0,0,0
1650449546.2603238,public.usertable,567411,97787,765116416,16893,public,usertable,1,0,1403993,3348404,626814,47078,59403,20363,567411,97787,733295,626814,,,,,0,0,0,0
1650449547.289358,public.usertable,567773,97833,765599744,16893,public,usertable,1,0,1405059,3349786,627199,47102,59426,20375,567773,97833,733727,627199,,,,,0,0,0,0
1650449548.3184574,public.usertable,568122,97864,766033920,16893,public,usertable,1,0,1406054,3351286,627565,47119,59443,20385,568122,97864,734127,627565,,,,,0,0,0,0
1650449549.350724,public.usertable,568466,97885,766492672,16893,public,usertable,1,0,1406971,3352758,627930,47129,59464,20389,568466,97885,734523,627930,,,,,0,0,0,0
1650449550.3791838,public.usertable,568826,97922,766967808,16893,public,usertable,1,0,1407951,3353901,628312,47149,59486,20397,568826,97922,734947,628312,,,,,0,0,0,0
1650449551.4087691,public.usertable,569189,97955,767451136,16893,public,usertable,1,0,1409035,3355590,628694,47172,59505,20408,569189,97955,735371,628694,,,,,0,0,0,0
1650449552.437124,public.usertable,569523,97986,767844352,16893,public,usertable,1,0,1410018,3356452,629047,47187,59524,20416,569523,97986,735758,629047,,,,,0,0,0,0
1650449553.4666994,public.usertable,569834,98018,768270336,16893,public,usertable,1,0,1410955,3357354,629376,47201,59542,20421,569834,98018,736119,629376,,,,,0,0,0,0
1650449554.4958608,public.usertable,570170,98037,768679936,16893,public,usertable,1,0,1411888,3358834,629728,47212,59558,20424,570170,98037,736498,629728,,,,,0,0,0,0
1650449555.525963,public.usertable,570452,98049,769024000,16893,public,usertable,1,0,1412642,3359518,630017,47218,59565,20426,570452,98049,736800,630017,,,,,0,0,0,0
1650449556.5552595,public.usertable,570727,98072,769368064,16893,public,usertable,1,0,1413372,3360273,630309,47231,59582,20433,570727,98072,737122,630309,,,,,0,0,0,0
1650449557.586511,public.usertable,571031,98089,769777664,16893,public,usertable,1,0,1414179,3360718,630622,47241,59591,20439,571031,98089,737454,630622,,,,,0,0,0,0
1650449558.6158671,public.usertable,571323,98131,770121728,16893,public,usertable,1,0,1415083,3362125,630942,47258,59619,20446,571323,98131,737819,630942,,,,,0,0,0,0
1650449559.6453493,public.usertable,571578,98154,770498560,16893,public,usertable,1,0,1415774,3362403,631211,47267,59633,20451,571578,98154,738111,631211,,,,,0,0,0,0
1650449560.6762657,public.usertable,571894,98174,770875392,16893,public,usertable,1,0,1416704,3363271,631539,47280,59645,20456,571894,98174,738464,631539,,,,,0,0,0,0
1650449561.704451,public.usertable,572277,98205,771194880,16893,public,usertable,1,0,1417819,3364851,631949,47301,59672,20468,572277,98205,738922,631949,,,,,0,0,0,0
1650449562.7332792,public.usertable,572571,98224,771563520,16893,public,usertable,1,0,1418617,3365339,632256,47312,59685,20474,572571,98224,739253,632256,,,,,0,0,0,0
1650449563.7618275,public.usertable,572877,98251,771981312,16893,public,usertable,1,0,1419528,3365637,632581,47323,59704,20480,572877,98251,739608,632581,,,,,0,0,0,0
1650449564.7906528,public.usertable,573146,98288,772349952,16893,public,usertable,1,0,1420297,3366337,632873,47338,59727,20488,573146,98288,739938,632873,,,,,0,0,0,0
1650449565.8195398,public.usertable,573518,98321,772816896,16893,public,usertable,1,0,1421350,3367681,633268,47352,59750,20497,573518,98321,740370,633268,,,,,0,0,0,0
1650449566.8480315,public.usertable,573871,98346,773275648,16893,public,usertable,1,0,1422258,3368270,633634,47365,59763,20503,573871,98346,740762,633634,,,,,0,0,0,0
1650449567.8796556,public.usertable,574230,98374,773726208,16893,public,usertable,1,0,1423142,3368891,634012,47377,59782,20508,574230,98374,741171,634012,,,,,0,0,0,0
1650449568.908987,public.usertable,574578,98398,774176768,16893,public,usertable,1,0,1424139,3371301,634379,47390,59801,20516,574578,98398,741570,634379,,,,,0,0,0,0
1650449569.9388092,public.usertable,574934,98420,774643712,16893,public,usertable,1,0,1425073,3371992,634751,47404,59817,20525,574934,98420,741972,634751,,,,,0,0,0,0
1650449570.9697683,public.usertable,575315,98441,775110656,16893,public,usertable,1,0,1426183,3372832,635142,47417,59827,20530,575315,98441,742386,635142,,,,,0,0,0,0
1650449571.9987295,public.usertable,575669,98481,775569408,16893,public,usertable,1,0,1427269,3374049,635521,47433,59852,20540,575669,98481,742806,635521,,,,,0,0,0,0
1650449573.0300493,public.usertable,576024,98517,776019968,16893,public,usertable,1,0,1428265,3374835,635900,47446,59876,20550,576024,98517,743222,635900,,,,,0,0,0,0
1650449574.0600157,public.usertable,576373,98539,776478720,16893,public,usertable,1,0,1429303,3376546,636260,47462,59887,20559,576373,98539,743609,636260,,,,,0,0,0,0
1650449575.089492,public.usertable,576733,98563,776921088,16893,public,usertable,1,0,1430267,3377094,636636,47477,59903,20570,576733,98563,744016,636636,,,,,0,0,0,0
1650449576.1181731,public.usertable,577097,98592,777388032,16893,public,usertable,1,0,1431279,3377934,637015,47496,59918,20583,577097,98592,744429,637015,,,,,0,0,0,0
1650449577.1518984,public.usertable,577449,98626,777838592,16893,public,usertable,1,0,1432350,3379176,637388,47513,59939,20593,577449,98626,744840,637388,,,,,0,0,0,0
1650449578.1849725,public.usertable,577794,98659,778297344,16893,public,usertable,1,0,1433345,3379619,637754,47525,59960,20600,577794,98659,745239,637754,,,,,0,0,0,0
1650449579.2141294,public.usertable,578124,98697,778764288,16893,public,usertable,1,0,1434329,3380686,638111,47539,59987,20606,578124,98697,745637,638111,,,,,0,0,0,0
1650449580.2424946,public.usertable,578497,98728,779214848,16893,public,usertable,1,0,1435376,3381335,638500,47557,60003,20612,578497,98728,746060,638500,,,,,0,0,0,0
1650449581.2711244,public.usertable,579048,98770,779689984,16893,public,usertable,1,0,1436832,3382632,639073,47582,60025,20627,579048,98770,746680,639073,,,,,0,0,0,0
1650449582.300068,public.usertable,579402,98801,780156928,16893,public,usertable,1,0,1437858,3383332,639450,47594,60048,20634,579402,98801,747092,639450,,,,,0,0,0,0
1650449583.3323483,public.usertable,579758,98835,780615680,16893,public,usertable,1,0,1438901,3384103,639827,47610,60069,20642,579758,98835,747506,639827,,,,,0,0,0,0
1650449584.3610933,public.usertable,580112,98866,781066240,16893,public,usertable,1,0,1439852,3385850,640197,47630,60085,20655,580112,98866,747912,640197,,,,,0,0,0,0
1650449585.3897076,public.usertable,580500,98898,781549568,16893,public,usertable,1,0,1440934,3386477,640601,47648,60101,20666,580500,98898,748350,640601,,,,,0,0,0,0
1650449586.4194562,public.usertable,580858,98918,782024704,16893,public,usertable,1,0,1442003,3387500,640977,47660,60119,20674,580858,98918,748756,640977,,,,,0,0,0,0
1650449587.4510846,public.usertable,581225,98952,782499840,16893,public,usertable,1,0,1443004,3389270,641367,47676,60142,20682,581225,98952,749185,641367,,,,,0,0,0,0
1650449588.4801114,public.usertable,581626,98988,783007744,16893,public,usertable,1,0,1444177,3391071,641787,47694,60161,20690,581626,98988,749642,641787,,,,,0,0,0,0
1650449589.5092137,public.usertable,582014,99031,783515648,16893,public,usertable,1,0,1445321,3392283,642200,47713,60186,20696,582014,99031,750099,642200,,,,,0,0,0,0
1650449590.5389569,public.usertable,582406,99060,784048128,16893,public,usertable,1,0,1446484,3393494,642610,47736,60204,20707,582406,99060,750550,642610,,,,,0,0,0,0
1650449591.5684266,public.usertable,582827,99098,784572416,16893,public,usertable,1,0,1447610,3394677,643053,47754,60226,20717,582827,99098,751033,643053,,,,,0,0,0,0
1650449592.5975769,public.usertable,583253,99131,785113088,16893,public,usertable,1,0,1448709,3395810,643495,47771,60242,20725,583253,99131,751508,643495,,,,,0,0,0,0
1650449593.6276927,public.usertable,583654,99151,785629184,16893,public,usertable,1,0,1449747,3397734,643915,47783,60261,20731,583654,99151,751959,643915,,,,,0,0,0,0
1650449594.656308,public.usertable,584044,99191,786153472,16893,public,usertable,1,0,1450808,3398877,644337,47802,60293,20739,584044,99191,752432,644337,,,,,0,0,0,0
1650449595.6852329,public.usertable,584451,99224,786628608,16893,public,usertable,1,0,1451937,3399613,644762,47821,60311,20750,584451,99224,752894,644762,,,,,0,0,0,0
1650449596.7136426,public.usertable,584819,99250,787152896,16893,public,usertable,1,0,1452979,3400433,645149,47831,60330,20754,584819,99250,753310,645149,,,,,0,0,0,0
1650449597.743344,public.usertable,585204,99292,787628032,16893,public,usertable,1,0,1454102,3401900,645560,47848,60356,20765,585204,99292,753764,645560,,,,,0,0,0,0
1650449598.7724173,public.usertable,585524,99317,787980288,16893,public,usertable,1,0,1454911,3402191,645895,47861,60371,20773,585524,99317,754127,645895,,,,,0,0,0,0
1650449599.8007836,public.usertable,585775,99350,788307968,16893,public,usertable,1,0,1455617,3402932,646171,47871,60396,20777,585775,99350,754438,646171,,,,,0,0,0,0
1650449600.8295646,public.usertable,586166,99385,788635648,16893,public,usertable,1,0,1456652,3403758,646577,47895,60411,20790,586166,99385,754883,646577,,,,,0,0,0,0
1650449601.8589735,public.usertable,586430,99405,788971520,16893,public,usertable,1,0,1457329,3404260,646856,47902,60426,20795,586430,99405,755184,646856,,,,,0,0,0,0
1650449602.887694,public.usertable,586737,99423,789364736,16893,public,usertable,1,0,1458169,3405450,647177,47913,60440,20798,586737,99423,755530,647177,,,,,0,0,0,0
1650449603.9182317,public.usertable,587017,99444,789733376,16893,public,usertable,1,0,1458944,3406593,647467,47927,60450,20808,587017,99444,755844,647467,,,,,0,0,0,0
1650449604.9468024,public.usertable,587335,99469,790151168,16893,public,usertable,1,0,1459890,3407404,647809,47934,60474,20812,587335,99469,756217,647809,,,,,0,0,0,0
1650449605.9814374,public.usertable,587706,99495,790626304,16893,public,usertable,1,0,1460885,3407762,648196,47944,60490,20818,587706,99495,756630,648196,,,,,0,0,0,0
1650449607.0102477,public.usertable,588065,99526,791109632,16893,public,usertable,1,0,1461874,3408699,648577,47959,60512,20822,588065,99526,757048,648577,,,,,0,0,0,0
1650449608.0393357,public.usertable,588449,99561,791592960,16893,public,usertable,1,0,1462905,3409171,648984,47975,60535,20830,588449,99561,757494,648984,,,,,0,0,0,0
1650449609.0685291,public.usertable,588835,99588,792100864,16893,public,usertable,1,0,1464024,3410144,649392,47987,60557,20836,588835,99588,757936,649392,,,,,0,0,0,0
1650449610.0984845,public.usertable,589246,99619,792625152,16893,public,usertable,1,0,1465140,3410354,649825,47996,60579,20841,589246,99619,758400,649825,,,,,0,0,0,0
1650449611.1279857,public.usertable,589642,99651,793124864,16893,public,usertable,1,0,1466199,3411163,650245,48007,60603,20848,589642,99651,758855,650245,,,,,0,0,0,0
1650449612.1574373,public.usertable,590038,99682,793624576,16893,public,usertable,1,0,1467361,3412024,650656,48027,60618,20860,590038,99682,759301,650656,,,,,0,0,0,0
1650449613.1858182,public.usertable,590427,99716,794140672,16893,public,usertable,1,0,1468539,3413513,651069,48042,60642,20867,590427,99716,759753,651069,,,,,0,0,0,0
1650449614.2161663,public.usertable,590799,99750,794558464,16893,public,usertable,1,0,1469522,3414567,651466,48056,60667,20875,590799,99750,760189,651466,,,,,0,0,0,0
1650449615.2486534,public.usertable,591060,99763,794877952,16893,public,usertable,1,0,1470180,3414881,651737,48063,60677,20879,591060,99763,760477,651737,,,,,0,0,0,0
1650449616.2799916,public.usertable,591302,99793,795189248,16893,public,usertable,1,0,1470824,3415444,651992,48083,60690,20892,591302,99793,760765,651992,,,,,0,0,0,0
1650449617.310857,public.usertable,591570,99808,795533312,16893,public,usertable,1,0,1471496,3415946,652269,48090,60699,20895,591570,99808,761058,652269,,,,,0,0,0,0
1650449618.3465214,public.usertable,591865,99828,795967488,16893,public,usertable,1,0,1472261,3416940,652578,48097,60713,20899,591865,99828,761388,652578,,,,,0,0,0,0
1650449619.3765385,public.usertable,592313,99870,796327936,16893,public,usertable,1,0,1473556,3417092,653051,48114,60738,20908,592313,99870,761903,653051,,,,,0,0,0,0
1650449620.405628,public.usertable,592641,99895,796753920,16893,public,usertable,1,0,1474451,3418176,653397,48129,60756,20920,592641,99895,762282,653397,,,,,0,0,0,0
1650449621.435058,public.usertable,593026,99915,797237248,16893,public,usertable,1,0,1475401,3419132,653797,48138,60771,20923,593026,99915,762706,653797,,,,,0,0,0,0
1650449622.4637191,public.usertable,593441,99941,797761536,16893,public,usertable,1,0,1476430,3420452,654232,48149,60791,20931,593441,99941,763172,654232,,,,,0,0,0,0
1650449623.4947548,public.usertable,593817,99982,798253056,16893,public,usertable,1,0,1477584,3421435,654633,48165,60816,20937,593817,99982,763614,654633,,,,,0,0,0,0
1650449624.5243857,public.usertable,594185,100009,798736384,16893,public,usertable,1,0,1478657,3422785,655020,48185,60835,20950,594185,100009,764040,655020,,,,,0,0,0,0
1650449625.5554507,public.usertable,594569,100038,799219712,16893,public,usertable,1,0,1479649,3423336,655422,48205,60853,20963,594569,100038,764480,655422,,,,,0,0,0,0
1650449626.5854783,public.usertable,594897,100066,799653888,16893,public,usertable,1,0,1480607,3424633,655768,48219,60871,20973,594897,100066,764858,655768,,,,,0,0,0,0
1650449627.6146977,public.usertable,595285,100092,800112640,16893,public,usertable,1,0,1481563,3426154,656169,48239,60884,20987,595285,100092,765292,656169,,,,,0,0,0,0
1650449628.64387,public.usertable,595629,100123,800587776,16893,public,usertable,1,0,1482533,3427115,656534,48255,60905,20994,595629,100123,765694,656534,,,,,0,0,0,0
1650449629.6742682,public.usertable,595979,100143,801013760,16893,public,usertable,1,0,1483588,3427952,656901,48264,60922,20999,595979,100143,766087,656901,,,,,0,0,0,0
1650449630.7122996,public.usertable,596292,100179,801447936,16893,public,usertable,1,0,1484407,3428216,657237,48278,60945,21006,596292,100179,766460,657237,,,,,0,0,0,0
1650449631.741024,public.usertable,596658,100207,801906688,16893,public,usertable,1,0,1485397,3428928,657620,48290,60962,21012,596658,100207,766872,657620,,,,,0,0,0,0
1650449632.7701616,public.usertable,597003,100236,802357248,16893,public,usertable,1,0,1486413,3430108,657985,48304,60982,21019,597003,100236,767271,657985,,,,,0,0,0,0
1650449633.7985249,public.usertable,597337,100264,802783232,16893,public,usertable,1,0,1487373,3431288,658334,48319,60997,21028,597337,100264,767650,658334,,,,,0,0,0,0
1650449634.82775,public.usertable,597684,100298,803225600,16893,public,usertable,1,0,1488332,3432254,658699,48335,61015,21036,597684,100298,768049,658699,,,,,0,0,0,0
1650449635.8564217,public.usertable,598035,100322,803667968,16893,public,usertable,1,0,1489378,3433207,659064,48347,61029,21042,598035,100322,768440,659064,,,,,0,0,0,0
1650449636.8861144,public.usertable,598384,100352,804118528,16893,public,usertable,1,0,1490360,3434130,659431,48360,61047,21048,598384,100352,768838,659431,,,,,0,0,0,0
1650449637.9153347,public.usertable,598715,100379,804577280,16893,public,usertable,1,0,1491300,3435386,659780,48374,61065,21056,598715,100379,769219,659780,,,,,0,0,0,0
1650449638.9442055,public.usertable,599187,100404,804929536,16893,public,usertable,1,0,1492617,3437881,660275,48391,61088,21064,599187,100404,769754,660275,,,,,0,0,0,0
1650449639.9739752,public.usertable,599447,100433,805281792,16893,public,usertable,1,0,1493418,3438705,660554,48402,61107,21067,599447,100433,770063,660554,,,,,0,0,0,0
1650449641.0047219,public.usertable,599694,100447,805593088,16893,public,usertable,1,0,1494077,3439628,660815,48407,61121,21070,599694,100447,770343,660815,,,,,0,0,0,0
1650449642.0330737,public.usertable,599924,100468,805888000,16893,public,usertable,1,0,1494716,3440201,661059,48414,61135,21073,599924,100468,770608,661059,,,,,0,0,0,0
1650449643.065841,public.usertable,600188,100495,806248448,16893,public,usertable,1,0,1495452,3441230,661339,48426,61151,21078,600188,100495,770916,661339,,,,,0,0,0,0
1650449644.0945022,public.usertable,600528,100516,806674432,16893,public,usertable,1,0,1496362,3442487,661698,48438,61170,21084,600528,100516,771306,661698,,,,,0,0,0,0
1650449645.1233056,public.usertable,600850,100547,807116800,16893,public,usertable,1,0,1497224,3442818,662039,48454,61189,21092,600850,100547,771682,662039,,,,,0,0,0,0
1650449646.1550086,public.usertable,601173,100570,807542784,16893,public,usertable,1,0,1498153,3443540,662379,48463,61206,21096,601173,100570,772048,662379,,,,,0,0,0,0
1650449647.1861541,public.usertable,601511,100597,807976960,16893,public,usertable,1,0,1499140,3444653,662733,48476,61222,21101,601511,100597,772431,662733,,,,,0,0,0,0
1650449648.215234,public.usertable,601923,100616,808460288,16893,public,usertable,1,0,1500214,3445914,663159,48487,61236,21108,601923,100616,772882,663159,,,,,0,0,0,0
1650449649.24584,public.usertable,602283,100648,808951808,16893,public,usertable,1,0,1501194,3446772,663544,48499,61261,21116,602283,100648,773304,663544,,,,,0,0,0,0
1650449650.2738204,public.usertable,602639,100665,809402368,16893,public,usertable,1,0,1502139,3448832,663913,48511,61274,21124,602639,100665,773698,663913,,,,,0,0,0,0
1650449651.3042166,public.usertable,603006,100698,809885696,16893,public,usertable,1,0,1503189,3449368,664304,48527,61298,21134,603006,100698,774129,664304,,,,,0,0,0,0
1650449652.3327987,public.usertable,603331,100714,810246144,16893,public,usertable,1,0,1504061,3449939,664640,48536,61309,21137,603331,100714,774485,664640,,,,,0,0,0,0
1650449653.36194,public.usertable,603582,100734,810541056,16893,public,usertable,1,0,1504709,3450250,664902,48549,61320,21141,603582,100734,774771,664902,,,,,0,0,0,0
1650449654.3912468,public.usertable,603828,100755,810901504,16893,public,usertable,1,0,1505363,3450799,665161,48561,61333,21145,603828,100755,775055,665161,,,,,0,0,0,0
1650449655.4202857,public.usertable,604184,100781,811409408,16893,public,usertable,1,0,1506338,3452039,665535,48576,61351,21156,604184,100781,775462,665535,,,,,0,0,0,0
1650449656.4492078,public.usertable,604589,100807,811917312,16893,public,usertable,1,0,1507363,3453011,665955,48592,61366,21167,604589,100807,775913,665955,,,,,0,0,0,0
1650449657.4776068,public.usertable,604961,100835,812392448,16893,public,usertable,1,0,1508298,3454194,666346,48605,61385,21171,604961,100835,776336,666346,,,,,0,0,0,0
1650449658.5090406,public.usertable,605552,100890,812916736,16893,public,usertable,1,0,1509965,3455056,666972,48628,61420,21181,605552,100890,777020,666972,,,,,0,0,0,0
1650449659.538633,public.usertable,605938,100938,813432832,16893,public,usertable,1,0,1511040,3455672,667384,48650,61446,21190,605938,100938,777480,667384,,,,,0,0,0,0
1650449660.5700355,public.usertable,606348,100966,813940736,16893,public,usertable,1,0,1512162,3456981,667812,48661,61464,21198,606348,100966,777937,667812,,,,,0,0,0,0
1650449661.6005611,public.usertable,606718,101010,814432256,16893,public,usertable,1,0,1513239,3458084,668205,48684,61487,21207,606718,101010,778376,668205,,,,,0,0,0,0
1650449662.6321099,public.usertable,607088,101041,814915584,16893,public,usertable,1,0,1514272,3459202,668598,48699,61510,21215,607088,101041,778807,668598,,,,,0,0,0,0
1650449663.6607692,public.usertable,607473,101086,815415296,16893,public,usertable,1,0,1515394,3460596,669001,48727,61528,21230,607473,101086,779256,669001,,,,,0,0,0,0
1650449664.6902099,public.usertable,607855,101125,815915008,16893,public,usertable,1,0,1516496,3461841,669407,48745,61552,21240,607855,101125,779704,669407,,,,,0,0,0,0
1650449665.7195573,public.usertable,608245,101158,816406528,16893,public,usertable,1,0,1517471,3462931,669821,48757,61576,21247,608245,101158,780154,669821,,,,,0,0,0,0
1650449666.7487445,public.usertable,608634,101199,816922624,16893,public,usertable,1,0,1518658,3463679,670231,48778,61597,21264,608634,101199,780606,670231,,,,,0,0,0,0
1650449667.777198,public.usertable,609028,101240,817430528,16893,public,usertable,1,0,1519779,3464898,670651,48796,61623,21273,609028,101240,781070,670651,,,,,0,0,0,0
1650449668.8079107,public.usertable,609434,101262,817954816,16893,public,usertable,1,0,1520904,3466793,671072,48810,61638,21283,609434,101262,781520,671072,,,,,0,0,0,0
1650449669.838609,public.usertable,609845,101298,818462720,16893,public,usertable,1,0,1521995,3467838,671504,48827,61659,21288,609845,101298,781990,671504,,,,,0,0,0,0
1650449670.8687148,public.usertable,610216,101340,818962432,16893,public,usertable,1,0,1523148,3470237,671902,48845,61686,21295,610216,101340,782433,671902,,,,,0,0,0,0
1650449671.8986156,public.usertable,610605,101357,819462144,16893,public,usertable,1,0,1524161,3472217,672303,48859,61698,21304,610605,101357,782860,672303,,,,,0,0,0,0
1650449672.9279642,public.usertable,610992,101376,819945472,16893,public,usertable,1,0,1525249,3473229,672708,48868,61716,21307,610992,101376,783292,672708,,,,,0,0,0,0
1650449673.9593534,public.usertable,611366,101410,820428800,16893,public,usertable,1,0,1526450,3474456,673103,48889,61737,21320,611366,101410,783729,673103,,,,,0,0,0,0
1650449674.9875784,public.usertable,611747,101439,820944896,16893,public,usertable,1,0,1527593,3475838,673503,48902,61756,21328,611747,101439,784161,673503,,,,,0,0,0,0
1650449676.017519,public.usertable,612159,101476,821452800,16893,public,usertable,1,0,1528627,3476543,673935,48920,61776,21341,612159,101476,784631,673935,,,,,0,0,0,0
1650449677.0486941,public.usertable,612750,101518,821960704,16893,public,usertable,1,0,1530222,3477850,674557,48939,61807,21350,612750,101518,785303,674557,,,,,0,0,0,0
1650449678.077866,public.usertable,613112,101562,822444032,16893,public,usertable,1,0,1531280,3478945,674947,48963,61835,21360,613112,101562,785745,674947,,,,,0,0,0,0
1650449679.1090527,public.usertable,613483,101606,822935552,16893,public,usertable,1,0,1532411,3480001,675341,48987,61858,21372,613483,101606,786186,675341,,,,,0,0,0,0
1650449680.1399348,public.usertable,613827,101630,823377920,16893,public,usertable,1,0,1533422,3480692,675709,48997,61882,21378,613827,101630,786588,675709,,,,,0,0,0,0
1650449681.1683059,public.usertable,614197,101660,823844864,16893,public,usertable,1,0,1534532,3482013,676095,49015,61898,21390,614197,101660,787008,676095,,,,,0,0,0,0
1650449682.1985657,public.usertable,614550,101694,824311808,16893,public,usertable,1,0,1535520,3482905,676464,49034,61914,21399,614550,101694,787412,676464,,,,,0,0,0,0
1650449683.2287073,public.usertable,614925,101730,824803328,16893,public,usertable,1,0,1536572,3483590,676862,49047,61937,21404,614925,101730,787846,676862,,,,,0,0,0,0
1650449684.2587435,public.usertable,615278,101764,825245696,16893,public,usertable,1,0,1537479,3484316,677238,49062,61960,21408,615278,101764,788260,677238,,,,,0,0,0,0
1650449685.2885616,public.usertable,615601,101785,825679872,16893,public,usertable,1,0,1538499,3486070,677579,49074,61978,21416,615601,101785,788631,677579,,,,,0,0,0,0
1650449686.3222387,public.usertable,615973,101810,826130432,16893,public,usertable,1,0,1539553,3486418,677965,49087,61992,21422,615973,101810,789044,677965,,,,,0,0,0,0
1650449687.3532474,public.usertable,616304,101835,826580992,16893,public,usertable,1,0,1540453,3487159,678312,49099,62008,21431,616304,101835,789419,678312,,,,,0,0,0,0
1650449688.381861,public.usertable,616638,101858,826998784,16893,public,usertable,1,0,1541346,3487749,678662,49108,62024,21434,616638,101858,789794,678662,,,,,0,0,0,0
1650449689.4159083,public.usertable,616988,101879,827424768,16893,public,usertable,1,0,1542274,3488354,679027,49116,62039,21436,616988,101879,790182,679027,,,,,0,0,0,0
1650449690.4441986,public.usertable,617345,101903,827924480,16893,public,usertable,1,0,1543224,3489232,679401,49129,62056,21442,617345,101903,790586,679401,,,,,0,0,0,0
1650449691.4757664,public.usertable,617729,101929,828416000,16893,public,usertable,1,0,1544232,3490395,679800,49147,62071,21449,617729,101929,791018,679800,,,,,0,0,0,0
1650449692.505261,public.usertable,618125,101959,828915712,16893,public,usertable,1,0,1545425,3491997,680218,49155,62093,21454,618125,101959,791466,680218,,,,,0,0,0,0
1650449693.5342958,public.usertable,618508,101993,829423616,16893,public,usertable,1,0,1546534,3492682,680626,49167,62118,21463,618508,101993,791911,680626,,,,,0,0,0,0
1650449694.563657,public.usertable,618904,102029,829923328,16893,public,usertable,1,0,1547632,3493935,681046,49184,62142,21476,618904,102029,792372,681046,,,,,0,0,0,0
1650449695.5938997,public.usertable,619474,102083,830423040,16893,public,usertable,1,0,1549412,3496557,681649,49216,62175,21494,619474,102083,793040,681649,,,,,0,0,0,0
1650449696.624104,public.usertable,619868,102109,830914560,16893,public,usertable,1,0,1550441,3497283,682059,49228,62191,21499,619868,102109,793478,682059,,,,,0,0,0,0
1650449697.652762,public.usertable,620251,102144,831422464,16893,public,usertable,1,0,1551469,3497487,682467,49238,62216,21506,620251,102144,793921,682467,,,,,0,0,0,0
1650449698.6842632,public.usertable,620649,102166,831930368,16893,public,usertable,1,0,1552454,3498773,682877,49253,62228,21512,620649,102166,794358,682877,,,,,0,0,0,0
1650449699.712754,public.usertable,621052,102202,832413696,16893,public,usertable,1,0,1553454,3500051,683297,49272,62245,21523,621052,102202,794814,683297,,,,,0,0,0,0
1650449700.7433748,public.usertable,621455,102228,832937984,16893,public,usertable,1,0,1554544,3500345,683717,49284,62262,21529,621455,102228,795263,683717,,,,,0,0,0,0
1650449701.7726018,public.usertable,621843,102246,833421312,16893,public,usertable,1,0,1555624,3501047,684118,49292,62275,21533,621843,102246,795685,684118,,,,,0,0,0,0
1650449702.8017282,public.usertable,622228,102269,833929216,16893,public,usertable,1,0,1556813,3502411,684519,49311,62291,21541,622228,102269,796121,684519,,,,,0,0,0,0
1650449703.8307552,public.usertable,622613,102313,834445312,16893,public,usertable,1,0,1557936,3504130,684928,49331,62315,21551,622613,102313,796574,684928,,,,,0,0,0,0
1650449704.8595042,public.usertable,623002,102347,834936832,16893,public,usertable,1,0,1559108,3505070,685340,49347,62338,21560,623002,102347,797025,685340,,,,,0,0,0,0
1650449705.8881364,public.usertable,623402,102375,835436544,16893,public,usertable,1,0,1560256,3505914,685760,49360,62358,21567,623402,102375,797478,685760,,,,,0,0,0,0
1650449706.9177783,public.usertable,623780,102411,835936256,16893,public,usertable,1,0,1561476,3506923,686159,49377,62379,21577,623780,102411,797915,686159,,,,,0,0,0,0
1650449707.9503741,public.usertable,624166,102425,836435968,16893,public,usertable,1,0,1562592,3509569,686566,49388,62400,21581,624166,102425,798354,686566,,,,,0,0,0,0
1650449708.9789407,public.usertable,624543,102453,836927488,16893,public,usertable,1,0,1563692,3510501,686962,49402,62419,21588,624543,102453,798783,686962,,,,,0,0,0,0
1650449710.0117812,public.usertable,624942,102487,837435392,16893,public,usertable,1,0,1564915,3511624,687380,49417,62438,21595,624942,102487,799235,687380,,,,,0,0,0,0
1650449711.0422351,public.usertable,625334,102515,837951488,16893,public,usertable,1,0,1565912,3512760,687791,49432,62457,21601,625334,102515,799680,687791,,,,,0,0,0,0
1650449712.0720057,public.usertable,625719,102556,838443008,16893,public,usertable,1,0,1567038,3514329,688200,49453,62481,21614,625719,102556,800134,688200,,,,,0,0,0,0
1650449713.1008825,public.usertable,626100,102596,838950912,16893,public,usertable,1,0,1568164,3515378,688609,49466,62509,21621,626100,102596,800584,688609,,,,,0,0,0,0
1650449714.1305423,public.usertable,626695,102650,839458816,16893,public,usertable,1,0,1569827,3516550,689237,49488,62542,21635,626695,102650,801267,689237,,,,,0,0,0,0
1650449715.1591716,public.usertable,627073,102677,839950336,16893,public,usertable,1,0,1570898,3518083,689633,49505,62560,21643,627073,102677,801698,689633,,,,,0,0,0,0
1650449716.1893876,public.usertable,627475,102705,840450048,16893,public,usertable,1,0,1571934,3519151,690052,49519,62577,21650,627475,102705,802148,690052,,,,,0,0,0,0
1650449717.21827,public.usertable,627868,102736,840974336,16893,public,usertable,1,0,1572941,3520682,690469,49529,62601,21655,627868,102736,802599,690469,,,,,0,0,0,0
1650449718.2469578,public.usertable,628250,102765,841408512,16893,public,usertable,1,0,1573990,3521737,690867,49544,62617,21664,628250,102765,803028,690867,,,,,0,0,0,0
1650449719.2837718,public.usertable,628590,102800,841908224,16893,public,usertable,1,0,1574991,3523033,691230,49560,62640,21670,628590,102800,803430,691230,,,,,0,0,0,0
1650449720.3122404,public.usertable,628983,102837,842416128,16893,public,usertable,1,0,1575992,3523822,691641,49579,62658,21683,628983,102837,803878,691641,,,,,0,0,0,0
1650449721.341409,public.usertable,629387,102867,842932224,16893,public,usertable,1,0,1577134,3524396,692063,49597,62676,21691,629387,102867,804336,692063,,,,,0,0,0,0
1650449722.3698204,public.usertable,629783,102893,843423744,16893,public,usertable,1,0,1578266,3524976,692472,49616,62689,21701,629783,102893,804777,692472,,,,,0,0,0,0
1650449723.4008243,public.usertable,630165,102930,843915264,16893,public,usertable,1,0,1579433,3525623,692870,49641,62705,21714,630165,102930,805216,692870,,,,,0,0,0,0
1650449724.429538,public.usertable,630462,102951,844251136,16893,public,usertable,1,0,1580178,3526157,693180,49651,62718,21722,630462,102951,805549,693180,,,,,0,0,0,0
1650449725.4626622,public.usertable,630686,102974,844537856,16893,public,usertable,1,0,1580864,3526799,693411,49667,62725,21729,630686,102974,805803,693411,,,,,0,0,0,0
1650449726.4931896,public.usertable,630939,102994,844824576,16893,public,usertable,1,0,1581492,3527226,693676,49675,62737,21733,630939,102994,806088,693676,,,,,0,0,0,0
1650449727.5220437,public.usertable,631148,103014,845127680,16893,public,usertable,1,0,1582104,3527997,693896,49687,62748,21738,631148,103014,806331,693896,,,,,0,0,0,0
1650449728.5543385,public.usertable,631376,103033,845479936,16893,public,usertable,1,0,1582865,3529339,694143,49694,62767,21741,631376,103033,806604,694143,,,,,0,0,0,0
1650449729.583899,public.usertable,631665,103056,845848576,16893,public,usertable,1,0,1583666,3530377,694450,49702,62785,21746,631665,103056,806937,694450,,,,,0,0,0,0
1650449730.613325,public.usertable,631994,103085,846299136,16893,public,usertable,1,0,1584588,3531560,694803,49714,62809,21754,631994,103085,807326,694803,,,,,0,0,0,0
1650449731.6421123,public.usertable,632348,103118,846782464,16893,public,usertable,1,0,1585672,3533045,695176,49730,62828,21760,632348,103118,807734,695176,,,,,0,0,0,0
1650449732.6721108,public.usertable,632922,103146,847241216,16893,public,usertable,1,0,1587127,3534604,695767,49741,62845,21767,632922,103146,808353,695767,,,,,0,0,0,0
1650449733.700901,public.usertable,633303,103170,847724544,16893,public,usertable,1,0,1588055,3535210,696157,49758,62854,21775,633303,103170,808769,696157,,,,,0,0,0,0
1650449734.7309616,public.usertable,633664,103206,848207872,16893,public,usertable,1,0,1589036,3536608,696541,49773,62877,21782,633664,103206,809191,696541,,,,,0,0,0,0
1650449735.7617745,public.usertable,634079,103233,848732160,16893,public,usertable,1,0,1590212,3537692,696974,49789,62895,21792,634079,103233,809658,696974,,,,,0,0,0,0
1650449736.7918155,public.usertable,634479,103260,849231872,16893,public,usertable,1,0,1591232,3538399,697388,49804,62909,21800,634479,103260,810101,697388,,,,,0,0,0,0
1650449737.8205855,public.usertable,634863,103288,849731584,16893,public,usertable,1,0,1592357,3539008,697787,49821,62924,21805,634863,103288,810532,697787,,,,,0,0,0,0
1650449738.8514762,public.usertable,635259,103307,850214912,16893,public,usertable,1,0,1593434,3540732,698194,49831,62935,21810,635259,103307,810960,698194,,,,,0,0,0,0
1650449739.8824134,public.usertable,635577,103338,850616320,16893,public,usertable,1,0,1594411,3541475,698531,49846,62954,21816,635577,103338,811331,698531,,,,,0,0,0,0
1650449740.9120874,public.usertable,635910,103364,851058688,16893,public,usertable,1,0,1595224,3542308,698877,49859,62967,21820,635910,103364,811703,698877,,,,,0,0,0,0
1650449741.9411495,public.usertable,636259,103382,851517440,16893,public,usertable,1,0,1596201,3543965,699241,49875,62982,21827,636259,103382,812098,699241,,,,,0,0,0,0
1650449742.9726222,public.usertable,636617,103414,851984384,16893,public,usertable,1,0,1597210,3544374,699622,49889,63005,21834,636617,103414,812516,699622,,,,,0,0,0,0
1650449744.00102,public.usertable,637005,103445,852467712,16893,public,usertable,1,0,1598312,3545208,700032,49902,63027,21839,637005,103445,812961,700032,,,,,0,0,0,0
1650449745.0312045,public.usertable,637333,103444,852893696,16893,public,usertable,1,0,1599251,3546737,700369,49907,63036,21842,637333,103444,813312,700369,,,,,0,0,0,0
1650449746.0596266,public.usertable,637636,103478,853254144,16893,public,usertable,1,0,1600130,3547384,700691,49925,63055,21847,637636,103478,813671,700691,,,,,0,0,0,0
1650449747.089108,public.usertable,637924,103497,853606400,16893,public,usertable,1,0,1600918,3548007,700990,49942,63066,21858,637924,103497,813998,700990,,,,,0,0,0,0
1650449748.1182804,public.usertable,638243,103519,854032384,16893,public,usertable,1,0,1601838,3548520,701320,49953,63077,21866,638243,103519,814350,701320,,,,,0,0,0,0
1650449749.1495993,public.usertable,638539,103540,854368256,16893,public,usertable,1,0,1602677,3548930,701632,49964,63093,21873,638539,103540,814689,701632,,,,,0,0,0,0
1650449750.1778755,public.usertable,638767,103571,854695936,16893,public,usertable,1,0,1603416,3549442,701877,49978,63110,21876,638767,103571,814965,701877,,,,,0,0,0,0
1650449751.2070708,public.usertable,639221,103607,855113728,16893,public,usertable,1,0,1604742,3550896,702353,49999,63132,21882,639221,103607,815484,702353,,,,,0,0,0,0
1650449752.2365775,public.usertable,639467,103622,855425024,16893,public,usertable,1,0,1605370,3551227,702611,50009,63144,21886,639467,103622,815764,702611,,,,,0,0,0,0
1650449753.2652342,public.usertable,639787,103644,855842816,16893,public,usertable,1,0,1606405,3552329,702946,50019,63159,21891,639787,103644,816124,702946,,,,,0,0,0,0
1650449754.2941313,public.usertable,640126,103668,856268800,16893,public,usertable,1,0,1607340,3552661,703296,50034,63170,21898,640126,103668,816500,703296,,,,,0,0,0,0
1650449755.3254468,public.usertable,640490,103682,856735744,16893,public,usertable,1,0,1608303,3553739,703676,50044,63186,21902,640490,103682,816906,703676,,,,,0,0,0,0
1650449756.3539996,public.usertable,640829,103696,857145344,16893,public,usertable,1,0,1609181,3555599,704027,50052,63198,21906,640829,103696,817277,704027,,,,,0,0,0,0
1650449757.3835,public.usertable,641130,103729,857554944,16893,public,usertable,1,0,1610021,3556702,704347,50069,63217,21914,641130,103729,817633,704347,,,,,0,0,0,0
1650449758.412519,public.usertable,641466,103747,857972736,16893,public,usertable,1,0,1610972,3557866,704692,50082,63226,21920,641466,103747,818000,704692,,,,,0,0,0,0
1650449759.4422438,public.usertable,641775,103774,858374144,16893,public,usertable,1,0,1611928,3558855,705011,50099,63236,21926,641775,103774,818346,705011,,,,,0,0,0,0
1650449760.4718533,public.usertable,642052,103801,858734592,16893,public,usertable,1,0,1612790,3560221,705304,50115,63252,21935,642052,103801,818671,705304,,,,,0,0,0,0
1650449761.5005841,public.usertable,642408,103836,859209728,16893,public,usertable,1,0,1613778,3560460,705679,50132,63271,21946,642408,103836,819082,705679,,,,,0,0,0,0
1650449762.5319912,public.usertable,642783,103862,859676672,16893,public,usertable,1,0,1614791,3560918,706073,50139,63290,21950,642783,103862,819502,706073,,,,,0,0,0,0
1650449763.5617375,public.usertable,643155,103890,860160000,16893,public,usertable,1,0,1615834,3561894,706460,50155,63305,21960,643155,103890,819920,706460,,,,,0,0,0,0
1650449764.5917838,public.usertable,643543,103919,860651520,16893,public,usertable,1,0,1616886,3562391,706868,50167,63325,21965,643543,103919,820360,706868,,,,,0,0,0,0
1650449765.6232085,public.usertable,643875,103949,861069312,16893,public,usertable,1,0,1617823,3563421,707220,50182,63345,21973,643875,103949,820747,707220,,,,,0,0,0,0
1650449766.6521986,public.usertable,644218,103987,861536256,16893,public,usertable,1,0,1618874,3564549,707592,50199,63374,21982,644218,103987,821165,707592,,,,,0,0,0,0
1650449767.6811993,public.usertable,644600,104002,862019584,16893,public,usertable,1,0,1619960,3566332,707986,50212,63386,21993,644600,104002,821584,707986,,,,,0,0,0,0
1650449768.71058,public.usertable,644958,104024,862461952,16893,public,usertable,1,0,1621064,3567134,708364,50222,63406,22000,644958,104024,821992,708364,,,,,0,0,0,0
1650449769.7411292,public.usertable,645345,104047,862969856,16893,public,usertable,1,0,1622104,3567684,708760,50237,63415,22007,645345,104047,822412,708760,,,,,0,0,0,0
1650449770.7709534,public.usertable,645902,104085,863444992,16893,public,usertable,1,0,1623752,3569870,709348,50255,63446,22017,645902,104085,823049,709348,,,,,0,0,0,0
1650449771.8007698,public.usertable,646284,104106,863936512,16893,public,usertable,1,0,1624894,3571601,709747,50273,63463,22023,646284,104106,823483,709747,,,,,0,0,0,0
1650449772.8300529,public.usertable,646653,104138,864403456,16893,public,usertable,1,0,1625966,3573303,710136,50289,63483,22030,646653,104138,823908,710136,,,,,0,0,0,0
1650449773.8585582,public.usertable,647016,104170,864878592,16893,public,usertable,1,0,1626947,3574005,710519,50303,63503,22039,647016,104170,824325,710519,,,,,0,0,0,0
1650449774.8885565,public.usertable,647414,104188,865378304,16893,public,usertable,1,0,1627968,3575125,710927,50312,63513,22044,647414,104188,824752,710927,,,,,0,0,0,0
1650449775.9187984,public.usertable,647804,104225,865894400,16893,public,usertable,1,0,1629125,3576234,711341,50330,63537,22051,647804,104225,825208,711341,,,,,0,0,0,0
1650449776.9548588,public.usertable,648196,104252,866385920,16893,public,usertable,1,0,1630247,3577343,711746,50346,63550,22060,648196,104252,825642,711746,,,,,0,0,0,0
1650449777.9841812,public.usertable,648599,104279,866902016,16893,public,usertable,1,0,1631333,3577699,712164,50361,63565,22069,648599,104279,826090,712164,,,,,0,0,0,0
1650449779.0133052,public.usertable,648970,104333,867401728,16893,public,usertable,1,0,1632447,3578855,712569,50386,63599,22080,648970,104333,826554,712569,,,,,0,0,0,0
1650449780.0462391,public.usertable,649363,104362,867885056,16893,public,usertable,1,0,1633545,3579498,712978,50400,63615,22087,649363,104362,826993,712978,,,,,0,0,0,0
1650449781.0754545,public.usertable,649738,104395,868409344,16893,public,usertable,1,0,1634647,3580748,713373,50418,63635,22096,649738,104395,827426,713373,,,,,0,0,0,0
1650449782.1059132,public.usertable,650149,104436,868925440,16893,public,usertable,1,0,1635762,3581442,713807,50437,63658,22106,650149,104436,827902,713807,,,,,0,0,0,0
1650449783.1351807,public.usertable,650553,104464,869449728,16893,public,usertable,1,0,1636937,3582633,714229,50450,63676,22112,650553,104464,828355,714229,,,,,0,0,0,0
1650449784.1653922,public.usertable,650945,104501,869965824,16893,public,usertable,1,0,1638103,3583813,714647,50463,63702,22116,650945,104501,828812,714647,,,,,0,0,0,0
1650449785.1939821,public.usertable,651347,104540,870490112,16893,public,usertable,1,0,1639292,3584556,715066,50488,63719,22129,651347,104540,829273,715066,,,,,0,0,0,0
1650449786.2247071,public.usertable,651773,104574,871030784,16893,public,usertable,1,0,1640591,3585315,715510,50508,63737,22139,651773,104574,829755,715510,,,,,0,0,0,0
1650449787.2579997,public.usertable,652194,104594,871563264,16893,public,usertable,1,0,1641707,3586924,715946,50523,63752,22148,652194,104594,830221,715946,,,,,0,0,0,0
1650449788.2870393,public.usertable,652597,104632,872062976,16893,public,usertable,1,0,1642933,3587925,716368,50546,63771,22162,652597,104632,830685,716368,,,,,0,0,0,0
1650449789.3176534,public.usertable,653171,104680,872554496,16893,public,usertable,1,0,1644675,3589138,716970,50570,63799,22179,653171,104680,831339,716970,,,,,0,0,0,0
1650449790.3467815,public.usertable,653548,104707,873029632,16893,public,usertable,1,0,1645687,3590043,717364,50580,63816,22185,653548,104707,831760,717364,,,,,0,0,0,0
1650449791.3760235,public.usertable,653907,104736,873488384,16893,public,usertable,1,0,1646653,3590635,717743,50592,63836,22192,653907,104736,832171,717743,,,,,0,0,0,0
1650449792.4044101,public.usertable,654242,104760,873914368,16893,public,usertable,1,0,1647576,3591911,718095,50607,63853,22197,654242,104760,832555,718095,,,,,0,0,0,0
1650449793.4326527,public.usertable,654580,104793,874373120,16893,public,usertable,1,0,1648691,3592569,718455,50623,63875,22203,654580,104793,832953,718455,,,,,0,0,0,0
1650449794.4623802,public.usertable,654902,104815,874782720,16893,public,usertable,1,0,1649612,3594200,718790,50637,63888,22213,654902,104815,833315,718790,,,,,0,0,0,0
1650449795.4924648,public.usertable,655240,104835,875208704,16893,public,usertable,1,0,1650521,3594779,719146,50648,63906,22216,655240,104835,833700,719146,,,,,0,0,0,0
1650449796.5212202,public.usertable,655569,104868,875642880,16893,public,usertable,1,0,1651467,3595693,719491,50667,63922,22226,655569,104868,834080,719491,,,,,0,0,0,0
1650449797.5499845,public.usertable,655924,104897,876093440,16893,public,usertable,1,0,1652433,3596721,719862,50680,63938,22235,655924,104897,834480,719862,,,,,0,0,0,0
1650449798.5794122,public.usertable,656292,104932,876568576,16893,public,usertable,1,0,1653482,3598613,720256,50694,63964,22242,656292,104932,834914,720256,,,,,0,0,0,0
1650449799.6082218,public.usertable,656648,104954,877027328,16893,public,usertable,1,0,1654364,3599741,720624,50708,63976,22247,656648,104954,835308,720624,,,,,0,0,0,0
1650449800.6388767,public.usertable,657003,104975,877494272,16893,public,usertable,1,0,1655303,3600424,720993,50720,63990,22251,657003,104975,835703,720993,,,,,0,0,0,0
1650449801.670824,public.usertable,657366,105014,877944832,16893,public,usertable,1,0,1656381,3600873,721378,50738,64012,22261,657366,105014,836128,721378,,,,,0,0,0,0
1650449802.701022,public.usertable,657718,105044,878411776,16893,public,usertable,1,0,1657343,3601885,721747,50755,64029,22268,657718,105044,836531,721747,,,,,0,0,0,0
1650449803.731188,public.usertable,658089,105062,878870528,16893,public,usertable,1,0,1658413,3603442,722134,50771,64045,22277,658089,105062,836950,722134,,,,,0,0,0,0
1650449804.7595458,public.usertable,658437,105088,879329280,16893,public,usertable,1,0,1659361,3603775,722496,50784,64059,22283,658437,105088,837339,722496,,,,,0,0,0,0
1650449805.789379,public.usertable,658778,105120,879747072,16893,public,usertable,1,0,1660430,3604359,722857,50797,64079,22289,658778,105120,837733,722857,,,,,0,0,0,0
1650449806.8201132,public.usertable,659078,105143,880107520,16893,public,usertable,1,0,1661243,3605455,723173,50808,64095,22294,659078,105143,838076,723173,,,,,0,0,0,0
1650449807.8502448,public.usertable,659482,105171,880451584,16893,public,usertable,1,0,1662331,3606406,723597,50821,64115,22301,659482,105171,838533,723597,,,,,0,0,0,0
1650449808.8792953,public.usertable,659723,105195,880754688,16893,public,usertable,1,0,1663051,3606941,723851,50834,64128,22308,659723,105195,838813,723851,,,,,0,0,0,0
1650449809.9079988,public.usertable,659956,105212,881057792,16893,public,usertable,1,0,1663640,3607222,724093,50842,64137,22314,659956,105212,839072,724093,,,,,0,0,0,0
1650449810.9367528,public.usertable,660192,105238,881344512,16893,public,usertable,1,0,1664328,3607581,724345,50852,64153,22319,660192,105238,839350,724345,,,,,0,0,0,0
1650449811.967207,public.usertable,660403,105250,881631232,16893,public,usertable,1,0,1664929,3608778,724569,50857,64166,22320,660403,105250,839592,724569,,,,,0,0,0,0
1650449812.9953206,public.usertable,660602,105264,881876992,16893,public,usertable,1,0,1665474,3609418,724780,50862,64178,22324,660602,105264,839820,724780,,,,,0,0,0,0
1650449814.0270646,public.usertable,660824,105281,882163712,16893,public,usertable,1,0,1666203,3610598,725011,50874,64187,22331,660824,105281,840072,725011,,,,,0,0,0,0
1650449815.057257,public.usertable,661026,105295,882425856,16893,public,usertable,1,0,1666745,3611831,725225,50882,64199,22335,661026,105295,840306,725225,,,,,0,0,0,0
1650449816.0856466,public.usertable,661305,105314,882794496,16893,public,usertable,1,0,1667454,3612569,725512,50894,64207,22341,661305,105314,840613,725512,,,,,0,0,0,0
1650449817.1153927,public.usertable,661580,105325,883113984,16893,public,usertable,1,0,1668151,3613071,725794,50900,64214,22345,661580,105325,840908,725794,,,,,0,0,0,0
1650449818.1457148,public.usertable,661835,105351,883490816,16893,public,usertable,1,0,1668933,3613696,726068,50909,64233,22351,661835,105351,841210,726068,,,,,0,0,0,0
1650449819.1744335,public.usertable,662213,105375,883965952,16893,public,usertable,1,0,1669894,3614895,726459,50924,64246,22359,662213,105375,841629,726459,,,,,0,0,0,0
1650449820.2048962,public.usertable,662580,105397,884441088,16893,public,usertable,1,0,1670938,3615637,726841,50937,64261,22363,662580,105397,842039,726841,,,,,0,0,0,0
1650449821.2344298,public.usertable,662976,105408,884948992,16893,public,usertable,1,0,1671899,3617267,727256,50942,64280,22367,662976,105408,842478,727256,,,,,0,0,0,0
1650449822.2644992,public.usertable,663368,105436,885432320,16893,public,usertable,1,0,1672908,3618007,727666,50960,64298,22376,663368,105436,842924,727666,,,,,0,0,0,0
1650449823.2946436,public.usertable,663760,105460,885923840,16893,public,usertable,1,0,1673881,3618897,728067,50978,64307,22385,663760,105460,843352,728067,,,,,0,0,0,0
1650449824.3257825,public.usertable,664141,105485,886423552,16893,public,usertable,1,0,1674956,3619982,728465,50990,64324,22388,664141,105485,843779,728465,,,,,0,0,0,0
1650449825.3574219,public.usertable,664533,105507,886915072,16893,public,usertable,1,0,1676071,3620959,728874,50999,64341,22393,664533,105507,844214,728874,,,,,0,0,0,0
1650449826.3878589,public.usertable,664920,105529,887414784,16893,public,usertable,1,0,1677185,3621749,729275,51011,64355,22400,664920,105529,844641,729275,,,,,0,0,0,0
1650449827.4167368,public.usertable,665306,105567,887898112,16893,public,usertable,1,0,1678333,3622340,729683,51029,64377,22408,665306,105567,845089,729683,,,,,0,0,0,0
1650449828.4464648,public.usertable,665684,105593,888406016,16893,public,usertable,1,0,1679345,3623705,730083,51042,64399,22418,665684,105593,845524,730083,,,,,0,0,0,0
1650449829.4748905,public.usertable,666271,105641,888905728,16893,public,usertable,1,0,1680939,3625796,730702,51064,64431,22431,666271,105641,846197,730702,,,,,0,0,0,0
1650449830.505133,public.usertable,666648,105664,889389056,16893,public,usertable,1,0,1681998,3626750,731097,51083,64449,22439,666648,105664,846629,731097,,,,,0,0,0,0
1650449831.5354843,public.usertable,667010,105702,889864192,16893,public,usertable,1,0,1683149,3627259,731483,51100,64473,22447,667010,105702,847056,731483,,,,,0,0,0,0
1650449832.5645761,public.usertable,667404,105736,890363904,16893,public,usertable,1,0,1684214,3628096,731896,51116,64492,22455,667404,105736,847504,731896,,,,,0,0,0,0
1650449833.5929537,public.usertable,667797,105755,890847232,16893,public,usertable,1,0,1685158,3628821,732302,51124,64505,22462,667797,105755,847931,732302,,,,,0,0,0,0
1650449834.625061,public.usertable,668172,105778,891330560,16893,public,usertable,1,0,1686141,3629595,732694,51135,64522,22469,668172,105778,848351,732694,,,,,0,0,0,0
1650449835.6551292,public.usertable,668558,105812,891822080,16893,public,usertable,1,0,1687185,3629924,733099,51150,64541,22477,668558,105812,848790,733099,,,,,0,0,0,0
1650449836.6848688,public.usertable,668931,105837,892313600,16893,public,usertable,1,0,1688229,3631484,733488,51164,64557,22482,668931,105837,849209,733488,,,,,0,0,0,0
1650449837.714103,public.usertable,669319,105862,892788736,16893,public,usertable,1,0,1689351,3632825,733890,51177,64571,22491,669319,105862,849638,733890,,,,,0,0,0,0
1650449838.7433333,public.usertable,669711,105882,893288448,16893,public,usertable,1,0,1690445,3634351,734299,51189,64588,22497,669711,105882,850076,734299,,,,,0,0,0,0
1650449839.7721055,public.usertable,670058,105911,893747200,16893,public,usertable,1,0,1691511,3636020,734675,51197,64617,22501,670058,105911,850489,734675,,,,,0,0,0,0
1650449840.8021207,public.usertable,670404,105934,894099456,16893,public,usertable,1,0,1692457,3636375,735034,51208,64630,22507,670404,105934,850872,735034,,,,,0,0,0,0
1650449841.83315,public.usertable,670598,105939,894369792,16893,public,usertable,1,0,1692873,3636707,735234,51213,64636,22512,670598,105939,851083,735234,,,,,0,0,0,0
1650449842.8625576,public.usertable,670864,105954,894705664,16893,public,usertable,1,0,1693603,3638176,735514,51219,64650,22514,670864,105954,851383,735514,,,,,0,0,0,0
1650449843.891085,public.usertable,671123,105973,895049728,16893,public,usertable,1,0,1694328,3638803,735784,51229,64661,22520,671123,105973,851674,735784,,,,,0,0,0,0
1650449844.9198115,public.usertable,671391,106000,895393792,16893,public,usertable,1,0,1695114,3639005,736070,51238,64679,22526,671391,106000,851987,736070,,,,,0,0,0,0
1650449845.9489896,public.usertable,671667,106026,895770624,16893,public,usertable,1,0,1695885,3639399,736362,51250,64695,22532,671667,106026,852307,736362,,,,,0,0,0,0
1650449846.9807255,public.usertable,671958,106046,896122880,16893,public,usertable,1,0,1696742,3640179,736670,51263,64712,22540,671958,106046,852645,736670,,,,,0,0,0,0
1650449848.0097106,public.usertable,672215,106076,896458752,16893,public,usertable,1,0,1697563,3641032,736942,51279,64727,22546,672215,106076,852948,736942,,,,,0,0,0,0
1650449849.0387194,public.usertable,672468,106077,896794624,16893,public,usertable,1,0,1698222,3641568,737200,51286,64732,22549,672468,106077,853218,737200,,,,,0,0,0,0
1650449850.06897,public.usertable,672911,106115,897179648,16893,public,usertable,1,0,1699559,3643626,737665,51307,64754,22562,672911,106115,853726,737665,,,,,0,0,0,0
1650449851.0999975,public.usertable,673254,106146,897630208,16893,public,usertable,1,0,1700647,3644545,738031,51319,64777,22565,673254,106146,854127,738031,,,,,0,0,0,0
1650449852.1315248,public.usertable,673606,106175,898080768,16893,public,usertable,1,0,1701749,3645695,738409,51329,64803,22571,673606,106175,854541,738409,,,,,0,0,0,0
1650449853.1615856,public.usertable,673961,106206,898547712,16893,public,usertable,1,0,1702816,3647176,738786,51343,64825,22579,673961,106206,854954,738786,,,,,0,0,0,0
1650449854.1903,public.usertable,674347,106237,899039232,16893,public,usertable,1,0,1703915,3647790,739187,51361,64840,22590,674347,106237,855388,739187,,,,,0,0,0,0
1650449855.220271,public.usertable,674743,106272,899563520,16893,public,usertable,1,0,1705005,3648983,739600,51380,64857,22602,674743,106272,855837,739600,,,,,0,0,0,0
1650449856.2491817,public.usertable,675139,106307,900055040,16893,public,usertable,1,0,1706114,3650153,740021,51393,64882,22609,675139,106307,856296,740021,,,,,0,0,0,0
1650449857.2774315,public.usertable,675540,106335,900579328,16893,public,usertable,1,0,1707338,3650448,740442,51401,64902,22611,675540,106335,856745,740442,,,,,0,0,0,0
1650449858.3093095,public.usertable,675942,106360,901095424,16893,public,usertable,1,0,1708360,3651142,740861,51414,64919,22616,675942,106360,857194,740861,,,,,0,0,0,0
1650449859.3409102,public.usertable,676311,106375,901537792,16893,public,usertable,1,0,1709316,3652306,741240,51422,64929,22621,676311,106375,857591,741240,,,,,0,0,0,0
1650449860.3707528,public.usertable,676642,106405,901971968,16893,public,usertable,1,0,1710359,3653989,741594,51435,64952,22629,676642,106405,857981,741594,,,,,0,0,0,0
1650449861.3997252,public.usertable,676991,106428,902406144,16893,public,usertable,1,0,1711465,3654703,741955,51448,64964,22634,676991,106428,858367,741955,,,,,0,0,0,0
1650449862.4285343,public.usertable,677333,106455,902848512,16893,public,usertable,1,0,1712467,3655811,742315,51459,64982,22643,677333,106455,858756,742315,,,,,0,0,0,0
1650449863.457303,public.usertable,677677,106476,903290880,16893,public,usertable,1,0,1713454,3656842,742676,51471,64999,22652,677677,106476,859146,742676,,,,,0,0,0,0
1650449864.4864862,public.usertable,678033,106493,903725056,16893,public,usertable,1,0,1714380,3657890,743044,51481,65011,22657,678033,106493,859536,743044,,,,,0,0,0,0
1650449865.5177305,public.usertable,678384,106522,904175616,16893,public,usertable,1,0,1715361,3659178,743411,51494,65027,22665,678384,106522,859932,743411,,,,,0,0,0,0
1650449866.5486944,public.usertable,678728,106544,904634368,16893,public,usertable,1,0,1716356,3660049,743773,51502,65045,22668,678728,106544,860320,743773,,,,,0,0,0,0
1650449867.5784805,public.usertable,679081,106569,905084928,16893,public,usertable,1,0,1717450,3661297,744141,51518,65060,22674,679081,106569,860719,744141,,,,,0,0,0,0
1650449868.6075878,public.usertable,679464,106592,905560064,16893,public,usertable,1,0,1718443,3662015,744534,51533,65070,22682,679464,106592,861137,744534,,,,,0,0,0,0
1650449869.6358914,public.usertable,679815,106616,906018816,16893,public,usertable,1,0,1719411,3663029,744902,51549,65087,22694,679815,106616,861538,744902,,,,,0,0,0,0
1650449870.664935,public.usertable,680380,106666,906502144,16893,public,usertable,1,0,1720922,3664368,745491,51577,65111,22707,680380,106666,862179,745491,,,,,0,0,0,0
1650449871.6973863,public.usertable,680752,106682,906969088,16893,public,usertable,1,0,1721886,3665835,745874,51593,65122,22716,680752,106682,862589,745874,,,,,0,0,0,0
1650449872.730804,public.usertable,681060,106700,907370496,16893,public,usertable,1,0,1722760,3667259,746196,51606,65136,22722,681060,106700,862938,746196,,,,,0,0,0,0
1650449873.764767,public.usertable,681419,106717,907821056,16893,public,usertable,1,0,1723655,3668568,746567,51615,65148,22725,681419,106717,863330,746567,,,,,0,0,0,0
1650449874.7941883,public.usertable,681781,106743,908279808,16893,public,usertable,1,0,1724618,3669507,746944,51626,65163,22732,681781,106743,863733,746944,,,,,0,0,0,0
1650449875.8225727,public.usertable,682148,106762,908754944,16893,public,usertable,1,0,1725567,3670582,747323,51637,65175,22736,682148,106762,864135,747323,,,,,0,0,0,0
1650449876.8532982,public.usertable,682541,106790,909238272,16893,public,usertable,1,0,1726659,3670898,747731,51652,65190,22745,682541,106790,864573,747731,,,,,0,0,0,0
1650449877.8821235,public.usertable,682916,106804,909697024,16893,public,usertable,1,0,1727656,3671865,748119,51663,65203,22748,682916,106804,864985,748119,,,,,0,0,0,0
1650449878.9105856,public.usertable,683266,106827,910139392,16893,public,usertable,1,0,1728615,3672615,748483,51672,65217,22754,683266,106827,865372,748483,,,,,0,0,0,0
1650449879.940114,public.usertable,683602,106844,910565376,16893,public,usertable,1,0,1729548,3673857,748833,51683,65231,22761,683602,106844,865747,748833,,,,,0,0,0,0
1650449880.9706686,public.usertable,683964,106875,911056896,16893,public,usertable,1,0,1730693,3675067,749209,51701,65245,22769,683964,106875,866155,749209,,,,,0,0,0,0
1650449882.0014246,public.usertable,684345,106911,911540224,16893,public,usertable,1,0,1731824,3676640,749610,51719,65265,22779,684345,106911,866594,749610,,,,,0,0,0,0
1650449883.0327234,public.usertable,684703,106935,911990784,16893,public,usertable,1,0,1732887,3677680,749986,51731,65283,22787,684703,106935,867000,749986,,,,,0,0,0,0
1650449884.0629606,public.usertable,685051,106962,912449536,16893,public,usertable,1,0,1733967,3678950,750351,51746,65300,22798,685051,106962,867397,750351,,,,,0,0,0,0
1650449885.0935643,public.usertable,685421,106997,912924672,16893,public,usertable,1,0,1734980,3680369,750738,51766,65317,22804,685421,106997,867821,750738,,,,,0,0,0,0
1650449886.122906,public.usertable,685800,107019,913424384,16893,public,usertable,1,0,1736144,3680745,751130,51775,65330,22808,685800,107019,868235,751130,,,,,0,0,0,0
1650449887.1539974,public.usertable,686201,107035,913915904,16893,public,usertable,1,0,1737215,3681741,751547,51783,65346,22812,686201,107035,868676,751547,,,,,0,0,0,0
1650449888.1833522,public.usertable,686574,107068,914399232,16893,public,usertable,1,0,1738310,3681996,751944,51793,65370,22814,686574,107068,869107,751944,,,,,0,0,0,0
1650449889.2136056,public.usertable,687100,107100,914825216,16893,public,usertable,1,0,1739731,3683465,752489,51807,65389,22822,687100,107100,869685,752489,,,,,0,0,0,0
1650449890.2426026,public.usertable,687380,107124,915185664,16893,public,usertable,1,0,1740529,3683744,752783,51817,65403,22825,687380,107124,870003,752783,,,,,0,0,0,0
1650449891.2712502,public.usertable,687679,107142,915537920,16893,public,usertable,1,0,1741367,3685039,753091,51829,65412,22833,687679,107142,870332,753091,,,,,0,0,0,0
1650449892.3012738,public.usertable,687916,107155,915865600,16893,public,usertable,1,0,1742081,3686132,753339,51835,65423,22837,687916,107155,870597,753339,,,,,0,0,0,0
1650449893.3335688,public.usertable,688172,107174,916185088,16893,public,usertable,1,0,1742739,3687134,753609,51847,65437,22844,688172,107174,870893,753609,,,,,0,0,0,0
1650449894.3619854,public.usertable,688447,107192,916520960,16893,public,usertable,1,0,1743503,3687533,753895,51854,65448,22848,688447,107192,871197,753895,,,,,0,0,0,0
1650449895.3923945,public.usertable,688698,107214,916848640,16893,public,usertable,1,0,1744241,3688081,754159,51867,65461,22855,688698,107214,871487,754159,,,,,0,0,0,0
1650449896.422754,public.usertable,688938,107241,917143552,16893,public,usertable,1,0,1744910,3688292,754417,51879,65479,22861,688938,107241,871775,754417,,,,,0,0,0,0
1650449897.4529305,public.usertable,689191,107260,917487616,16893,public,usertable,1,0,1745583,3688536,754680,51888,65489,22866,689191,107260,872057,754680,,,,,0,0,0,0
1650449898.4822023,public.usertable,689435,107271,917831680,16893,public,usertable,1,0,1746282,3689599,754936,51893,65501,22869,689435,107271,872330,754936,,,,,0,0,0,0
1650449899.5098348,public.usertable,689798,107294,918298624,16893,public,usertable,1,0,1747285,3690989,755314,51907,65516,22879,689798,107294,872737,755314,,,,,0,0,0,0
1650449900.5385306,public.usertable,690201,107320,918798336,16893,public,usertable,1,0,1748402,3691603,755730,51920,65529,22886,690201,107320,873179,755730,,,,,0,0,0,0
1650449901.5673106,public.usertable,690578,107349,919281664,16893,public,usertable,1,0,1749364,3691889,756126,51933,65548,22893,690578,107349,873607,756126,,,,,0,0,0,0
1650449902.5962195,public.usertable,690928,107381,919699456,16893,public,usertable,1,0,1750412,3693078,756501,51949,65573,22900,690928,107381,874023,756501,,,,,0,0,0,0
1650449903.6247222,public.usertable,691255,107408,920166400,16893,public,usertable,1,0,1751406,3693499,756843,51961,65588,22907,691255,107408,874392,756843,,,,,0,0,0,0
1650449904.6563663,public.usertable,691656,107432,920690688,16893,public,usertable,1,0,1752403,3694775,757261,51973,65605,22913,691656,107432,874839,757261,,,,,0,0,0,0
1650449905.6858068,public.usertable,692063,107467,921198592,16893,public,usertable,1,0,1753593,3695461,757678,51998,65615,22922,692063,107467,875291,757678,,,,,0,0,0,0
1650449906.7179372,public.usertable,692435,107501,921681920,16893,public,usertable,1,0,1754768,3695862,758068,52015,65633,22927,692435,107501,875716,758068,,,,,0,0,0,0
1650449907.7482796,public.usertable,692823,107524,922165248,16893,public,usertable,1,0,1755843,3696477,758477,52024,65654,22934,692823,107524,876155,758477,,,,,0,0,0,0
1650449908.777022,public.usertable,693373,107554,922624000,16893,public,usertable,1,0,1757233,3698730,759051,52038,65678,22940,693373,107554,876767,759051,,,,,0,0,0,0
1650449909.808469,public.usertable,693731,107581,923074560,16893,public,usertable,1,0,1758264,3699815,759426,52050,65695,22946,693731,107581,877171,759426,,,,,0,0,0,0
1650449910.8389328,public.usertable,694060,107598,923500544,16893,public,usertable,1,0,1759203,3700860,759768,52060,65708,22952,694060,107598,877536,759768,,,,,0,0,0,0
1650449911.869142,public.usertable,694429,107625,923967488,16893,public,usertable,1,0,1760201,3701431,760151,52076,65722,22960,694429,107625,877949,760151,,,,,0,0,0,0
1650449912.8994682,public.usertable,694785,107658,924426240,16893,public,usertable,1,0,1761287,3702293,760529,52087,65744,22966,694785,107658,878360,760529,,,,,0,0,0,0
1650449913.9284334,public.usertable,695099,107686,924844032,16893,public,usertable,1,0,1762207,3702979,760864,52096,65765,22971,695099,107686,878725,760864,,,,,0,0,0,0
1650449914.9596915,public.usertable,695450,107709,925294592,16893,public,usertable,1,0,1763284,3704000,761232,52112,65782,22978,695450,107709,879126,761232,,,,,0,0,0,0
1650449915.9904015,public.usertable,695814,107732,925753344,16893,public,usertable,1,0,1764246,3704883,761609,52125,65795,22987,695814,107732,879529,761609,,,,,0,0,0,0
1650449917.0201468,public.usertable,696152,107760,926187520,16893,public,usertable,1,0,1765205,3706532,761959,52143,65807,22999,696152,107760,879909,761959,,,,,0,0,0,0
1650449918.052484,public.usertable,696519,107775,926638080,16893,public,usertable,1,0,1766246,3707837,762336,52155,65817,23006,696519,107775,880308,762336,,,,,0,0,0,0
1650449919.0857713,public.usertable,696882,107798,927088640,16893,public,usertable,1,0,1767379,3708371,762709,52169,65827,23011,696882,107798,880705,762709,,,,,0,0,0,0
1650449920.1142209,public.usertable,697237,107827,927563776,16893,public,usertable,1,0,1768395,3709571,763088,52178,65851,23018,697237,107827,881117,763088,,,,,0,0,0,0
1650449921.1428442,public.usertable,697608,107848,927997952,16893,public,usertable,1,0,1769470,3710141,763471,52189,65863,23023,697608,107848,881523,763471,,,,,0,0,0,0
1650449922.1710873,public.usertable,697965,107874,928473088,16893,public,usertable,1,0,1770352,3710823,763843,52200,65878,23027,697965,107874,881921,763843,,,,,0,0,0,0
1650449923.2017565,public.usertable,698333,107896,928948224,16893,public,usertable,1,0,1771294,3711496,764225,52209,65892,23031,698333,107896,882326,764225,,,,,0,0,0,0
1650449924.2315705,public.usertable,698680,107924,929390592,16893,public,usertable,1,0,1772342,3712590,764583,52231,65903,23044,698680,107924,882717,764583,,,,,0,0,0,0
1650449925.2629585,public.usertable,699049,107947,929865728,16893,public,usertable,1,0,1773359,3714059,764966,52248,65917,23054,699049,107947,883131,764966,,,,,0,0,0,0
1650449926.2923055,public.usertable,699439,107971,930373632,16893,public,usertable,1,0,1774435,3715494,765367,52267,65928,23066,699439,107971,883562,765367,,,,,0,0,0,0
1650449927.3207812,public.usertable,699846,107993,930873344,16893,public,usertable,1,0,1775548,3716383,765793,52276,65947,23072,699846,107993,884016,765793,,,,,0,0,0,0
1650449928.3494213,public.usertable,700426,108039,931373056,16893,public,usertable,1,0,1777201,3718021,766399,52302,65973,23081,700426,108039,884674,766399,,,,,0,0,0,0
1650449929.3796778,public.usertable,700808,108063,931864576,16893,public,usertable,1,0,1778238,3719923,766800,52316,65992,23091,700808,108063,885108,766800,,,,,0,0,0,0
1650449930.4090927,public.usertable,701185,108093,932347904,16893,public,usertable,1,0,1779235,3721001,767193,52337,66008,23103,701185,108093,885538,767193,,,,,0,0,0,0
1650449931.437153,public.usertable,701574,108120,932847616,16893,public,usertable,1,0,1780279,3721591,767598,52351,66024,23108,701574,108120,885973,767598,,,,,0,0,0,0
1650449932.4658396,public.usertable,701935,108147,933314560,16893,public,usertable,1,0,1781334,3722818,767978,52363,66043,23113,701935,108147,886384,767978,,,,,0,0,0,0
1650449933.495698,public.usertable,702288,108166,933765120,16893,public,usertable,1,0,1782327,3723790,768345,52373,66057,23119,702288,108166,886775,768345,,,,,0,0,0,0
1650449934.5270367,public.usertable,702690,108192,934273024,16893,public,usertable,1,0,1783447,3724347,768757,52389,66067,23128,702690,108192,887213,768757,,,,,0,0,0,0
1650449935.5572605,public.usertable,703083,108216,934780928,16893,public,usertable,1,0,1784580,3725079,769164,52402,66081,23130,703083,108216,887647,769164,,,,,0,0,0,0
1650449936.5871673,public.usertable,703472,108253,935280640,16893,public,usertable,1,0,1785608,3725558,769575,52421,66103,23138,703472,108253,888099,769575,,,,,0,0,0,0
1650449937.6188552,public.usertable,703853,108290,935780352,16893,public,usertable,1,0,1786764,3726282,769984,52436,66131,23148,703853,108290,888551,769984,,,,,0,0,0,0
1650449938.6489742,public.usertable,704218,108312,936222720,16893,public,usertable,1,0,1787827,3727520,770361,52451,66143,23158,704218,108312,888955,770361,,,,,0,0,0,0
1650449939.678781,public.usertable,704521,108333,936574976,16893,public,usertable,1,0,1788634,3728289,770678,52467,66157,23169,704521,108333,889302,770678,,,,,0,0,0,0
1650449940.707108,public.usertable,704813,108354,936984576,16893,public,usertable,1,0,1789468,3728741,770981,52478,66168,23175,704813,108354,889627,770981,,,,,0,0,0,0
1650449941.7383249,public.usertable,705161,108385,937435136,16893,public,usertable,1,0,1790504,3729876,771348,52494,66187,23181,705161,108385,890029,771348,,,,,0,0,0,0
1650449942.767327,public.usertable,705434,108403,937787392,16893,public,usertable,1,0,1791400,3730315,771635,52503,66201,23186,705434,108403,890339,771635,,,,,0,0,0,0
1650449943.797223,public.usertable,705787,108420,938246144,16893,public,usertable,1,0,1792429,3731220,772001,52513,66214,23192,705787,108420,890728,772001,,,,,0,0,0,0
1650449944.827494,public.usertable,706131,108442,938680320,16893,public,usertable,1,0,1793467,3731569,772358,52530,66227,23200,706131,108442,891115,772358,,,,,0,0,0,0
1650449945.8567212,public.usertable,706482,108464,939139072,16893,public,usertable,1,0,1794329,3732284,772723,52540,66241,23204,706482,108464,891504,772723,,,,,0,0,0,0
1650449946.8870199,public.usertable,707033,108504,939597824,16893,public,usertable,1,0,1795852,3732726,773293,52561,66260,23219,707033,108504,892114,773293,,,,,0,0,0,0
1650449947.9172192,public.usertable,707387,108529,940048384,16893,public,usertable,1,0,1796820,3733250,773658,52576,66271,23226,707387,108529,892505,773658,,,,,0,0,0,0
1650449948.945716,public.usertable,707746,108552,940498944,16893,public,usertable,1,0,1797655,3733914,774026,52590,66280,23232,707746,108552,892896,774026,,,,,0,0,0,0
1650449949.976472,public.usertable,708019,108560,940826624,16893,public,usertable,1,0,1798376,3734835,774307,52596,66288,23236,708019,108560,893191,774307,,,,,0,0,0,0
1650449951.005652,public.usertable,708204,108580,941064192,16893,public,usertable,1,0,1798979,3735547,774507,52605,66303,23241,708204,108580,893415,774507,,,,,0,0,0,0
1650449952.033631,public.usertable,708424,108599,941367296,16893,public,usertable,1,0,1799598,3736132,774739,52614,66315,23244,708424,108599,893668,774739,,,,,0,0,0,0
1650449953.064783,public.usertable,708762,108619,941809664,16893,public,usertable,1,0,1800589,3737165,775090,52625,66328,23250,708762,108619,894043,775090,,,,,0,0,0,0
1650449954.094633,public.usertable,709078,108638,942211072,16893,public,usertable,1,0,1801434,3737851,775418,52636,66340,23254,709078,108638,894394,775418,,,,,0,0,0,0
1650449955.1236634,public.usertable,709432,108649,942637056,16893,public,usertable,1,0,1802313,3739449,775785,52643,66353,23258,709432,108649,894781,775785,,,,,0,0,0,0
1650449956.1523774,public.usertable,709700,108676,942997504,16893,public,usertable,1,0,1803105,3739766,776070,52653,66370,23263,709700,108676,895093,776070,,,,,0,0,0,0
1650449957.1822045,public.usertable,709996,108699,943357952,16893,public,usertable,1,0,1803913,3740566,776376,52668,66380,23268,709996,108699,895424,776376,,,,,0,0,0,0
1650449958.2130725,public.usertable,710313,108713,943792128,16893,public,usertable,1,0,1804791,3741569,776707,52673,66394,23270,710313,108713,895774,776707,,,,,0,0,0,0
1650449959.243667,public.usertable,710662,108742,944209920,16893,public,usertable,1,0,1805672,3742092,777066,52692,66404,23277,710662,108742,896162,777066,,,,,0,0,0,0
1650449960.2769823,public.usertable,711001,108773,944701440,16893,public,usertable,1,0,1806713,3743203,777427,52710,66426,23285,711001,108773,896563,777427,,,,,0,0,0,0
1650449961.3057287,public.usertable,711395,108804,945209344,16893,public,usertable,1,0,1807777,3744288,777842,52721,66447,23292,711395,108804,897010,777842,,,,,0,0,0,0
1650449962.3353982,public.usertable,711793,108815,945692672,16893,public,usertable,1,0,1808867,3745902,778254,52734,66461,23298,711793,108815,897449,778254,,,,,0,0,0,0
1650449963.3646047,public.usertable,712188,108831,946225152,16893,public,usertable,1,0,1810038,3747184,778664,52743,66476,23300,712188,108831,897883,778664,,,,,0,0,0,0
1650449964.3938336,public.usertable,712589,108870,946692096,16893,public,usertable,1,0,1811147,3748273,779081,52766,66492,23311,712589,108870,898339,779081,,,,,0,0,0,0
1650449965.4243658,public.usertable,713190,108893,947232768,16893,public,usertable,1,0,1812853,3750304,779701,52789,66511,23323,713190,108893,899001,779701,,,,,0,0,0,0
1650449966.4531786,public.usertable,713614,108926,947773440,16893,public,usertable,1,0,1814087,3750622,780143,52805,66529,23332,713614,108926,899477,780143,,,,,0,0,0,0
1650449967.4852242,public.usertable,714046,108958,948322304,16893,public,usertable,1,0,1815270,3751335,780593,52820,66547,23337,714046,108958,899960,780593,,,,,0,0,0,0
1650449968.5138044,public.usertable,714471,108973,948854784,16893,public,usertable,1,0,1816307,3751866,781025,52830,66554,23345,714471,108973,900409,781025,,,,,0,0,0,0
1650449969.5433316,public.usertable,714847,108999,949321728,16893,public,usertable,1,0,1817336,3752628,781414,52846,66567,23356,714847,108999,900827,781414,,,,,0,0,0,0
1650449970.571679,public.usertable,715220,109025,949780480,16893,public,usertable,1,0,1818336,3752917,781796,52863,66576,23365,715220,109025,901235,781796,,,,,0,0,0,0
1650449971.6035824,public.usertable,715589,109055,950255616,16893,public,usertable,1,0,1819306,3753714,782183,52880,66594,23376,715589,109055,901657,782183,,,,,0,0,0,0
1650449972.6349697,public.usertable,715936,109075,950697984,16893,public,usertable,1,0,1820310,3754023,782543,52888,66607,23382,715936,109075,902038,782543,,,,,0,0,0,0
1650449973.6654587,public.usertable,716301,109082,951148544,16893,public,usertable,1,0,1821257,3755755,782922,52896,66621,23386,716301,109082,902439,782922,,,,,0,0,0,0
1650449974.6972163,public.usertable,716649,109106,951582720,16893,public,usertable,1,0,1822084,3756071,783283,52907,66634,23392,716649,109106,902824,783283,,,,,0,0,0,0
1650449975.7268305,public.usertable,716940,109121,951951360,16893,public,usertable,1,0,1822828,3756488,783582,52920,66642,23400,716940,109121,903144,783582,,,,,0,0,0,0
1650449976.756523,public.usertable,717293,109146,952410112,16893,public,usertable,1,0,1823891,3757653,783958,52928,66665,23406,717293,109146,903551,783958,,,,,0,0,0,0
1650449977.7852304,public.usertable,717651,109183,952901632,16893,public,usertable,1,0,1824991,3758150,784343,52942,66692,23415,717651,109183,903977,784343,,,,,0,0,0,0
1650449978.814123,public.usertable,718033,109201,953368576,16893,public,usertable,1,0,1826076,3758498,784740,52950,66707,23420,718033,109201,904397,784740,,,,,0,0,0,0
1650449979.8429942,public.usertable,718423,109221,953868288,16893,public,usertable,1,0,1827089,3758802,785138,52965,66715,23427,718423,109221,904818,785138,,,,,0,0,0,0
1650449980.8715878,public.usertable,718812,109243,954335232,16893,public,usertable,1,0,1828161,3760060,785544,52974,66732,23432,718812,109243,905250,785544,,,,,0,0,0,0
1650449981.901866,public.usertable,719173,109269,954802176,16893,public,usertable,1,0,1829148,3760364,785916,52989,66743,23439,719173,109269,905648,785916,,,,,0,0,0,0
1650449982.9321222,public.usertable,719537,109290,955301888,16893,public,usertable,1,0,1830300,3762429,786296,53001,66759,23443,719537,109290,906056,786296,,,,,0,0,0,0
1650449983.9625819,public.usertable,719956,109313,955793408,16893,public,usertable,1,0,1831303,3762885,786727,53014,66771,23451,719956,109313,906512,786727,,,,,0,0,0,0
1650449984.992623,public.usertable,720531,109343,956284928,16893,public,usertable,1,0,1832907,3764918,787321,53034,66790,23462,720531,109343,907145,787321,,,,,0,0,0,0
1650449986.0235834,public.usertable,720921,109371,956776448,16893,public,usertable,1,0,1834025,3765997,787722,53054,66801,23475,720921,109371,907577,787722,,,,,0,0,0,0
1650449987.0514464,public.usertable,721297,109390,957259776,16893,public,usertable,1,0,1835163,3766812,788118,53063,66821,23482,721297,109390,908002,788118,,,,,0,0,0,0
1650449988.0810947,public.usertable,721690,109420,957759488,16893,public,usertable,1,0,1836297,3767558,788528,53077,66838,23488,721690,109420,908443,788528,,,,,0,0,0,0
1650449989.1098053,public.usertable,722066,109445,958242816,16893,public,usertable,1,0,1837400,3769389,788917,53097,66851,23497,722066,109445,908865,788917,,,,,0,0,0,0
1650449990.1417496,public.usertable,722459,109472,958750720,16893,public,usertable,1,0,1838456,3770681,789328,53107,66869,23502,722459,109472,909304,789328,,,,,0,0,0,0
1650449991.1734757,public.usertable,722870,109506,959275008,16893,public,usertable,1,0,1839618,3771972,789757,53127,66887,23512,722870,109506,909771,789757,,,,,0,0,0,0
1650449992.2017224,public.usertable,723283,109532,959791104,16893,public,usertable,1,0,1840683,3772824,790190,53136,66907,23515,723283,109532,910233,790190,,,,,0,0,0,0
1650449993.2300403,public.usertable,723681,109543,960307200,16893,public,usertable,1,0,1841832,3774576,790604,53146,66923,23518,723681,109543,910673,790604,,,,,0,0,0,0
1650449994.2609277,public.usertable,724053,109576,960774144,16893,public,usertable,1,0,1842899,3775186,790991,53164,66938,23527,724053,109576,911093,790991,,,,,0,0,0,0
1650449995.2911487,public.usertable,724402,109604,961216512,16893,public,usertable,1,0,1843919,3775835,791360,53179,66958,23538,724402,109604,911497,791360,,,,,0,0,0,0
1650449996.3196568,public.usertable,724770,109627,961699840,16893,public,usertable,1,0,1844916,3776371,791747,53191,66977,23544,724770,109627,911915,791747,,,,,0,0,0,0
1650449997.3495235,public.usertable,725137,109647,962142208,16893,public,usertable,1,0,1846066,3777999,792132,53200,66995,23549,725137,109647,912327,792132,,,,,0,0,0,0
1650449998.3828418,public.usertable,725486,109675,962600960,16893,public,usertable,1,0,1847042,3778885,792501,53212,67015,23554,725486,109675,912728,792501,,,,,0,0,0,0
1650449999.4119923,public.usertable,725841,109696,963059712,16893,public,usertable,1,0,1848050,3779611,792871,53222,67030,23561,725841,109696,913123,792871,,,,,0,0,0,0
1650450000.442399,public.usertable,726190,109723,963510272,16893,public,usertable,1,0,1849024,3780713,793238,53237,67048,23571,726190,109723,913523,793238,,,,,0,0,0,0
1650450001.4718583,public.usertable,726547,109750,963960832,16893,public,usertable,1,0,1850028,3782276,793610,53254,67063,23579,726547,109750,913927,793610,,,,,0,0,0,0
1650450002.5013835,public.usertable,726890,109776,964386816,16893,public,usertable,1,0,1850968,3782939,793971,53264,67081,23585,726890,109776,914316,793971,,,,,0,0,0,0
1650450003.532481,public.usertable,727385,109802,964812800,16893,public,usertable,1,0,1852373,3785104,794494,53278,67109,23592,727385,109802,914881,794494,,,,,0,0,0,0
1650450004.560786,public.usertable,727705,109818,965206016,16893,public,usertable,1,0,1853204,3785552,794823,53292,67118,23600,727705,109818,915233,794823,,,,,0,0,0,0
1650450005.5919561,public.usertable,728037,109840,965640192,16893,public,usertable,1,0,1854122,3786330,795169,53300,67132,23604,728037,109840,915601,795169,,,,,0,0,0,0
1650450006.6229143,public.usertable,728407,109869,966115328,16893,public,usertable,1,0,1855151,3787354,795564,53308,67157,23608,728407,109869,916029,795564,,,,,0,0,0,0
1650450007.6529088,public.usertable,728772,109890,966582272,16893,public,usertable,1,0,1856187,3788132,795944,53321,67172,23614,728772,109890,916437,795944,,,,,0,0,0,0
1650450008.6834955,public.usertable,729119,109909,967024640,16893,public,usertable,1,0,1857165,3788736,796311,53328,67192,23619,729119,109909,916831,796311,,,,,0,0,0,0
1650450009.7140608,public.usertable,729485,109926,967499776,16893,public,usertable,1,0,1858188,3790585,796689,53336,67204,23619,729485,109926,917229,796689,,,,,0,0,0,0
1650450010.7439299,public.usertable,729845,109948,967958528,16893,public,usertable,1,0,1859213,3791004,797056,53352,67211,23627,729845,109948,917619,797056,,,,,0,0,0,0
1650450011.7757072,public.usertable,730210,109970,968425472,16893,public,usertable,1,0,1860250,3791812,797439,53364,67229,23633,730210,109970,918032,797439,,,,,0,0,0,0
1650450012.8062303,public.usertable,730572,110003,968876032,16893,public,usertable,1,0,1861271,3792733,797817,53382,67245,23645,730572,110003,918444,797817,,,,,0,0,0,0
1650450013.8346937,public.usertable,730932,110025,969310208,16893,public,usertable,1,0,1862212,3793083,798190,53393,67258,23653,730932,110025,918841,798190,,,,,0,0,0,0
1650450014.8646564,public.usertable,731268,110043,969736192,16893,public,usertable,1,0,1863199,3795164,798539,53405,67271,23660,731268,110043,919215,798539,,,,,0,0,0,0
1650450015.894251,public.usertable,731630,110067,970219520,16893,public,usertable,1,0,1864207,3795619,798918,53417,67288,23666,731630,110067,919623,798918,,,,,0,0,0,0
1650450016.9264817,public.usertable,731990,110093,970678272,16893,public,usertable,1,0,1865237,3795935,799299,53425,67309,23668,731990,110093,920033,799299,,,,,0,0,0,0
1650450017.9550889,public.usertable,732356,110127,971137024,16893,public,usertable,1,0,1866254,3797204,799681,53445,67325,23678,732356,110127,920451,799681,,,,,0,0,0,0
1650450018.9837775,public.usertable,732645,110143,971472896,16893,public,usertable,1,0,1867034,3798067,799979,53452,67334,23681,732645,110143,920765,799979,,,,,0,0,0,0
1650450020.0138123,public.usertable,732959,110154,971898880,16893,public,usertable,1,0,1867867,3798393,800302,53459,67343,23683,732959,110154,921104,800302,,,,,0,0,0,0
1650450021.0429564,public.usertable,733252,110178,972300288,16893,public,usertable,1,0,1868729,3799010,800608,53472,67356,23691,733252,110178,921436,800608,,,,,0,0,0,0
1650450022.0740783,public.usertable,733619,110200,972742656,16893,public,usertable,1,0,1869670,3799465,800987,53484,67368,23699,733619,110200,921839,800987,,,,,0,0,0,0
1650450023.103654,public.usertable,734162,110232,973209600,16893,public,usertable,1,0,1871160,3800973,801556,53499,67394,23707,734162,110232,922449,801556,,,,,0,0,0,0
1650450024.1321735,public.usertable,734433,110248,973561856,16893,public,usertable,1,0,1871887,3801858,801840,53508,67407,23711,734433,110248,922755,801840,,,,,0,0,0,0
1650450025.1631465,public.usertable,734787,110265,974004224,16893,public,usertable,1,0,1872936,3803047,802207,53517,67420,23713,734787,110265,923144,802207,,,,,0,0,0,0
1650450026.1917014,public.usertable,735087,110282,974356480,16893,public,usertable,1,0,1873832,3803770,802521,53522,67434,23715,735087,110282,923477,802521,,,,,0,0,0,0
1650450027.2218697,public.usertable,735396,110295,974774272,16893,public,usertable,1,0,1874744,3804185,802839,53526,67443,23718,735396,110295,923808,802839,,,,,0,0,0,0
1650450028.2515547,public.usertable,735708,110316,975175680,16893,public,usertable,1,0,1875687,3804670,803168,53535,67460,23722,735708,110316,924163,803168,,,,,0,0,0,0
1650450029.28109,public.usertable,736050,110332,975642624,16893,public,usertable,1,0,1876594,3805911,803525,53543,67475,23723,736050,110332,924543,803525,,,,,0,0,0,0
1650450030.3098724,public.usertable,736437,110357,976117760,16893,public,usertable,1,0,1877635,3806142,803928,53552,67491,23725,736437,110357,924971,803928,,,,,0,0,0,0
1650450031.3398228,public.usertable,736813,110371,976576512,16893,public,usertable,1,0,1878609,3807487,804318,53558,67505,23729,736813,110371,925381,804318,,,,,0,0,0,0
1650450032.3695028,public.usertable,737160,110398,976994304,16893,public,usertable,1,0,1879643,3808137,804681,53571,67521,23736,737160,110398,925773,804681,,,,,0,0,0,0
1650450033.3984654,public.usertable,737408,110414,977313792,16893,public,usertable,1,0,1880449,3808602,804938,53578,67530,23740,737408,110414,926046,804938,,,,,0,0,0,0
1650450034.4263752,public.usertable,737673,110437,977657856,16893,public,usertable,1,0,1881125,3809464,805217,53587,67544,23746,737673,110437,926348,805217,,,,,0,0,0,0
1650450035.4563138,public.usertable,737923,110456,977944576,16893,public,usertable,1,0,1881735,3809532,805478,53595,67555,23751,737923,110456,926628,805478,,,,,0,0,0,0
1650450036.4866748,public.usertable,738171,110468,978255872,16893,public,usertable,1,0,1882404,3810651,805733,53602,67562,23753,738171,110468,926897,805733,,,,,0,0,0,0
1650450037.5150049,public.usertable,738390,110485,978518016,16893,public,usertable,1,0,1883061,3811182,805961,53613,67571,23759,738390,110485,927145,805961,,,,,0,0,0,0
1650450038.5466523,public.usertable,738617,110504,978862080,16893,public,usertable,1,0,1883696,3811332,806200,53621,67583,23762,738617,110504,927404,806200,,,,,0,0,0,0
1650450039.5755436,public.usertable,738884,110523,979189760,16893,public,usertable,1,0,1884414,3812200,806482,53626,67598,23765,738884,110523,927706,806482,,,,,0,0,0,0
1650450040.6058073,public.usertable,739209,110556,979656704,16893,public,usertable,1,0,1885369,3812795,806828,53638,67619,23773,739209,110556,928085,806828,,,,,0,0,0,0
1650450041.6344316,public.usertable,739573,110582,980131840,16893,public,usertable,1,0,1886478,3813516,807210,53646,67637,23779,739573,110582,928493,807210,,,,,0,0,0,0
1650450042.6630604,public.usertable,740182,110617,980656128,16893,public,usertable,1,0,1888072,3814644,807837,53668,67655,23793,740182,110617,929160,807837,,,,,0,0,0,0
1650450043.6951652,public.usertable,740582,110637,981147648,16893,public,usertable,1,0,1889137,3815564,808248,53680,67666,23803,740582,110637,929594,808248,,,,,0,0,0,0
1650450044.7276022,public.usertable,740979,110668,981671936,16893,public,usertable,1,0,1890251,3815879,808664,53695,67685,23809,740979,110668,930044,808664,,,,,0,0,0,0
1650450045.7579687,public.usertable,741377,110689,982171648,16893,public,usertable,1,0,1891394,3816592,809073,53716,67696,23821,741377,110689,930485,809073,,,,,0,0,0,0
1650450046.7870214,public.usertable,741774,110719,982663168,16893,public,usertable,1,0,1892626,3817121,809492,53726,67718,23831,741774,110719,930936,809492,,,,,0,0,0,0
1650450047.816667,public.usertable,742151,110747,983154688,16893,public,usertable,1,0,1893745,3818313,809886,53739,67735,23838,742151,110747,931360,809886,,,,,0,0,0,0
1650450048.8456078,public.usertable,742559,110765,983662592,16893,public,usertable,1,0,1894857,3818642,810303,53748,67744,23842,742559,110765,931795,810303,,,,,0,0,0,0
1650450049.8744195,public.usertable,742940,110792,984137728,16893,public,usertable,1,0,1895920,3819725,810703,53756,67763,23847,742940,110792,932222,810703,,,,,0,0,0,0
1650450050.9059532,public.usertable,743329,110814,984637440,16893,public,usertable,1,0,1897069,3820642,811113,53765,67784,23852,743329,110814,932662,811113,,,,,0,0,0,0
1650450051.936569,public.usertable,743720,110835,985145344,16893,public,usertable,1,0,1898195,3821369,811514,53776,67794,23853,743720,110835,933084,811514,,,,,0,0,0,0
1650450052.9661176,public.usertable,744111,110858,985636864,16893,public,usertable,1,0,1899366,3821937,811920,53787,67809,23859,744111,110858,933516,811920,,,,,0,0,0,0
1650450053.9977317,public.usertable,744505,110881,986128384,16893,public,usertable,1,0,1900441,3822528,812329,53798,67824,23865,744505,110881,933951,812329,,,,,0,0,0,0
1650450055.0254312,public.usertable,744895,110913,986652672,16893,public,usertable,1,0,1901645,3823269,812735,53814,67840,23870,744895,110913,934389,812735,,,,,0,0,0,0
1650450056.0573125,public.usertable,745296,110940,987144192,16893,public,usertable,1,0,1902714,3823648,813148,53829,67852,23878,745296,110940,934829,813148,,,,,0,0,0,0
1650450057.0876563,public.usertable,745644,110961,987578368,16893,public,usertable,1,0,1903593,3824356,813508,53840,67864,23884,745644,110961,935212,813508,,,,,0,0,0,0
1650450058.1179156,public.usertable,746034,110985,988045312,16893,public,usertable,1,0,1904695,3824942,813911,53858,67877,23893,746034,110985,935646,813911,,,,,0,0,0,0
1650450059.148902,public.usertable,746334,111001,988364800,16893,public,usertable,1,0,1905604,3825893,814224,53865,67890,23898,746334,111001,935979,814224,,,,,0,0,0,0
1650450060.180105,public.usertable,746701,111022,988676096,16893,public,usertable,1,0,1906591,3826402,814601,53876,67900,23903,746701,111022,936377,814601,,,,,0,0,0,0
1650450061.2093186,public.usertable,746966,111036,989011968,16893,public,usertable,1,0,1907336,3827687,814875,53882,67909,23907,746966,111036,936666,814875,,,,,0,0,0,0
1650450062.2380176,public.usertable,747271,111045,989388800,16893,public,usertable,1,0,1908161,3828248,815184,53887,67913,23912,747271,111045,936984,815184,,,,,0,0,0,0
1650450063.2671618,public.usertable,747562,111065,989757440,16893,public,usertable,1,0,1908941,3829895,815487,53896,67925,23918,747562,111065,937308,815487,,,,,0,0,0,0
1650450064.2951572,public.usertable,747881,111082,990158848,16893,public,usertable,1,0,1909835,3830289,815817,53902,67936,23922,747881,111082,937655,815817,,,,,0,0,0,0
1650450065.3250299,public.usertable,748210,111090,990552064,16893,public,usertable,1,0,1910770,3830749,816155,53907,67945,23925,748210,111090,938007,816155,,,,,0,0,0,0
1650450066.354265,public.usertable,748537,111118,990969856,16893,public,usertable,1,0,1911648,3831398,816499,53918,67962,23933,748537,111118,938379,816499,,,,,0,0,0,0
1650450067.3836923,public.usertable,748871,111148,991428608,16893,public,usertable,1,0,1912578,3832313,816850,53933,67979,23941,748871,111148,938762,816850,,,,,0,0,0,0
1650450068.4136071,public.usertable,749248,111178,991903744,16893,public,usertable,1,0,1913659,3833254,817241,53952,67993,23954,749248,111178,939186,817241,,,,,0,0,0,0
1650450069.4441206,public.usertable,749619,111206,992387072,16893,public,usertable,1,0,1914698,3833791,817632,53960,68013,23958,749619,111206,939605,817632,,,,,0,0,0,0
1650450070.4755747,public.usertable,750030,111221,992903168,16893,public,usertable,1,0,1915807,3834722,818054,53970,68024,23965,750030,111221,940048,818054,,,,,0,0,0,0
1650450071.5062208,public.usertable,750445,111248,993443840,16893,public,usertable,1,0,1916981,3835241,818486,53984,68041,23968,750445,111248,940511,818486,,,,,0,0,0,0
1650450072.535673,public.usertable,750861,111279,993943552,16893,public,usertable,1,0,1918123,3836037,818922,53995,68061,23977,750861,111279,940978,818922,,,,,0,0,0,0
1650450073.5634973,public.usertable,751248,111321,994451456,16893,public,usertable,1,0,1919251,3836606,819333,54014,68085,23988,751248,111321,941432,819333,,,,,0,0,0,0
1650450074.5934534,public.usertable,751658,111342,994959360,16893,public,usertable,1,0,1920371,3837601,819755,54023,68097,23992,751658,111342,941875,819755,,,,,0,0,0,0
1650450075.6231172,public.usertable,752048,111367,995475456,16893,public,usertable,1,0,1921359,3838771,820163,54033,68115,23996,752048,111367,942311,820163,,,,,0,0,0,0
1650450076.6526914,public.usertable,752445,111391,995958784,16893,public,usertable,1,0,1922486,3839218,820569,54048,68124,24003,752445,111391,942741,820569,,,,,0,0,0,0
1650450077.6805127,public.usertable,752837,111415,996466688,16893,public,usertable,1,0,1923625,3840951,820976,54064,68139,24009,752837,111415,943179,820976,,,,,0,0,0,0
1650450078.7091086,public.usertable,753426,111440,996966400,16893,public,usertable,1,0,1925101,3842833,821585,54084,68159,24017,753426,111440,943828,821585,,,,,0,0,0,0
1650450079.7375987,public.usertable,753731,111467,997359616,16893,public,usertable,1,0,1926049,3844626,821908,54095,68177,24026,753731,111467,944180,821908,,,,,0,0,0,0
1650450080.7686367,public.usertable,754025,111486,997720064,16893,public,usertable,1,0,1926868,3845318,822212,54104,68187,24031,754025,111486,944503,822212,,,,,0,0,0,0
1650450081.7972677,public.usertable,754287,111500,998055936,16893,public,usertable,1,0,1927542,3845463,822483,54111,68196,24034,754287,111500,944790,822483,,,,,0,0,0,0
1650450082.8292208,public.usertable,754576,111514,998416384,16893,public,usertable,1,0,1928321,3846352,822784,54118,68208,24037,754576,111514,945110,822784,,,,,0,0,0,0
1650450083.8573203,public.usertable,754855,111535,998760448,16893,public,usertable,1,0,1929043,3846990,823074,54128,68219,24041,754855,111535,945421,823074,,,,,0,0,0,0
1650450084.8876934,public.usertable,755117,111547,999079936,16893,public,usertable,1,0,1929812,3848004,823342,54136,68225,24046,755117,111547,945703,823342,,,,,0,0,0,0
1650450085.9185362,public.usertable,755368,111544,999415808,16893,public,usertable,1,0,1930434,3848991,823600,54146,68232,24052,755368,111544,945978,823600,,,,,0,0,0,0
1650450086.946847,public.usertable,755647,111567,999759872,16893,public,usertable,1,0,1931275,3849242,823891,54159,68244,24058,755647,111567,946294,823891,,,,,0,0,0,0
1650450087.9755428,public.usertable,755911,111576,1000103936,16893,public,usertable,1,0,1932064,3850595,824164,54168,68253,24059,755911,111576,946585,824164,,,,,0,0,0,0
1650450089.007325,public.usertable,756193,111594,1000472576,16893,public,usertable,1,0,1932782,3850913,824453,54179,68260,24063,756193,111594,946892,824453,,,,,0,0,0,0
1650450090.0387151,public.usertable,756494,111609,1000882176,16893,public,usertable,1,0,1933704,3851843,824765,54183,68271,24064,756494,111609,947219,824765,,,,,0,0,0,0
1650450091.0676124,public.usertable,756906,111616,1001390080,16893,public,usertable,1,0,1934720,3853409,825183,54190,68277,24067,756906,111616,947650,825183,,,,,0,0,0,0
1650450092.0975223,public.usertable,757297,111637,1001881600,16893,public,usertable,1,0,1935720,3853899,825586,54202,68289,24074,757297,111637,948077,825586,,,,,0,0,0,0
1650450093.1260529,public.usertable,757673,111662,1002364928,16893,public,usertable,1,0,1936727,3854393,825979,54213,68306,24080,757673,111662,948498,825979,,,,,0,0,0,0
1650450094.1539316,public.usertable,758062,111676,1002856448,16893,public,usertable,1,0,1937856,3855406,826381,54224,68319,24086,758062,111676,948924,826381,,,,,0,0,0,0
1650450095.1846862,public.usertable,758485,111686,1003405312,16893,public,usertable,1,0,1938861,3856889,826819,54235,68334,24091,758485,111686,949388,826819,,,,,0,0,0,0
1650450096.2150648,public.usertable,758900,111711,1003896832,16893,public,usertable,1,0,1939950,3857573,827245,54254,68345,24097,758900,111711,949844,827245,,,,,0,0,0,0
1650450097.2443225,public.usertable,759257,111745,1004371968,16893,public,usertable,1,0,1941032,3858340,827623,54267,68366,24102,759257,111745,950256,827623,,,,,0,0,0,0
1650450098.2735662,public.usertable,759624,111779,1004847104,16893,public,usertable,1,0,1942120,3859460,828016,54277,68392,24108,759624,111779,950685,828016,,,,,0,0,0,0
1650450099.3023093,public.usertable,760192,111809,1005314048,16893,public,usertable,1,0,1943658,3860136,828598,54296,68406,24118,760192,111809,951300,828598,,,,,0,0,0,0
1650450100.3304167,public.usertable,760549,111831,1005764608,16893,public,usertable,1,0,1944620,3861731,828971,54308,68422,24123,760549,111831,951701,828971,,,,,0,0,0,0
1650450101.3600707,public.usertable,760903,111852,1006215168,16893,public,usertable,1,0,1945609,3862436,829341,54316,68438,24130,760903,111852,952095,829341,,,,,0,0,0,0
1650450102.3895054,public.usertable,761287,111862,1006690304,16893,public,usertable,1,0,1946604,3862961,829733,54327,68446,24136,761287,111862,952506,829733,,,,,0,0,0,0
1650450103.4220958,public.usertable,761669,111888,1007165440,16893,public,usertable,1,0,1947747,3863437,830129,54339,68460,24144,761669,111888,952928,830129,,,,,0,0,0,0
1650450104.450675,public.usertable,762023,111918,1007640576,16893,public,usertable,1,0,1948802,3864159,830498,54354,68475,24152,762023,111918,953327,830498,,,,,0,0,0,0
1650450105.4815338,public.usertable,762413,111949,1008140288,16893,public,usertable,1,0,1949893,3865222,830905,54371,68492,24157,762413,111949,953768,830905,,,,,0,0,0,0
1650450106.5140438,public.usertable,762829,111966,1008648192,16893,public,usertable,1,0,1950918,3866583,831330,54381,68501,24162,762829,111966,954212,831330,,,,,0,0,0,0
1650450107.5448313,public.usertable,763191,111983,1009106944,16893,public,usertable,1,0,1951866,3867663,831704,54390,68513,24164,763191,111983,954607,831704,,,,,0,0,0,0
1650450108.5738423,public.usertable,763568,112009,1009598464,16893,public,usertable,1,0,1952967,3868278,832096,54405,68528,24171,763568,112009,955029,832096,,,,,0,0,0,0
1650450109.6023943,public.usertable,763929,112037,1010057216,16893,public,usertable,1,0,1953985,3869887,832481,54413,68552,24176,763929,112037,955446,832481,,,,,0,0,0,0
1650450110.637181,public.usertable,764305,112062,1010548736,16893,public,usertable,1,0,1955060,3870693,832876,54419,68571,24177,764305,112062,955866,832876,,,,,0,0,0,0
1650450111.6678133,public.usertable,764684,112091,1011015680,16893,public,usertable,1,0,1956237,3871487,833270,54433,68586,24186,764684,112091,956289,833270,,,,,0,0,0,0
1650450112.697186,public.usertable,765046,112121,1011490816,16893,public,usertable,1,0,1957355,3872383,833650,54449,68604,24197,765046,112121,956703,833650,,,,,0,0,0,0
1650450113.7258646,public.usertable,765442,112139,1011974144,16893,public,usertable,1,0,1958330,3873188,834057,54459,68615,24202,765442,112139,957131,834057,,,,,0,0,0,0
1650450114.7549214,public.usertable,765800,112155,1012391936,16893,public,usertable,1,0,1959301,3873750,834425,54467,68625,24209,765800,112155,957517,834425,,,,,0,0,0,0
1650450115.7835782,public.usertable,766141,112182,1012842496,16893,public,usertable,1,0,1960263,3874675,834784,54478,68643,24214,766141,112182,957905,834784,,,,,0,0,0,0
1650450116.8128743,public.usertable,766651,112216,1013268480,16893,public,usertable,1,0,1961795,3875836,835308,54500,68657,24227,766651,112216,958465,835308,,,,,0,0,0,0
1650450117.8430977,public.usertable,766979,112239,1013686272,16893,public,usertable,1,0,1962773,3876816,835651,54512,68672,24232,766979,112239,958835,835651,,,,,0,0,0,0
1650450118.8714917,public.usertable,767361,112258,1014161408,16893,public,usertable,1,0,1963843,3877500,836041,54527,68680,24244,767361,112258,959248,836041,,,,,0,0,0,0
1650450119.9017274,public.usertable,767730,112274,1014628352,16893,public,usertable,1,0,1964810,3878196,836419,54536,68689,24249,767730,112274,959644,836419,,,,,0,0,0,0
1650450120.9323435,public.usertable,768083,112298,1015070720,16893,public,usertable,1,0,1965826,3879036,836782,54552,68699,24261,768083,112298,960033,836782,,,,,0,0,0,0
1650450121.9658287,public.usertable,768469,112310,1015537664,16893,public,usertable,1,0,1966790,3879921,837178,54563,68709,24270,768469,112310,960450,837178,,,,,0,0,0,0
1650450122.9944034,public.usertable,768819,112339,1015980032,16893,public,usertable,1,0,1967784,3880913,837543,54579,68724,24281,768819,112339,960846,837543,,,,,0,0,0,0
1650450124.0230536,public.usertable,769183,112354,1016430592,16893,public,usertable,1,0,1968767,3881363,837916,54585,68733,24286,769183,112354,961234,837916,,,,,0,0,0,0
1650450125.0532331,public.usertable,769504,112379,1016840192,16893,public,usertable,1,0,1969724,3881931,838252,54596,68748,24291,769504,112379,961596,838252,,,,,0,0,0,0
1650450126.0826764,public.usertable,769845,112401,1017274368,16893,public,usertable,1,0,1970652,3882745,838606,54605,68761,24294,769845,112401,961972,838606,,,,,0,0,0,0
1650450127.1115158,public.usertable,770193,112425,1017708544,16893,public,usertable,1,0,1971565,3883134,838968,54615,68775,24299,770193,112425,962358,838968,,,,,0,0,0,0
1650450128.1419923,public.usertable,770535,112446,1018134528,16893,public,usertable,1,0,1972561,3884368,839328,54623,68793,24306,770535,112446,962744,839328,,,,,0,0,0,0
1650450129.1708908,public.usertable,770879,112479,1018568704,16893,public,usertable,1,0,1973589,3884606,839688,54640,68809,24315,770879,112479,963137,839688,,,,,0,0,0,0
1650450130.2029006,public.usertable,771157,112493,1018937344,16893,public,usertable,1,0,1974434,3885131,839975,54647,68818,24319,771157,112493,963440,839975,,,,,0,0,0,0
1650450131.2316747,public.usertable,771460,112516,1019289600,16893,public,usertable,1,0,1975270,3885248,840291,54657,68831,24322,771460,112516,963779,840291,,,,,0,0,0,0
1650450132.2624528,public.usertable,771740,112541,1019641856,16893,public,usertable,1,0,1976079,3886651,840586,54668,68846,24330,771740,112541,964100,840586,,,,,0,0,0,0
1650450133.290113,public.usertable,771998,112553,1019977728,16893,public,usertable,1,0,1976796,3887482,840857,54672,68859,24331,771998,112553,964388,840857,,,,,0,0,0,0
1650450134.3210351,public.usertable,772295,112574,1020370944,16893,public,usertable,1,0,1977698,3887903,841162,54685,68867,24339,772295,112574,964714,841162,,,,,0,0,0,0
1650450135.3543198,public.usertable,772615,112593,1020755968,16893,public,usertable,1,0,1978481,3888380,841492,54694,68877,24344,772615,112593,965063,841492,,,,,0,0,0,0
1650450136.387739,public.usertable,772897,112605,1021116416,16893,public,usertable,1,0,1979317,3889476,841785,54702,68888,24349,772897,112605,965375,841785,,,,,0,0,0,0
1650450137.4163177,public.usertable,773287,112628,1021419520,16893,public,usertable,1,0,1980399,3889999,842192,54713,68905,24357,773287,112628,965810,842192,,,,,0,0,0,0
1650450138.4454606,public.usertable,773533,112648,1021730816,16893,public,usertable,1,0,1981124,3890325,842453,54719,68920,24361,773533,112648,966092,842453,,,,,0,0,0,0
1650450139.476356,public.usertable,773779,112664,1022050304,16893,public,usertable,1,0,1981813,3890618,842710,54724,68931,24363,773779,112664,966365,842710,,,,,0,0,0,0
1650450140.5040772,public.usertable,774013,112676,1022337024,16893,public,usertable,1,0,1982431,3891344,842952,54733,68939,24369,774013,112676,966624,842952,,,,,0,0,0,0
1650450141.5338097,public.usertable,774278,112692,1022697472,16893,public,usertable,1,0,1983208,3891770,843230,54743,68952,24375,774278,112692,966925,843230,,,,,0,0,0,0
1650450142.5645561,public.usertable,774643,112717,1023164416,16893,public,usertable,1,0,1984187,3892522,843604,54762,68961,24388,774643,112717,967327,843604,,,,,0,0,0,0
1650450143.595287,public.usertable,774997,112741,1023598592,16893,public,usertable,1,0,1985140,3892972,843979,54770,68982,24390,774997,112741,967731,843979,,,,,0,0,0,0
1650450144.6233885,public.usertable,775374,112758,1024073728,16893,public,usertable,1,0,1986127,3893254,844366,54783,68992,24399,775374,112758,968141,844366,,,,,0,0,0,0
1650450145.6537762,public.usertable,775736,112774,1024540672,16893,public,usertable,1,0,1986998,3893989,844740,54791,69004,24405,775736,112774,968535,844740,,,,,0,0,0,0
1650450146.6860385,public.usertable,776101,112802,1024999424,16893,public,usertable,1,0,1988054,3894989,845120,54807,69019,24413,776101,112802,968946,845120,,,,,0,0,0,0
1650450147.7143586,public.usertable,776467,112830,1025466368,16893,public,usertable,1,0,1989078,3896275,845508,54816,69041,24417,776467,112830,969365,845508,,,,,0,0,0,0
1650450148.744123,public.usertable,776782,112855,1025875968,16893,public,usertable,1,0,1989863,3896411,845838,54826,69056,24423,776782,112855,969720,845838,,,,,0,0,0,0
1650450149.7746115,public.usertable,777147,112871,1026310144,16893,public,usertable,1,0,1990779,3897326,846214,54834,69067,24427,777147,112871,970115,846214,,,,,0,0,0,0
1650450150.805083,public.usertable,777462,112884,1026686976,16893,public,usertable,1,0,1991557,3897597,846538,54841,69076,24430,777462,112884,970455,846538,,,,,0,0,0,0
1650450151.83417,public.usertable,777768,112899,1027063808,16893,public,usertable,1,0,1992343,3898654,846856,54846,69088,24433,777768,112899,970790,846856,,,,,0,0,0,0
1650450152.8634987,public.usertable,778057,112914,1027407872,16893,public,usertable,1,0,1993124,3899214,847154,54853,69097,24436,778057,112914,971104,847154,,,,,0,0,0,0
1650450153.893905,public.usertable,778357,112930,1027842048,16893,public,usertable,1,0,1993915,3900494,847462,54866,69105,24442,778357,112930,971433,847462,,,,,0,0,0,0
1650450154.9226606,public.usertable,778651,112944,1028194304,16893,public,usertable,1,0,1994677,3901700,847768,54870,69117,24444,778651,112944,971755,847768,,,,,0,0,0,0
1650450155.952042,public.usertable,778965,112967,1028603904,16893,public,usertable,1,0,1995685,3902225,848101,54878,69136,24450,778965,112967,972115,848101,,,,,0,0,0,0
1650450156.9825203,public.usertable,779290,113000,1029054464,16893,public,usertable,1,0,1996614,3902650,848438,54899,69148,24459,779290,113000,972485,848438,,,,,0,0,0,0
1650450158.0130339,public.usertable,779821,113023,1029480448,16893,public,usertable,1,0,1997991,3903583,848979,54913,69158,24465,779821,113023,973050,848979,,,,,0,0,0,0
1650450159.041883,public.usertable,780179,113038,1029914624,16893,public,usertable,1,0,1998827,3904256,849346,54922,69167,24469,780179,113038,973435,849346,,,,,0,0,0,0
1650450160.0733886,public.usertable,780490,113055,1030316032,16893,public,usertable,1,0,1999717,3904519,849665,54931,69175,24474,780490,113055,973771,849665,,,,,0,0,0,0
1650450161.101779,public.usertable,780812,113081,1030725632,16893,public,usertable,1,0,2000646,3905590,850001,54944,69189,24484,780812,113081,974134,850001,,,,,0,0,0,0
1650450162.1305923,public.usertable,781173,113092,1031176192,16893,public,usertable,1,0,2001693,3906426,850377,54956,69204,24493,781173,113092,974537,850377,,,,,0,0,0,0
1650450163.16248,public.usertable,781518,113124,1031626752,16893,public,usertable,1,0,2002687,3906817,850740,54970,69222,24500,781518,113124,974932,850740,,,,,0,0,0,0
1650450164.1920493,public.usertable,781852,113146,1032060928,16893,public,usertable,1,0,2003695,3908026,851092,54980,69240,24509,781852,113146,975312,851092,,,,,0,0,0,0
1650450165.2212412,public.usertable,782201,113179,1032503296,16893,public,usertable,1,0,2004686,3908857,851461,54995,69260,24516,782201,113179,975716,851461,,,,,0,0,0,0
1650450166.2541654,public.usertable,782556,113209,1032978432,16893,public,usertable,1,0,2005684,3909391,851835,55009,69279,24522,782556,113209,976123,851835,,,,,0,0,0,0
1650450167.2833219,public.usertable,782927,113225,1033428992,16893,public,usertable,1,0,2006592,3910273,852219,55017,69292,24526,782927,113225,976528,852219,,,,,0,0,0,0
1650450168.3131647,public.usertable,783295,113246,1033904128,16893,public,usertable,1,0,2007490,3911180,852597,55033,69302,24534,783295,113246,976932,852597,,,,,0,0,0,0
1650450169.3424153,public.usertable,783654,113265,1034354688,16893,public,usertable,1,0,2008405,3912118,852968,55040,69314,24537,783654,113265,977322,852968,,,,,0,0,0,0
1650450170.3737383,public.usertable,784028,113281,1034829824,16893,public,usertable,1,0,2009381,3913531,853350,55052,69322,24543,784028,113281,977724,853350,,,,,0,0,0,0
1650450171.4056017,public.usertable,784376,113315,1035272192,16893,public,usertable,1,0,2010356,3913832,853721,55064,69345,24550,784376,113315,978130,853721,,,,,0,0,0,0
1650450172.4350758,public.usertable,784717,113336,1035714560,16893,public,usertable,1,0,2011213,3914210,854077,55071,69360,24555,784717,113336,978508,854077,,,,,0,0,0,0
1650450173.465303,public.usertable,785077,113351,1036173312,16893,public,usertable,1,0,2012188,3915114,854447,55076,69370,24556,785077,113351,978893,854447,,,,,0,0,0,0
1650450174.4944475,public.usertable,785451,113378,1036656640,16893,public,usertable,1,0,2013305,3916086,854840,55087,69389,24562,785451,113378,979316,854840,,,,,0,0,0,0
1650450175.529022,public.usertable,786032,113407,1037131776,16893,public,usertable,1,0,2014812,3917459,855436,55104,69404,24573,786032,113407,979944,855436,,,,,0,0,0,0
1650450176.5596557,public.usertable,786410,113436,1037623296,16893,public,usertable,1,0,2015905,3918453,855827,55124,69417,24582,786410,113436,980368,855827,,,,,0,0,0,0
1650450177.5903203,public.usertable,786798,113449,1038098432,16893,public,usertable,1,0,2016995,3919325,856223,55134,69425,24588,786798,113449,980782,856223,,,,,0,0,0,0
1650450178.6210368,public.usertable,787197,113465,1038606336,16893,public,usertable,1,0,2018022,3920051,856634,55140,69437,24589,787197,113465,981211,856634,,,,,0,0,0,0
1650450179.6500561,public.usertable,787557,113478,1039032320,16893,public,usertable,1,0,2018941,3920616,857006,55143,69449,24592,787557,113478,981598,857006,,,,,0,0,0,0
1650450180.6782837,public.usertable,787911,113502,1039482880,16893,public,usertable,1,0,2019837,3921473,857371,55156,69460,24598,787911,113502,981987,857371,,,,,0,0,0,0
1650450181.7127104,public.usertable,788301,113523,1039958016,16893,public,usertable,1,0,2020880,3921790,857775,55163,69474,24603,788301,113523,982412,857775,,,,,0,0,0,0
1650450182.743711,public.usertable,788635,113535,1040384000,16893,public,usertable,1,0,2021785,3923474,858117,55173,69482,24607,788635,113535,982772,858117,,,,,0,0,0,0
1650450183.7735534,public.usertable,788977,113557,1040801792,16893,public,usertable,1,0,2022684,3923814,858471,55183,69494,24611,788977,113557,983148,858471,,,,,0,0,0,0
1650450184.804155,public.usertable,789255,113575,1041154048,16893,public,usertable,1,0,2023444,3924465,858755,55197,69500,24617,789255,113575,983452,858755,,,,,0,0,0,0
1650450185.8334646,public.usertable,789531,113586,1041473536,16893,public,usertable,1,0,2024229,3924902,859037,55205,69506,24622,789531,113586,983748,859037,,,,,0,0,0,0
1650450186.8650975,public.usertable,789781,113611,1041801216,16893,public,usertable,1,0,2025029,3925321,859298,55219,69517,24630,789781,113611,984034,859298,,,,,0,0,0,0
1650450187.8937817,public.usertable,790054,113618,1042153472,16893,public,usertable,1,0,2025884,3926261,859581,55224,69527,24631,790054,113618,984332,859581,,,,,0,0,0,0
1650450188.9233468,public.usertable,790363,113635,1042554880,16893,public,usertable,1,0,2026664,3926883,859897,55234,69534,24638,790363,113635,984665,859897,,,,,0,0,0,0
1650450189.9522178,public.usertable,790692,113654,1042980864,16893,public,usertable,1,0,2027627,3927657,860239,55240,69547,24642,790692,113654,985026,860239,,,,,0,0,0,0
1650450190.9815629,public.usertable,791050,113680,1043464192,16893,public,usertable,1,0,2028599,3928303,860615,55248,69565,24647,791050,113680,985428,860615,,,,,0,0,0,0
1650450192.0101905,public.usertable,791451,113704,1043955712,16893,public,usertable,1,0,2029633,3928533,861031,55257,69580,24651,791451,113704,985868,861031,,,,,0,0,0,0
1650450193.0394053,public.usertable,791832,113728,1044455424,16893,public,usertable,1,0,2030547,3929117,861431,55266,69599,24657,791832,113728,986296,861431,,,,,0,0,0,0
1650450194.0693688,public.usertable,792228,113747,1044946944,16893,public,usertable,1,0,2031596,3929959,861837,55275,69609,24661,792228,113747,986721,861837,,,,,0,0,0,0
1650450195.0994751,public.usertable,792628,113759,1045438464,16893,public,usertable,1,0,2032638,3931230,862245,55283,69617,24668,792628,113759,987145,862245,,,,,0,0,0,0
1650450196.1324286,public.usertable,793214,113800,1045929984,16893,public,usertable,1,0,2034301,3932912,862856,55299,69642,24677,793214,113800,987797,862856,,,,,0,0,0,0
1650450197.1629934,public.usertable,793607,113827,1046413312,16893,public,usertable,1,0,2035346,3933794,863264,55311,69657,24683,793607,113827,988232,863264,,,,,0,0,0,0
1650450198.1922383,public.usertable,793990,113850,1046913024,16893,public,usertable,1,0,2036417,3934310,863659,55322,69669,24687,793990,113850,988650,863659,,,,,0,0,0,0
1650450199.226127,public.usertable,794360,113889,1047388160,16893,public,usertable,1,0,2037489,3934725,864049,55341,69689,24697,794360,113889,989079,864049,,,,,0,0,0,0
1650450200.255277,public.usertable,794768,113915,1047896064,16893,public,usertable,1,0,2038570,3935219,864467,55358,69699,24711,794768,113915,989524,864467,,,,,0,0,0,0
1650450201.2838776,public.usertable,795151,113941,1048379392,16893,public,usertable,1,0,2039615,3936119,864869,55371,69718,24718,795151,113941,989958,864869,,,,,0,0,0,0
1650450202.3134978,public.usertable,795538,113969,1048870912,16893,public,usertable,1,0,2040699,3936822,865270,55388,69732,24728,795538,113969,990390,865270,,,,,0,0,0,0
1650450203.3426678,public.usertable,795904,113989,1049354240,16893,public,usertable,1,0,2041810,3937339,865651,55398,69747,24732,795904,113989,990796,865651,,,,,0,0,0,0
1650450204.3750541,public.usertable,796309,114005,1049845760,16893,public,usertable,1,0,2042812,3937597,866068,55402,69759,24733,796309,114005,991229,866068,,,,,0,0,0,0
1650450205.4037337,public.usertable,796676,114027,1050304512,16893,public,usertable,1,0,2043884,3938813,866449,55414,69773,24739,796676,114027,991636,866449,,,,,0,0,0,0
1650450206.4329054,public.usertable,797061,114056,1050812416,16893,public,usertable,1,0,2044970,3940021,866849,55428,69788,24747,797061,114056,992065,866849,,,,,0,0,0,0
1650450207.4621124,public.usertable,797487,114074,1051361280,16893,public,usertable,1,0,2046100,3941024,867286,55441,69799,24752,797487,114074,992526,867286,,,,,0,0,0,0
1650450208.493749,public.usertable,797875,114097,1051844608,16893,public,usertable,1,0,2047192,3942121,867692,55449,69817,24753,797875,114097,992958,867692,,,,,0,0,0,0
1650450209.52261,public.usertable,798271,114119,1052327936,16893,public,usertable,1,0,2048362,3943342,868101,55464,69830,24763,798271,114119,993395,868101,,,,,0,0,0,0
1650450210.5532434,public.usertable,798630,114139,1052762112,16893,public,usertable,1,0,2049270,3943625,868469,55475,69839,24768,798630,114139,993783,868469,,,,,0,0,0,0
1650450211.5837586,public.usertable,798999,114159,1053220864,16893,public,usertable,1,0,2050394,3944220,868849,55487,69850,24776,798999,114159,994186,868849,,,,,0,0,0,0
1650450212.6128776,public.usertable,799376,114183,1053712384,16893,public,usertable,1,0,2051471,3945128,869242,55501,69866,24785,799376,114183,994609,869242,,,,,0,0,0,0
1650450213.6425893,public.usertable,799736,114214,1054171136,16893,public,usertable,1,0,2052531,3945955,869617,55517,69881,24795,799736,114214,995015,869617,,,,,0,0,0,0
1650450214.6749506,public.usertable,800273,114250,1054629888,16893,public,usertable,1,0,2054144,3947178,870179,55537,69906,24804,800273,114250,995622,870179,,,,,0,0,0,0
1650450215.7033155,public.usertable,800663,114275,1055129600,16893,public,usertable,1,0,2055238,3947706,870587,55550,69924,24811,800663,114275,996061,870587,,,,,0,0,0,0
1650450216.734657,public.usertable,801041,114295,1055604736,16893,public,usertable,1,0,2056222,3948516,870977,55564,69936,24821,801041,114295,996477,870977,,,,,0,0,0,0
1650450217.7634447,public.usertable,801431,114315,1056104448,16893,public,usertable,1,0,2057278,3950410,871386,55573,69955,24823,801431,114315,996914,871386,,,,,0,0,0,0
1650450218.7924807,public.usertable,801805,114343,1056571392,16893,public,usertable,1,0,2058305,3950709,871776,55585,69971,24828,801805,114343,997332,871776,,,,,0,0,0,0
1650450219.8211923,public.usertable,802184,114370,1057062912,16893,public,usertable,1,0,2059425,3951876,872173,55598,69989,24837,802184,114370,997760,872173,,,,,0,0,0,0
1650450220.8507037,public.usertable,802637,114383,1057628160,16893,public,usertable,1,0,2060525,3952157,872634,55608,69997,24841,802637,114383,998239,872634,,,,,0,0,0,0
1650450221.880779,public.usertable,803019,114404,1058127872,16893,public,usertable,1,0,2061670,3952990,873035,55621,70016,24846,803019,114404,998672,873035,,,,,0,0,0,0
1650450222.9092052,public.usertable,803455,114428,1058652160,16893,public,usertable,1,0,2062909,3953748,873487,55635,70032,24852,803455,114428,999154,873487,,,,,0,0,0,0
1650450223.9386818,public.usertable,803830,114450,1059135488,16893,public,usertable,1,0,2063986,3955065,873877,55647,70047,24856,803830,114450,999571,873877,,,,,0,0,0,0
1650450224.9671886,public.usertable,804192,114474,1059610624,16893,public,usertable,1,0,2065053,3956370,874255,55661,70063,24865,804192,114474,999979,874255,,,,,0,0,0,0
1650450225.9981492,public.usertable,804566,114495,1060069376,16893,public,usertable,1,0,2066198,3956818,874644,55670,70078,24869,804566,114495,1000392,874644,,,,,0,0,0,0
1650450227.027206,public.usertable,804938,114518,1060552704,16893,public,usertable,1,0,2067183,3957618,875031,55681,70093,24875,804938,114518,1000805,875031,,,,,0,0,0,0
1650450228.0573018,public.usertable,805360,114543,1061068800,16893,public,usertable,1,0,2068206,3957967,875468,55693,70108,24881,805360,114543,1001269,875468,,,,,0,0,0,0
1650450229.0860248,public.usertable,805751,114568,1061568512,16893,public,usertable,1,0,2069251,3958431,875874,55703,70123,24886,805751,114568,1001700,875874,,,,,0,0,0,0
1650450230.1145346,public.usertable,806153,114589,1062076416,16893,public,usertable,1,0,2070340,3958853,876288,55712,70135,24893,806153,114589,1002135,876288,,,,,0,0,0,0
1650450231.1437366,public.usertable,806541,114596,1062559744,16893,public,usertable,1,0,2071385,3960025,876688,55721,70147,24897,806541,114596,1002556,876688,,,,,0,0,0,0
1650450232.1721783,public.usertable,806926,114624,1063043072,16893,public,usertable,1,0,2072542,3960599,877092,55730,70166,24902,806926,114624,1002988,877092,,,,,0,0,0,0
1650450233.203336,public.usertable,807507,114669,1063542784,16893,public,usertable,1,0,2074148,3961398,877699,55750,70192,24915,807507,114669,1003641,877699,,,,,0,0,0,0
1650450234.2321346,public.usertable,807900,114694,1064042496,16893,public,usertable,1,0,2075203,3961759,878106,55762,70206,24923,807900,114694,1004074,878106,,,,,0,0,0,0
1650450235.2618198,public.usertable,808282,114724,1064525824,16893,public,usertable,1,0,2076255,3962005,878506,55776,70224,24932,808282,114724,1004506,878506,,,,,0,0,0,0
1650450236.2901514,public.usertable,808655,114760,1065009152,16893,public,usertable,1,0,2077338,3963433,878897,55795,70242,24941,808655,114760,1004934,878897,,,,,0,0,0,0
1650450237.3196564,public.usertable,809047,114780,1065500672,16893,public,usertable,1,0,2078495,3964130,879304,55805,70257,24947,809047,114780,1005366,879304,,,,,0,0,0,0
1650450238.3484259,public.usertable,809423,114801,1065984000,16893,public,usertable,1,0,2079474,3965555,879696,55817,70273,24953,809423,114801,1005786,879696,,,,,0,0,0,0
1650450239.3783298,public.usertable,809802,114826,1066467328,16893,public,usertable,1,0,2080512,3965815,880089,55828,70287,24959,809802,114826,1006204,880089,,,,,0,0,0,0
1650450240.4067943,public.usertable,810213,114839,1066975232,16893,public,usertable,1,0,2081535,3966920,880508,55835,70295,24963,810213,114839,1006638,880508,,,,,0,0,0,0
1650450241.4353557,public.usertable,810567,114858,1067417600,16893,public,usertable,1,0,2082500,3967725,880873,55846,70306,24966,810567,114858,1007025,880873,,,,,0,0,0,0
1650450242.463536,public.usertable,810928,114884,1067876352,16893,public,usertable,1,0,2083575,3968121,881251,55855,70323,24971,810928,114884,1007429,881251,,,,,0,0,0,0
1650450243.491487,public.usertable,811274,114916,1068326912,16893,public,usertable,1,0,2084684,3969009,881614,55870,70340,24980,811274,114916,1007824,881614,,,,,0,0,0,0
1650450244.5199952,public.usertable,811654,114935,1068793856,16893,public,usertable,1,0,2085708,3970242,882005,55885,70351,24993,811654,114935,1008241,882005,,,,,0,0,0,0
1650450245.5491393,public.usertable,812021,114954,1069268992,16893,public,usertable,1,0,2086671,3970964,882388,55895,70367,24998,812021,114954,1008650,882388,,,,,0,0,0,0
1650450246.5800276,public.usertable,812401,114978,1069776896,16893,public,usertable,1,0,2087717,3971817,882790,55905,70389,25003,812401,114978,1009084,882790,,,,,0,0,0,0
1650450247.608475,public.usertable,812825,115001,1070317568,16893,public,usertable,1,0,2088798,3972834,883229,55916,70404,25007,812825,115001,1009549,883229,,,,,0,0,0,0
1650450248.6390424,public.usertable,813265,115025,1070850048,16893,public,usertable,1,0,2089825,3973209,883685,55928,70420,25012,813265,115025,1010033,883685,,,,,0,0,0,0
1650450249.668665,public.usertable,813659,115042,1071366144,16893,public,usertable,1,0,2090942,3974609,884098,55941,70439,25021,813659,115042,1010478,884098,,,,,0,0,0,0
1650450250.6987479,public.usertable,814081,115063,1071865856,16893,public,usertable,1,0,2092111,3975508,884529,55954,70448,25028,814081,115063,1010931,884529,,,,,0,0,0,0
1650450251.7286866,public.usertable,814697,115089,1072398336,16893,public,usertable,1,0,2093947,3976902,885161,55970,70464,25036,814697,115089,1011595,885161,,,,,0,0,0,0
1650450252.7585397,public.usertable,815090,115112,1072898048,16893,public,usertable,1,0,2095082,3978475,885568,55981,70478,25041,815090,115112,1012027,885568,,,,,0,0,0,0
1650450253.7888446,public.usertable,815505,115131,1073414144,16893,public,usertable,1,0,2096263,3978885,885997,55989,70492,25048,815505,115131,1012478,885997,,,,,0,0,0,0
1650450254.817809,public.usertable,815896,115160,1073913856,16893,public,usertable,1,0,2097341,3979321,886402,56006,70506,25053,815896,115160,1012914,886402,,,,,0,0,0,0
1650450255.8486464,public.usertable,816252,115178,1074364416,16893,public,usertable,1,0,2098359,3980464,886770,56019,70518,25059,816252,115178,1013307,886770,,,,,0,0,0,0
1650450256.877694,public.usertable,816628,115204,1074847744,16893,public,usertable,1,0,2099414,3981140,887160,56031,70532,25061,816628,115204,1013723,887160,,,,,0,0,0,0
1650450257.9057984,public.usertable,816992,115224,1075314688,16893,public,usertable,1,0,2100389,3981436,887535,56040,70543,25064,816992,115224,1014118,887535,,,,,0,0,0,0
1650450258.935616,public.usertable,817373,115240,1075789824,16893,public,usertable,1,0,2101474,3983216,887930,56055,70557,25072,817373,115240,1014542,887930,,,,,0,0,0,0
1650450259.965701,public.usertable,817731,115270,1076248576,16893,public,usertable,1,0,2102506,3983517,888308,56065,70577,25075,817731,115270,1014950,888308,,,,,0,0,0,0
1650450260.9944813,public.usertable,818110,115301,1076740096,16893,public,usertable,1,0,2103479,3984021,888708,56077,70598,25084,818110,115301,1015383,888708,,,,,0,0,0,0
1650450262.025398,public.usertable,818529,115333,1077288960,16893,public,usertable,1,0,2104458,3984887,889151,56088,70622,25090,818529,115333,1015861,889151,,,,,0,0,0,0
1650450263.0549326,public.usertable,818933,115361,1077813248,16893,public,usertable,1,0,2105586,3985391,889578,56095,70645,25092,818933,115361,1016318,889578,,,,,0,0,0,0
1650450264.0886176,public.usertable,819355,115382,1078337536,16893,public,usertable,1,0,2106817,3986089,890012,56107,70657,25099,819355,115382,1016776,890012,,,,,0,0,0,0
1650450265.117055,public.usertable,819764,115409,1078853632,16893,public,usertable,1,0,2107962,3986623,890439,56116,70675,25103,819764,115409,1017230,890439,,,,,0,0,0,0
1650450266.1458278,public.usertable,820173,115446,1079386112,16893,public,usertable,1,0,2109057,3987542,890868,56133,70695,25114,820173,115446,1017696,890868,,,,,0,0,0,0
1650450267.1765084,public.usertable,820605,115456,1079918592,16893,public,usertable,1,0,2110325,3988864,891312,56141,70707,25121,820605,115456,1018160,891312,,,,,0,0,0,0
1650450268.2073808,public.usertable,821039,115484,1080459264,16893,public,usertable,1,0,2111568,3989119,891759,56159,70720,25130,821039,115484,1018638,891759,,,,,0,0,0,0
1650450269.2384677,public.usertable,821459,115506,1080999936,16893,public,usertable,1,0,2112723,3990113,892199,56166,70740,25133,821459,115506,1019105,892199,,,,,0,0,0,0
1650450270.2685268,public.usertable,822082,115543,1081524224,16893,public,usertable,1,0,2114402,3991624,892841,56188,70759,25144,822082,115543,1019788,892841,,,,,0,0,0,0
1650450271.3003666,public.usertable,822474,115556,1082015744,16893,public,usertable,1,0,2115288,3992134,893247,56197,70773,25149,822474,115556,1020217,893247,,,,,0,0,0,0
1650450272.3288562,public.usertable,822905,115581,1082556416,16893,public,usertable,1,0,2116367,3993834,893688,56213,70783,25158,822905,115581,1020684,893688,,,,,0,0,0,0
1650450273.3583715,public.usertable,823324,115604,1083072512,16893,public,usertable,1,0,2117411,3995025,894125,56222,70801,25164,823324,115604,1021148,894125,,,,,0,0,0,0
1650450274.3869114,public.usertable,823739,115626,1083613184,16893,public,usertable,1,0,2118515,3995588,894556,56236,70817,25171,823739,115626,1021609,894556,,,,,0,0,0,0
1650450275.4178214,public.usertable,824154,115642,1084129280,16893,public,usertable,1,0,2119578,3996388,894987,56241,70833,25174,824154,115642,1022061,894987,,,,,0,0,0,0
1650450276.44988,public.usertable,824586,115657,1084661760,16893,public,usertable,1,0,2120706,3996875,895432,56244,70846,25176,824586,115657,1022522,895432,,,,,0,0,0,0
1650450277.4792414,public.usertable,825005,115678,1085169664,16893,public,usertable,1,0,2121777,3997289,895863,56253,70858,25182,825005,115678,1022974,895863,,,,,0,0,0,0
1650450278.5074053,public.usertable,825374,115694,1085636608,16893,public,usertable,1,0,2122927,3998187,896245,56261,70871,25186,825374,115694,1023377,896245,,,,,0,0,0,0
1650450279.5372293,public.usertable,825756,115711,1086128128,16893,public,usertable,1,0,2124016,3998926,896641,56268,70885,25189,825756,115711,1023794,896641,,,,,0,0,0,0
1650450280.5667028,public.usertable,826155,115732,1086636032,16893,public,usertable,1,0,2125155,3999385,897055,56274,70900,25192,826155,115732,1024229,897055,,,,,0,0,0,0
1650450281.5975254,public.usertable,826570,115753,1087152128,16893,public,usertable,1,0,2126236,4000196,897484,56285,70914,25197,826570,115753,1024683,897484,,,,,0,0,0,0
1650450282.626961,public.usertable,826983,115773,1087676416,16893,public,usertable,1,0,2127424,4001104,897902,56301,70919,25201,826983,115773,1025122,897902,,,,,0,0,0,0
1650450283.6582785,public.usertable,827384,115798,1088184320,16893,public,usertable,1,0,2128594,4001981,898319,56313,70935,25207,827384,115798,1025567,898319,,,,,0,0,0,0
1650450284.689044,public.usertable,827801,115814,1088708608,16893,public,usertable,1,0,2129681,4002811,898748,56326,70947,25214,827801,115814,1026021,898748,,,,,0,0,0,0
1650450285.720343,public.usertable,828222,115835,1089232896,16893,public,usertable,1,0,2130884,4003759,899182,56337,70960,25223,828222,115835,1026479,899182,,,,,0,0,0,0
1650450286.7506247,public.usertable,828618,115867,1089699840,16893,public,usertable,1,0,2132023,4004661,899596,56351,70978,25230,828618,115867,1026925,899596,,,,,0,0,0,0
1650450287.7796555,public.usertable,828981,115892,1090207744,16893,public,usertable,1,0,2133051,4005296,899976,56360,70995,25234,828981,115892,1027331,899976,,,,,0,0,0,0
1650450288.8096378,public.usertable,829608,115921,1090732032,16893,public,usertable,1,0,2134750,4006713,900621,56373,71013,25242,829608,115921,1028007,900621,,,,,0,0,0,0
1650450289.8383777,public.usertable,830030,115938,1091256320,16893,public,usertable,1,0,2135812,4007477,901056,56382,71026,25244,830030,115938,1028464,901056,,,,,0,0,0,0
1650450290.867154,public.usertable,830441,115960,1091780608,16893,public,usertable,1,0,2136871,4008152,901481,56394,71040,25248,830441,115960,1028915,901481,,,,,0,0,0,0
1650450291.8981504,public.usertable,830847,115984,1092296704,16893,public,usertable,1,0,2138027,4008755,901903,56408,71056,25255,830847,115984,1029367,901903,,,,,0,0,0,0
1650450292.928743,public.usertable,831237,116012,1092788224,16893,public,usertable,1,0,2139244,4009267,902312,56419,71075,25261,831237,116012,1029806,902312,,,,,0,0,0,0
1650450293.957465,public.usertable,831661,116029,1093304320,16893,public,usertable,1,0,2140410,4010141,902752,56422,71091,25263,831661,116029,1030265,902752,,,,,0,0,0,0
1650450294.9877608,public.usertable,832031,116060,1093812224,16893,public,usertable,1,0,2141513,4010690,903149,56432,71118,25268,832031,116060,1030699,903149,,,,,0,0,0,0
1650450296.020152,public.usertable,832424,116079,1094311936,16893,public,usertable,1,0,2142662,4011675,903557,56441,71133,25273,832424,116079,1031131,903557,,,,,0,0,0,0
1650450297.0515294,public.usertable,832819,116103,1094787072,16893,public,usertable,1,0,2143748,4012154,903969,56451,71150,25278,832819,116103,1031570,903969,,,,,0,0,0,0
1650450298.0849216,public.usertable,833186,116128,1095270400,16893,public,usertable,1,0,2144741,4012537,904351,56461,71165,25284,833186,116128,1031977,904351,,,,,0,0,0,0
1650450299.1135228,public.usertable,833581,116152,1095753728,16893,public,usertable,1,0,2145798,4013211,904762,56472,71181,25293,833581,116152,1032415,904762,,,,,0,0,0,0
1650450300.1435804,public.usertable,833974,116183,1096261632,16893,public,usertable,1,0,2146942,4013384,905170,56488,71196,25304,833974,116183,1032854,905170,,,,,0,0,0,0
1650450301.172767,public.usertable,834368,116215,1096777728,16893,public,usertable,1,0,2148025,4014034,905577,56507,71209,25314,834368,116215,1033293,905577,,,,,0,0,0,0
1650450302.2045667,public.usertable,834801,116234,1097310208,16893,public,usertable,1,0,2149127,4014592,906022,56517,71221,25322,834801,116234,1033760,906022,,,,,0,0,0,0
1650450303.2327025,public.usertable,835211,116259,1097826304,16893,public,usertable,1,0,2150220,4015346,906448,56530,71237,25327,835211,116259,1034215,906448,,,,,0,0,0,0
1650450304.2608535,public.usertable,835627,116277,1098342400,16893,public,usertable,1,0,2151305,4015707,906875,56538,71248,25332,835627,116277,1034661,906875,,,,,0,0,0,0
1650450305.291043,public.usertable,836025,116302,1098842112,16893,public,usertable,1,0,2152407,4016351,907295,56545,71270,25336,836025,116302,1035110,907295,,,,,0,0,0,0
1650450306.3211052,public.usertable,836423,116315,1099366400,16893,public,usertable,1,0,2153483,4017583,907702,56553,71279,25339,836423,116315,1035534,907702,,,,,0,0,0,0
1650450307.3514285,public.usertable,837009,116366,1099841536,16893,public,usertable,1,0,2155206,4019104,908316,56580,71307,25357,837009,116366,1036203,908316,,,,,0,0,0,0
1650450308.382142,public.usertable,837402,116391,1100341248,16893,public,usertable,1,0,2156289,4019320,908726,56590,71324,25365,837402,116391,1036640,908726,,,,,0,0,0,0
1650450309.412114,public.usertable,837790,116420,1100816384,16893,public,usertable,1,0,2157407,4020184,909130,56603,71340,25371,837790,116420,1037073,909130,,,,,0,0,0,0
1650450310.4408598,public.usertable,838182,116439,1101307904,16893,public,usertable,1,0,2158533,4021229,909534,56612,71352,25375,838182,116439,1037498,909534,,,,,0,0,0,0
1650450311.4715219,public.usertable,838591,116457,1101832192,16893,public,usertable,1,0,2159607,4022103,909961,56625,71370,25382,838591,116457,1037956,909961,,,,,0,0,0,0
1650450312.5002637,public.usertable,839025,116472,1102372864,16893,public,usertable,1,0,2160692,4023351,910407,56633,71382,25384,839025,116472,1038422,910407,,,,,0,0,0,0
1650450313.5317795,public.usertable,839456,116496,1102905344,16893,public,usertable,1,0,2161833,4023679,910853,56643,71397,25391,839456,116496,1038893,910853,,,,,0,0,0,0
1650450314.5614076,public.usertable,839846,116518,1103405056,16893,public,usertable,1,0,2162880,4024055,911252,56656,71406,25399,839846,116518,1039314,911252,,,,,0,0,0,0
1650450315.5925238,public.usertable,840256,116535,1103904768,16893,public,usertable,1,0,2163978,4024596,911673,56670,71417,25403,840256,116535,1039760,911673,,,,,0,0,0,0
1650450316.623461,public.usertable,840654,116551,1104412672,16893,public,usertable,1,0,2164984,4025150,912082,56678,71428,25407,840654,116551,1040188,912082,,,,,0,0,0,0
1650450317.6517296,public.usertable,841017,116577,1104871424,16893,public,usertable,1,0,2165957,4025644,912460,56690,71443,25413,841017,116577,1040593,912460,,,,,0,0,0,0
1650450318.682783,public.usertable,841404,116606,1105371136,16893,public,usertable,1,0,2167091,4026599,912860,56707,71456,25419,841404,116606,1041023,912860,,,,,0,0,0,0
1650450319.7124934,public.usertable,841815,116617,1105854464,16893,public,usertable,1,0,2168170,4027565,913279,56712,71464,25423,841815,116617,1041455,913279,,,,,0,0,0,0
1650450320.7421257,public.usertable,842206,116641,1106370560,16893,public,usertable,1,0,2169194,4028058,913682,56725,71476,25428,842206,116641,1041883,913682,,,,,0,0,0,0
1650450321.7721112,public.usertable,842597,116661,1106862080,16893,public,usertable,1,0,2170336,4029364,914093,56729,71496,25431,842597,116661,1042318,914093,,,,,0,0,0,0
1650450322.8009818,public.usertable,842979,116686,1107361792,16893,public,usertable,1,0,2171397,4029877,914491,56739,71512,25436,842979,116686,1042742,914491,,,,,0,0,0,0
1650450323.8292534,public.usertable,843400,116701,1107845120,16893,public,usertable,1,0,2172540,4030867,914920,56748,71520,25440,843400,116701,1043188,914920,,,,,0,0,0,0
1650450324.8578491,public.usertable,843772,116738,1108336640,16893,public,usertable,1,0,2173706,4032178,915314,56768,71542,25452,843772,116738,1043624,915314,,,,,0,0,0,0
1650450325.8904533,public.usertable,844124,116756,1108795392,16893,public,usertable,1,0,2174565,4032564,915677,56777,71553,25454,844124,116756,1044007,915677,,,,,0,0,0,0
1650450326.9194567,public.usertable,844551,116775,1109352448,16893,public,usertable,1,0,2175692,4033236,916116,56786,71565,25462,844551,116775,1044467,916116,,,,,0,0,0,0
1650450327.9546459,public.usertable,845169,116799,1109852160,16893,public,usertable,1,0,2177384,4034895,916751,56798,71582,25467,845169,116799,1045131,916751,,,,,0,0,0,0
1650450328.9860866,public.usertable,845509,116809,1110269952,16893,public,usertable,1,0,2178270,4036386,917101,56808,71592,25473,845509,116809,1045501,917101,,,,,0,0,0,0
1650450330.0149727,public.usertable,845872,116829,1110736896,16893,public,usertable,1,0,2179298,4037627,917479,56818,71607,25478,845872,116829,1045904,917479,,,,,0,0,0,0
1650450331.0444853,public.usertable,846247,116853,1111220224,16893,public,usertable,1,0,2180319,4038545,917867,56830,71620,25483,846247,116853,1046317,917867,,,,,0,0,0,0
1650450332.0731134,public.usertable,846616,116882,1111687168,16893,public,usertable,1,0,2181400,4039136,918253,56842,71637,25486,846616,116882,1046732,918253,,,,,0,0,0,0
1650450333.1032896,public.usertable,847005,116900,1112186880,16893,public,usertable,1,0,2182445,4040027,918656,56851,71651,25489,847005,116900,1047158,918656,,,,,0,0,0,0
1650450334.1326525,public.usertable,847399,116921,1112686592,16893,public,usertable,1,0,2183546,4041575,919065,56860,71666,25494,847399,116921,1047591,919065,,,,,0,0,0,0
1650450335.162639,public.usertable,847785,116939,1113178112,16893,public,usertable,1,0,2184661,4043612,919465,56874,71680,25503,847785,116939,1048019,919465,,,,,0,0,0,0
1650450336.1913805,public.usertable,848192,116970,1113694208,16893,public,usertable,1,0,2185837,4044175,919891,56886,71699,25509,848192,116970,1048476,919891,,,,,0,0,0,0
1650450337.2207541,public.usertable,848581,117001,1114193920,16893,public,usertable,1,0,2186904,4045045,920302,56900,71721,25516,848581,117001,1048923,920302,,,,,0,0,0,0
1650450338.24977,public.usertable,849003,117022,1114710016,16893,public,usertable,1,0,2188071,4045621,920733,56912,71730,25525,849003,117022,1049375,920733,,,,,0,0,0,0
1650450339.2794895,public.usertable,849395,117049,1115209728,16893,public,usertable,1,0,2189203,4046486,921140,56926,71745,25534,849395,117049,1049811,921140,,,,,0,0,0,0
1650450340.3081014,public.usertable,849794,117070,1115725824,16893,public,usertable,1,0,2190535,4047784,921557,56935,71763,25538,849794,117070,1050255,921557,,,,,0,0,0,0
1650450341.3442504,public.usertable,850203,117101,1116258304,16893,public,usertable,1,0,2191625,4048136,921980,56956,71777,25548,850203,117101,1050713,921980,,,,,0,0,0,0
1650450342.3734121,public.usertable,850626,117122,1116782592,16893,public,usertable,1,0,2192787,4048627,922416,56967,71790,25551,850626,117122,1051173,922416,,,,,0,0,0,0
1650450343.403974,public.usertable,851025,117141,1117298688,16893,public,usertable,1,0,2193939,4049663,922831,56980,71806,25559,851025,117141,1051617,922831,,,,,0,0,0,0
1650450344.4352982,public.usertable,851441,117155,1117814784,16893,public,usertable,1,0,2195046,4050808,923258,56992,71817,25564,851441,117155,1052067,923258,,,,,0,0,0,0
1650450345.465631,public.usertable,852085,117185,1118363648,16893,public,usertable,1,0,2196727,4051635,923927,57001,71842,25568,852085,117185,1052770,923927,,,,,0,0,0,0
1650450346.4982805,public.usertable,852525,117205,1118904320,16893,public,usertable,1,0,2197801,4052260,924375,57016,71850,25575,852525,117205,1053241,924375,,,,,0,0,0,0
1650450347.527577,public.usertable,852743,117214,1119363072,16893,public,usertable,1,0,2198380,4052382,924600,57018,71857,25576,852743,117214,1053475,924600,,,,,0,0,0,0
1650450348.559722,public.usertable,853085,117237,1119698944,16893,public,usertable,1,0,2199357,4052975,924954,57029,71869,25581,853085,117237,1053852,924954,,,,,0,0,0,0
1650450349.589417,public.usertable,853504,117260,1120223232,16893,public,usertable,1,0,2200466,4053822,925389,57041,71885,25586,853504,117260,1054315,925389,,,,,0,0,0,0
1650450350.6187856,public.usertable,853897,117286,1120739328,16893,public,usertable,1,0,2201591,4054604,925800,57054,71903,25593,853897,117286,1054757,925800,,,,,0,0,0,0
1650450351.6481247,public.usertable,854321,117318,1121271808,16893,public,usertable,1,0,2202821,4055454,926237,57076,71916,25605,854321,117318,1055229,926237,,,,,0,0,0,0
1650450352.6785638,public.usertable,854729,117339,1121787904,16893,public,usertable,1,0,2203923,4056012,926657,57088,71928,25612,854729,117339,1055673,926657,,,,,0,0,0,0
1650450353.7092655,public.usertable,855146,117363,1122312192,16893,public,usertable,1,0,2205096,4056995,927091,57098,71945,25615,855146,117363,1056134,927091,,,,,0,0,0,0
1650450354.739507,public.usertable,855571,117382,1122836480,16893,public,usertable,1,0,2206240,4057611,927527,57106,71956,25618,855571,117382,1056589,927527,,,,,0,0,0,0
1650450355.768651,public.usertable,856000,117391,1123344384,16893,public,usertable,1,0,2207323,4058876,927963,57113,71963,25622,856000,117391,1057039,927963,,,,,0,0,0,0
1650450356.798177,public.usertable,856350,117410,1123745792,16893,public,usertable,1,0,2208227,4059695,928321,57126,71971,25628,856350,117410,1057418,928321,,,,,0,0,0,0
1650450357.8281941,public.usertable,856675,117428,1124179968,16893,public,usertable,1,0,2209016,4059994,928653,57137,71978,25632,856675,117428,1057768,928653,,,,,0,0,0,0
1650450358.8562644,public.usertable,857173,117456,1124589568,16893,public,usertable,1,0,2210407,4060690,929166,57151,71993,25638,857173,117456,1058310,929166,,,,,0,0,0,0
1650450359.8869503,public.usertable,857417,117476,1124884480,16893,public,usertable,1,0,2211118,4060978,929423,57158,72006,25642,857417,117476,1058587,929423,,,,,0,0,0,0
1650450360.9167147,public.usertable,857662,117491,1125203968,16893,public,usertable,1,0,2211783,4061402,929679,57162,72017,25646,857662,117491,1058858,929679,,,,,0,0,0,0
1650450361.9456604,public.usertable,857961,117503,1125548032,16893,public,usertable,1,0,2212532,4061969,929986,57168,72025,25652,857961,117503,1059179,929986,,,,,0,0,0,0
1650450362.9737499,public.usertable,858287,117520,1125982208,16893,public,usertable,1,0,2213382,4062691,930320,57177,72033,25656,858287,117520,1059530,930320,,,,,0,0,0,0
1650450364.0029497,public.usertable,858610,117536,1126375424,16893,public,usertable,1,0,2214255,4063199,930650,57188,72040,25660,858610,117536,1059878,930650,,,,,0,0,0,0
1650450365.0324023,public.usertable,858952,117551,1126793216,16893,public,usertable,1,0,2215208,4063508,931003,57196,72051,25663,858952,117551,1060250,931003,,,,,0,0,0,0
1650450366.0614092,public.usertable,859267,117571,1127227392,16893,public,usertable,1,0,2216151,4064329,931328,57209,72061,25669,859267,117571,1060598,931328,,,,,0,0,0,0
1650450367.0906959,public.usertable,859679,117590,1127735296,16893,public,usertable,1,0,2217378,4065441,931752,57218,72073,25673,859679,117590,1061043,931752,,,,,0,0,0,0
1650450368.119992,public.usertable,860081,117610,1128251392,16893,public,usertable,1,0,2218519,4066282,932173,57227,72092,25679,860081,117610,1061492,932173,,,,,0,0,0,0
1650450369.1497712,public.usertable,860502,117626,1128734720,16893,public,usertable,1,0,2219614,4067119,932602,57235,72100,25683,860502,117626,1061937,932602,,,,,0,0,0,0
1650450370.1807299,public.usertable,860899,117640,1129234432,16893,public,usertable,1,0,2220731,4068314,933013,57245,72114,25690,860899,117640,1062372,933013,,,,,0,0,0,0
1650450371.2091212,public.usertable,861316,117659,1129783296,16893,public,usertable,1,0,2221818,4069292,933442,57255,72126,25697,861316,117659,1062823,933442,,,,,0,0,0,0
1650450372.2386382,public.usertable,861730,117682,1130291200,16893,public,usertable,1,0,2222952,4070193,933875,57261,72145,25700,861730,117682,1063281,933875,,,,,0,0,0,0
1650450373.2677393,public.usertable,862112,117709,1130799104,16893,public,usertable,1,0,2224037,4071304,934273,57273,72161,25707,862112,117709,1063707,934273,,,,,0,0,0,0
1650450374.297542,public.usertable,862541,117737,1131315200,16893,public,usertable,1,0,2225208,4071614,934715,57291,72174,25715,862541,117737,1064180,934715,,,,,0,0,0,0
1650450375.3297179,public.usertable,862910,117756,1131732992,16893,public,usertable,1,0,2226301,4071964,935101,57299,72191,25721,862910,117756,1064591,935101,,,,,0,0,0,0
1650450376.3592098,public.usertable,863191,117775,1132109824,16893,public,usertable,1,0,2227086,4072762,935394,57309,72203,25727,863191,117775,1064906,935394,,,,,0,0,0,0
1650450377.3909504,public.usertable,863520,117789,1132535808,16893,public,usertable,1,0,2228036,4073693,935730,57319,72210,25735,863520,117789,1065259,935730,,,,,0,0,0,0
1650450378.4211392,public.usertable,863884,117804,1132945408,16893,public,usertable,1,0,2229003,4075108,936105,57328,72221,25739,863884,117804,1065654,936105,,,,,0,0,0,0
1650450379.451526,public.usertable,864150,117818,1133289472,16893,public,usertable,1,0,2229699,4075711,936380,57334,72230,25741,864150,117818,1065944,936380,,,,,0,0,0,0
1650450380.4799392,public.usertable,864698,117848,1133805568,16893,public,usertable,1,0,2231237,4076967,936945,57348,72247,25750,864698,117848,1066540,936945,,,,,0,0,0,0
1650450381.5089233,public.usertable,865107,117863,1134313472,16893,public,usertable,1,0,2232278,4077847,937359,57362,72252,25757,865107,117863,1066973,937359,,,,,0,0,0,0
1650450382.5383976,public.usertable,865523,117879,1134829568,16893,public,usertable,1,0,2233441,4078424,937786,57370,72263,25762,865523,117879,1067419,937786,,,,,0,0,0,0
1650450383.5672827,public.usertable,865924,117896,1135329280,16893,public,usertable,1,0,2234419,4079026,938199,57377,72275,25767,865924,117896,1067851,938199,,,,,0,0,0,0
1650450384.5972836,public.usertable,866341,117923,1135853568,16893,public,usertable,1,0,2235583,4079399,938630,57391,72289,25777,866341,117923,1068310,938630,,,,,0,0,0,0
1650450385.6314712,public.usertable,866745,117938,1136353280,16893,public,usertable,1,0,2236705,4080446,939045,57399,72300,25781,866745,117938,1068744,939045,,,,,0,0,0,0
1650450386.661714,public.usertable,867152,117962,1136869376,16893,public,usertable,1,0,2237716,4081069,939466,57410,72314,25787,867152,117962,1069190,939466,,,,,0,0,0,0
1650450387.690175,public.usertable,867574,117982,1137393664,16893,public,usertable,1,0,2238943,4081493,939907,57414,72333,25789,867574,117982,1069654,939907,,,,,0,0,0,0
1650450388.719625,public.usertable,867952,117999,1137860608,16893,public,usertable,1,0,2240013,4082156,940299,57420,72347,25791,867952,117999,1070066,940299,,,,,0,0,0,0
1650450389.750393,public.usertable,868302,118020,1138302976,16893,public,usertable,1,0,2241007,4083334,940667,57429,72365,25797,868302,118020,1070461,940667,,,,,0,0,0,0
1650450390.779434,public.usertable,868675,118040,1138761728,16893,public,usertable,1,0,2242007,4083456,941053,57436,72378,25802,868675,118040,1070867,941053,,,,,0,0,0,0
1650450391.8099241,public.usertable,868988,118051,1139163136,16893,public,usertable,1,0,2242773,4084948,941370,57445,72382,25808,868988,118051,1071197,941370,,,,,0,0,0,0
1650450392.8403952,public.usertable,869364,118069,1139621888,16893,public,usertable,1,0,2243659,4085334,941754,57455,72390,25815,869364,118069,1071599,941754,,,,,0,0,0,0
1650450393.8721325,public.usertable,869707,118090,1140015104,16893,public,usertable,1,0,2244566,4085838,942111,57464,72404,25817,869707,118090,1071979,942111,,,,,0,0,0,0
1650450394.9006543,public.usertable,869955,118106,1140326400,16893,public,usertable,1,0,2245218,4086569,942370,57472,72415,25822,869955,118106,1072257,942370,,,,,0,0,0,0
1650450395.9297397,public.usertable,870194,118127,1140604928,16893,public,usertable,1,0,2245945,4087025,942620,57483,72426,25832,870194,118127,1072529,942620,,,,,0,0,0,0
1650450396.959293,public.usertable,870441,118143,1140948992,16893,public,usertable,1,0,2246596,4087140,942872,57494,72431,25840,870441,118143,1072797,942872,,,,,0,0,0,0
1650450397.9881272,public.usertable,870745,118157,1141317632,16893,public,usertable,1,0,2247262,4087405,943183,57501,72438,25842,870745,118157,1073122,943183,,,,,0,0,0,0
1650450399.0155869,public.usertable,871005,118174,1141661696,16893,public,usertable,1,0,2248068,4087538,943457,57504,72452,25844,871005,118174,1073413,943457,,,,,0,0,0,0
1650450400.0438366,public.usertable,871511,118202,1142120448,16893,public,usertable,1,0,2249321,4088426,943977,57520,72466,25850,871511,118202,1073963,943977,,,,,0,0,0,0
1650450401.0750034,public.usertable,871892,118212,1142587392,16893,public,usertable,1,0,2250387,4089159,944361,57530,72469,25856,871892,118212,1074360,944361,,,,,0,0,0,0
1650450402.103852,public.usertable,872258,118235,1143046144,16893,public,usertable,1,0,2251480,4089327,944741,57539,72483,25863,872258,118235,1074763,944741,,,,,0,0,0,0
1650450403.1332154,public.usertable,872622,118253,1143513088,16893,public,usertable,1,0,2252479,4090602,945123,57547,72501,25868,872622,118253,1075171,945123,,,,,0,0,0,0
1650450404.164834,public.usertable,872990,118272,1143971840,16893,public,usertable,1,0,2253420,4091825,945505,57557,72515,25873,872990,118272,1075577,945505,,,,,0,0,0,0
1650450405.193826,public.usertable,873373,118290,1144455168,16893,public,usertable,1,0,2254551,4092888,945894,57571,72521,25879,873373,118290,1075986,945894,,,,,0,0,0,0
1650450406.2232418,public.usertable,873759,118311,1144930304,16893,public,usertable,1,0,2255671,4093713,946288,57585,72529,25889,873759,118311,1076402,946288,,,,,0,0,0,0
1650450407.252934,public.usertable,874117,118330,1145372672,16893,public,usertable,1,0,2256749,4094734,946659,57600,72542,25897,874117,118330,1076801,946659,,,,,0,0,0,0
1650450408.2838242,public.usertable,874492,118349,1145847808,16893,public,usertable,1,0,2257844,4096515,947048,57609,72556,25904,874492,118349,1077213,947048,,,,,0,0,0,0
1650450409.3121638,public.usertable,874861,118371,1146298368,16893,public,usertable,1,0,2258891,4097336,947430,57618,72569,25911,874861,118371,1077617,947430,,,,,0,0,0,0
1650450410.3428345,public.usertable,875175,118399,1146724352,16893,public,usertable,1,0,2259813,4097794,947756,57634,72581,25916,875175,118399,1077971,947756,,,,,0,0,0,0
1650450411.3722477,public.usertable,875557,118410,1147191296,16893,public,usertable,1,0,2260792,4098718,948147,57645,72590,25923,875557,118410,1078382,948147,,,,,0,0,0,0
1650450412.403848,public.usertable,875932,118424,1147666432,16893,public,usertable,1,0,2261759,4099418,948533,57651,72601,25928,875932,118424,1078785,948533,,,,,0,0,0,0
1650450413.4319582,public.usertable,876294,118447,1148116992,16893,public,usertable,1,0,2262765,4100016,948908,57661,72614,25934,876294,118447,1079183,948908,,,,,0,0,0,0
1650450414.4621716,public.usertable,876648,118470,1148559360,16893,public,usertable,1,0,2263706,4100733,949276,57674,72628,25941,876648,118470,1079578,949276,,,,,0,0,0,0
1650450415.491094,public.usertable,876992,118487,1148993536,16893,public,usertable,1,0,2264681,4101891,949632,57686,72640,25946,876992,118487,1079958,949632,,,,,0,0,0,0
1650450416.5207317,public.usertable,877351,118502,1149460480,16893,public,usertable,1,0,2265838,4102864,950002,57700,72651,25954,877351,118502,1080353,950002,,,,,0,0,0,0
1650450417.552028,public.usertable,877726,118517,1149911040,16893,public,usertable,1,0,2266817,4104005,950388,57709,72662,25960,877726,118517,1080759,950388,,,,,0,0,0,0
1650450418.5811071,public.usertable,878173,118534,1150246912,16893,public,usertable,1,0,2267962,4104618,950848,57719,72675,25965,878173,118534,1081242,950848,,,,,0,0,0,0
1650450419.6104336,public.usertable,878449,118554,1150599168,16893,public,usertable,1,0,2268806,4104937,951139,57724,72690,25967,878449,118554,1081553,951139,,,,,0,0,0,0
1650450420.640046,public.usertable,878728,118567,1150935040,16893,public,usertable,1,0,2269603,4105570,951425,57731,72697,25970,878728,118567,1081853,951425,,,,,0,0,0,0
1650450421.6725507,public.usertable,878961,118578,1151229952,16893,public,usertable,1,0,2270262,4106152,951668,57738,72707,25973,878961,118578,1082113,951668,,,,,0,0,0,0
1650450422.7040308,public.usertable,879204,118586,1151524864,16893,public,usertable,1,0,2270893,4106325,951916,57741,72712,25975,879204,118586,1082369,951916,,,,,0,0,0,0
1650450423.7333198,public.usertable,879470,118605,1151885312,16893,public,usertable,1,0,2271639,4106741,952197,57747,72727,25980,879470,118605,1082671,952197,,,,,0,0,0,0
1650450424.7624035,public.usertable,879788,118618,1152253952,16893,public,usertable,1,0,2272424,4107173,952518,57757,72730,25985,879788,118618,1083005,952518,,,,,0,0,0,0
1650450425.7930667,public.usertable,880083,118643,1152638976,16893,public,usertable,1,0,2273251,4108185,952823,57772,72740,25991,880083,118643,1083335,952823,,,,,0,0,0,0
1650450426.8219545,public.usertable,880384,118654,1153024000,16893,public,usertable,1,0,2274035,4109245,953130,57781,72746,25993,880384,118654,1083657,953130,,,,,0,0,0,0
1650450427.8512256,public.usertable,880708,118676,1153441792,16893,public,usertable,1,0,2274872,4109572,953466,57791,72758,25998,880708,118676,1084015,953466,,,,,0,0,0,0
1650450428.880015,public.usertable,881059,118690,1153884160,16893,public,usertable,1,0,2275895,4109920,953825,57797,72766,26001,881059,118690,1084388,953825,,,,,0,0,0,0
1650450429.9108973,public.usertable,881416,118709,1154326528,16893,public,usertable,1,0,2276850,4110409,954198,57803,72782,26002,881416,118709,1084783,954198,,,,,0,0,0,0
1650450430.9417918,public.usertable,881758,118731,1154760704,16893,public,usertable,1,0,2277768,4111426,954550,57817,72792,26008,881758,118731,1085159,954550,,,,,0,0,0,0
1650450431.9722006,public.usertable,882110,118749,1155211264,16893,public,usertable,1,0,2278810,4112630,954914,57826,72804,26014,882110,118749,1085544,954914,,,,,0,0,0,0
1650450433.0008109,public.usertable,882508,118764,1155702784,16893,public,usertable,1,0,2279924,4112881,955320,57833,72812,26018,882508,118764,1085965,955320,,,,,0,0,0,0
1650450434.0309741,public.usertable,882881,118781,1156169728,16893,public,usertable,1,0,2280983,4114659,955706,57844,72825,26025,882881,118781,1086375,955706,,,,,0,0,0,0
1650450435.0587938,public.usertable,883241,118799,1156628480,16893,public,usertable,1,0,2282006,4115072,956080,57854,72839,26032,883241,118799,1086773,956080,,,,,0,0,0,0
1650450436.0888798,public.usertable,883620,118810,1157103616,16893,public,usertable,1,0,2283032,4115815,956472,57858,72852,26034,883620,118810,1087182,956472,,,,,0,0,0,0
1650450437.1186087,public.usertable,883980,118829,1157554176,16893,public,usertable,1,0,2284101,4116604,956848,57865,72868,26038,883980,118829,1087581,956848,,,,,0,0,0,0
1650450438.1478975,public.usertable,884356,118853,1158037504,16893,public,usertable,1,0,2285132,4117208,957239,57874,72883,26043,884356,118853,1087996,957239,,,,,0,0,0,0
1650450439.1774073,public.usertable,884889,118887,1158471680,16893,public,usertable,1,0,2286696,4118484,957790,57894,72901,26054,884889,118887,1088585,957790,,,,,0,0,0,0
1650450440.2063522,public.usertable,885233,118906,1158897664,16893,public,usertable,1,0,2287644,4118838,958142,57910,72909,26060,885233,118906,1088961,958142,,,,,0,0,0,0
1650450441.2357676,public.usertable,885606,118928,1159380992,16893,public,usertable,1,0,2288697,4119686,958527,57924,72921,26067,885606,118928,1089372,958527,,,,,0,0,0,0
1650450442.2652738,public.usertable,885990,118943,1159856128,16893,public,usertable,1,0,2289766,4120056,958921,57933,72931,26074,885990,118943,1089785,958921,,,,,0,0,0,0
1650450443.2948794,public.usertable,886357,118956,1160314880,16893,public,usertable,1,0,2290780,4120519,959300,57939,72943,26079,886357,118956,1090182,959300,,,,,0,0,0,0
1650450444.323576,public.usertable,886724,118989,1160781824,16893,public,usertable,1,0,2291842,4121196,959680,57959,72956,26089,886724,118989,1090595,959680,,,,,0,0,0,0
1650450445.3537672,public.usertable,887088,119012,1161224192,16893,public,usertable,1,0,2292791,4121942,960054,57975,72966,26096,887088,119012,1090995,960054,,,,,0,0,0,0
1650450446.3841286,public.usertable,887441,119027,1161699328,16893,public,usertable,1,0,2293747,4122191,960417,57980,72976,26097,887441,119027,1091373,960417,,,,,0,0,0,0
1650450447.4138055,public.usertable,887798,119045,1162133504,16893,public,usertable,1,0,2294736,4122814,960788,57989,72990,26103,887798,119045,1091767,960788,,,,,0,0,0,0
1650450448.4422917,public.usertable,888146,119068,1162551296,16893,public,usertable,1,0,2295773,4123423,961150,57998,73004,26108,888146,119068,1092152,961150,,,,,0,0,0,0
1650450449.4750912,public.usertable,888444,119082,1162911744,16893,public,usertable,1,0,2296684,4124284,961456,58004,73012,26113,888444,119082,1092472,961456,,,,,0,0,0,0
1650450450.5033402,public.usertable,888706,119087,1163214848,16893,public,usertable,1,0,2297390,4125968,961725,58010,73019,26116,888706,119087,1092754,961725,,,,,0,0,0,0
1650450451.5318458,public.usertable,888930,119098,1163517952,16893,public,usertable,1,0,2298041,4126869,961959,58017,73029,26117,888930,119098,1093005,961959,,,,,0,0,0,0
1650450452.559649,public.usertable,889186,119105,1163829248,16893,public,usertable,1,0,2298794,4127571,962219,58023,73033,26119,889186,119105,1093275,962219,,,,,0,0,0,0
1650450453.5889132,public.usertable,889438,119126,1164132352,16893,public,usertable,1,0,2299657,4128145,962483,58032,73045,26125,889438,119126,1093560,962483,,,,,0,0,0,0
1650450454.6170156,public.usertable,889685,119139,1164500992,16893,public,usertable,1,0,2300395,4128637,962740,58035,73055,26127,889685,119139,1093830,962740,,,,,0,0,0,0
1650450455.6466486,public.usertable,890014,119155,1164910592,16893,public,usertable,1,0,2301289,4129243,963084,58040,73070,26131,890014,119155,1094194,963084,,,,,0,0,0,0
1650450456.6812828,public.usertable,890307,119178,1165295616,16893,public,usertable,1,0,2302122,4129498,963388,58052,73081,26140,890307,119178,1094521,963388,,,,,0,0,0,0
1650450457.7116258,public.usertable,890627,119191,1165672448,16893,public,usertable,1,0,2302920,4129768,963714,58060,73087,26143,890627,119191,1094861,963714,,,,,0,0,0,0
1650450458.7397127,public.usertable,890927,119217,1166057472,16893,public,usertable,1,0,2303818,4129879,964030,58070,73103,26149,890927,119217,1095203,964030,,,,,0,0,0,0
1650450459.7670205,public.usertable,891386,119240,1166442496,16893,public,usertable,1,0,2305078,4130831,964504,58080,73118,26152,891386,119240,1095702,964504,,,,,0,0,0,0
1650450460.7958622,public.usertable,891706,119257,1166835712,16893,public,usertable,1,0,2305956,4131435,964833,58089,73127,26159,891706,119257,1096049,964833,,,,,0,0,0,0
1650450461.8243232,public.usertable,892048,119274,1167278080,16893,public,usertable,1,0,2306849,4131696,965184,58098,73136,26166,892048,119274,1096418,965184,,,,,0,0,0,0
1650450462.8549516,public.usertable,892386,119299,1167712256,16893,public,usertable,1,0,2307756,4131880,965536,58109,73150,26170,892386,119299,1096795,965536,,,,,0,0,0,0
1650450463.8848033,public.usertable,892736,119316,1168138240,16893,public,usertable,1,0,2308714,4132375,965896,58119,73160,26175,892736,119316,1097175,965896,,,,,0,0,0,0
1650450464.9135332,public.usertable,893092,119339,1168596992,16893,public,usertable,1,0,2309601,4132964,966263,58131,73171,26179,893092,119339,1097565,966263,,,,,0,0,0,0
1650450465.943651,public.usertable,893485,119362,1169096704,16893,public,usertable,1,0,2310715,4133714,966669,58143,73184,26188,893485,119362,1097996,966669,,,,,0,0,0,0
1650450466.9748714,public.usertable,893884,119387,1169588224,16893,public,usertable,1,0,2311699,4134281,967082,58154,73198,26192,893884,119387,1098434,967082,,,,,0,0,0,0
1650450468.0036147,public.usertable,894191,119402,1169997824,16893,public,usertable,1,0,2312585,4134633,967405,58160,73214,26195,894191,119402,1098779,967405,,,,,0,0,0,0
1650450469.0318344,public.usertable,894600,119420,1170513920,16893,public,usertable,1,0,2313593,4135305,967827,58166,73227,26200,894600,119420,1099220,967827,,,,,0,0,0,0
1650450470.0599735,public.usertable,894981,119446,1170989056,16893,public,usertable,1,0,2314652,4135832,968223,58180,73242,26206,894981,119446,1099645,968223,,,,,0,0,0,0
1650450471.0879908,public.usertable,895370,119463,1171447808,16893,public,usertable,1,0,2315648,4137011,968625,58190,73255,26210,895370,119463,1100070,968625,,,,,0,0,0,0
1650450472.117659,public.usertable,895745,119474,1171939328,16893,public,usertable,1,0,2316668,4137341,969008,58195,73263,26214,895745,119474,1100466,969008,,,,,0,0,0,0
1650450473.1476228,public.usertable,896141,119495,1172439040,16893,public,usertable,1,0,2317675,4137939,969415,58207,73274,26224,896141,119495,1100896,969415,,,,,0,0,0,0
1650450474.1795833,public.usertable,896545,119509,1172930560,16893,public,usertable,1,0,2318726,4138641,969830,58211,73285,26228,896545,119509,1101326,969830,,,,,0,0,0,0
1650450475.2082262,public.usertable,896938,119533,1173430272,16893,public,usertable,1,0,2319810,4139248,970235,58223,73297,26236,896938,119533,1101755,970235,,,,,0,0,0,0
1650450476.2369502,public.usertable,897316,119554,1173897216,16893,public,usertable,1,0,2321008,4139819,970629,58230,73313,26240,897316,119554,1102172,970629,,,,,0,0,0,0
1650450477.2679746,public.usertable,897689,119567,1174355968,16893,public,usertable,1,0,2322101,4140604,971012,58242,73323,26243,897689,119567,1102577,971012,,,,,0,0,0,0
1650450478.2981155,public.usertable,898260,119598,1174847488,16893,public,usertable,1,0,2323783,4141126,971604,58254,73344,26249,898260,119598,1103202,971604,,,,,0,0,0,0
1650450479.329322,public.usertable,898615,119621,1175306240,16893,public,usertable,1,0,2324819,4141501,971973,58264,73358,26254,898615,119621,1103595,971973,,,,,0,0,0,0
1650450480.3590617,public.usertable,899017,119636,1175814144,16893,public,usertable,1,0,2325853,4142244,972385,58273,73368,26256,899017,119636,1104026,972385,,,,,0,0,0,0
1650450481.392003,public.usertable,899424,119644,1176322048,16893,public,usertable,1,0,2326899,4142931,972800,58283,73376,26262,899424,119644,1104459,972800,,,,,0,0,0,0
1650450482.4226823,public.usertable,899808,119655,1176788992,16893,public,usertable,1,0,2327913,4144007,973196,58292,73388,26268,899808,119655,1104876,973196,,,,,0,0,0,0
1650450483.4524157,public.usertable,900194,119670,1177280512,16893,public,usertable,1,0,2328998,4144259,973591,58299,73397,26271,900194,119670,1105287,973591,,,,,0,0,0,0
1650450484.482124,public.usertable,900589,119681,1177772032,16893,public,usertable,1,0,2330146,4144967,973996,58308,73407,26273,900589,119681,1105711,973996,,,,,0,0,0,0
1650450485.5100508,public.usertable,900994,119684,1178271744,16893,public,usertable,1,0,2331282,4145840,974409,58317,73415,26281,900994,119684,1106141,974409,,,,,0,0,0,0
1650450486.5384207,public.usertable,901407,119707,1178787840,16893,public,usertable,1,0,2332454,4146589,974835,58329,73428,26286,901407,119707,1106592,974835,,,,,0,0,0,0
1650450487.5677514,public.usertable,901825,119731,1179320320,16893,public,usertable,1,0,2333586,4147229,975264,58346,73439,26295,901825,119731,1107049,975264,,,,,0,0,0,0
1650450488.5971036,public.usertable,902223,119758,1179820032,16893,public,usertable,1,0,2334679,4147672,975674,58361,73451,26302,902223,119758,1107486,975674,,,,,0,0,0,0
1650450489.6272516,public.usertable,902606,119782,1180295168,16893,public,usertable,1,0,2335703,4147913,976071,58371,73465,26307,902606,119782,1107907,976071,,,,,0,0,0,0
1650450490.6597257,public.usertable,903010,119796,1180794880,16893,public,usertable,1,0,2336796,4148578,976483,58381,73473,26316,903010,119796,1108337,976483,,,,,0,0,0,0
1650450491.6884437,public.usertable,903388,119828,1181294592,16893,public,usertable,1,0,2338027,4150377,976883,58398,73495,26328,903388,119828,1108776,976883,,,,,0,0,0,0
1650450492.717339,public.usertable,903799,119836,1181794304,16893,public,usertable,1,0,2339266,4151642,977307,58407,73508,26332,903799,119836,1109222,977307,,,,,0,0,0,0
1650450493.7465158,public.usertable,904196,119848,1182277632,16893,public,usertable,1,0,2340427,4152240,977712,58414,73516,26336,904196,119848,1109642,977712,,,,,0,0,0,0
1650450494.7759473,public.usertable,904563,119877,1182752768,16893,public,usertable,1,0,2341507,4152815,978099,58426,73536,26342,904563,119877,1110061,978099,,,,,0,0,0,0
1650450495.8054006,public.usertable,904966,119891,1183260672,16893,public,usertable,1,0,2342629,4154007,978513,58435,73547,26346,904966,119891,1110495,978513,,,,,0,0,0,0
1650450496.834979,public.usertable,905567,119924,1183768576,16893,public,usertable,1,0,2344384,4155546,979135,58450,73568,26355,905567,119924,1111153,979135,,,,,0,0,0,0
1650450497.8654668,public.usertable,905961,119941,1184268288,16893,public,usertable,1,0,2345421,4156352,979542,58459,73581,26359,905961,119941,1111582,979542,,,,,0,0,0,0
1650450498.8946102,public.usertable,906351,119968,1184759808,16893,public,usertable,1,0,2346494,4156672,979948,58471,73597,26362,906351,119968,1112016,979948,,,,,0,0,0,0
1650450499.923158,public.usertable,906729,119992,1185251328,16893,public,usertable,1,0,2347611,4157526,980340,58484,73611,26370,906729,119992,1112435,980340,,,,,0,0,0,0
1650450500.9515681,public.usertable,907152,120006,1185767424,16893,public,usertable,1,0,2348723,4158421,980769,58496,73617,26377,907152,120006,1112882,980769,,,,,0,0,0,0
1650450501.9817247,public.usertable,907507,120023,1186209792,16893,public,usertable,1,0,2349675,4159692,981130,58509,73623,26384,907507,120023,1113262,981130,,,,,0,0,0,0
1650450503.0102246,public.usertable,907897,120047,1186701312,16893,public,usertable,1,0,2350784,4160006,981536,58517,73639,26388,907897,120047,1113692,981536,,,,,0,0,0,0
1650450504.04021,public.usertable,908311,120059,1187209216,16893,public,usertable,1,0,2351899,4160960,981961,58530,73650,26397,908311,120059,1114141,981961,,,,,0,0,0,0
1650450505.0733967,public.usertable,908710,120081,1187725312,16893,public,usertable,1,0,2352967,4162554,982372,58542,73662,26402,908710,120081,1114576,982372,,,,,0,0,0,0
1650450506.1020741,public.usertable,909101,120091,1188208640,16893,public,usertable,1,0,2354016,4163182,982771,58547,73670,26406,909101,120091,1114988,982771,,,,,0,0,0,0
1650450507.1319635,public.usertable,909522,120107,1188741120,16893,public,usertable,1,0,2355120,4164084,983207,58557,73685,26408,909522,120107,1115449,983207,,,,,0,0,0,0
1650450508.1632197,public.usertable,909933,120123,1189240832,16893,public,usertable,1,0,2356286,4165631,983626,58571,73693,26414,909933,120123,1115890,983626,,,,,0,0,0,0
1650450509.193849,public.usertable,910336,120136,1189740544,16893,public,usertable,1,0,2357318,4166126,984037,58580,73701,26419,910336,120136,1116318,984037,,,,,0,0,0,0
1650450510.226868,public.usertable,910728,120151,1190223872,16893,public,usertable,1,0,2358335,4167276,984445,58590,73717,26423,910728,120151,1116752,984445,,,,,0,0,0,0
1650450511.2552083,public.usertable,911125,120150,1190731776,16893,public,usertable,1,0,2359344,4168639,984847,58594,73722,26425,911125,120150,1117163,984847,,,,,0,0,0,0
1650450512.2840831,public.usertable,911522,120163,1191223296,16893,public,usertable,1,0,2360466,4169640,985253,58599,73731,26429,911522,120163,1117583,985253,,,,,0,0,0,0
1650450513.3145647,public.usertable,911907,120183,1191682048,16893,public,usertable,1,0,2361507,4170083,985651,58607,73744,26434,911907,120183,1118002,985651,,,,,0,0,0,0
1650450514.3434412,public.usertable,912492,120205,1192181760,16893,public,usertable,1,0,2363133,4170774,986245,58624,73753,26444,912492,120205,1118622,986245,,,,,0,0,0,0
1650450515.3716898,public.usertable,912875,120235,1192665088,16893,public,usertable,1,0,2364234,4170991,986641,58641,73766,26453,912875,120235,1119048,986641,,,,,0,0,0,0
1650450516.4011788,public.usertable,913274,120255,1193172992,16893,public,usertable,1,0,2365284,4171278,987051,58651,73777,26458,913274,120255,1119479,987051,,,,,0,0,0,0
1650450517.4324682,public.usertable,913646,120271,1193623552,16893,public,usertable,1,0,2366434,4171977,987430,58660,73784,26466,913646,120271,1119874,987430,,,,,0,0,0,0
1650450518.462726,public.usertable,914033,120293,1194115072,16893,public,usertable,1,0,2367550,4172374,987829,58670,73796,26471,914033,120293,1120295,987829,,,,,0,0,0,0
1650450519.4925117,public.usertable,914424,120315,1194606592,16893,public,usertable,1,0,2368592,4173022,988237,58675,73813,26475,914424,120315,1120725,988237,,,,,0,0,0,0
1650450520.5232556,public.usertable,914791,120343,1195081728,16893,public,usertable,1,0,2369613,4173588,988622,58687,73831,26479,914791,120343,1121140,988622,,,,,0,0,0,0
1650450521.5520942,public.usertable,915173,120355,1195548672,16893,public,usertable,1,0,2370628,4174153,989015,58691,73842,26481,915173,120355,1121548,989015,,,,,0,0,0,0
1650450522.5804343,public.usertable,915550,120370,1196032000,16893,public,usertable,1,0,2371636,4175082,989404,58701,73854,26488,915550,120370,1121959,989404,,,,,0,0,0,0
1650450523.610439,public.usertable,915958,120383,1196523520,16893,public,usertable,1,0,2372641,4175416,989819,58708,73861,26490,915958,120383,1122388,989819,,,,,0,0,0,0
1650450524.6391816,public.usertable,916338,120405,1197015040,16893,public,usertable,1,0,2373729,4176140,990210,58722,73872,26500,916338,120405,1122804,990210,,,,,0,0,0,0
1650450525.669423,public.usertable,916722,120428,1197481984,16893,public,usertable,1,0,2374844,4177108,990611,58729,73889,26504,916722,120428,1123229,990611,,,,,0,0,0,0
1650450526.7012045,public.usertable,917116,120444,1197965312,16893,public,usertable,1,0,2376016,4177328,991015,58736,73899,26507,917116,120444,1123650,991015,,,,,0,0,0,0
1650450527.7293355,public.usertable,917478,120458,1198440448,16893,public,usertable,1,0,2377032,4177890,991388,58744,73910,26512,917478,120458,1124042,991388,,,,,0,0,0,0
1650450528.7590046,public.usertable,917872,120481,1198940160,16893,public,usertable,1,0,2378125,4178727,991793,58757,73921,26518,917872,120481,1124471,991793,,,,,0,0,0,0
1650450529.788863,public.usertable,918292,120492,1199472640,16893,public,usertable,1,0,2379219,4179568,992222,58762,73930,26520,918292,120492,1124914,992222,,,,,0,0,0,0
1650450530.8195672,public.usertable,918706,120503,1199972352,16893,public,usertable,1,0,2380372,4180143,992644,58767,73938,26521,918706,120503,1125349,992644,,,,,0,0,0,0
1650450531.8521628,public.usertable,919104,120520,1200480256,16893,public,usertable,1,0,2381489,4181023,993052,58776,73948,26523,919104,120520,1125776,993052,,,,,0,0,0,0
1650450532.8877125,public.usertable,919664,120543,1200930816,16893,public,usertable,1,0,2382975,4181786,993630,58787,73966,26527,919664,120543,1126383,993630,,,,,0,0,0,0
1650450533.9163585,public.usertable,920057,120555,1201414144,16893,public,usertable,1,0,2384053,4182754,994029,58799,73972,26534,920057,120555,1126800,994029,,,,,0,0,0,0
1650450534.9455054,public.usertable,920434,120575,1201889280,16893,public,usertable,1,0,2385133,4183670,994423,58805,73989,26535,920434,120575,1127217,994423,,,,,0,0,0,0
1650450535.975131,public.usertable,920814,120593,1202372608,16893,public,usertable,1,0,2386191,4185126,994814,58818,74000,26540,920814,120593,1127632,994814,,,,,0,0,0,0
1650450537.006876,public.usertable,921201,120605,1202839552,16893,public,usertable,1,0,2387241,4185797,995206,58825,74005,26545,921201,120605,1128036,995206,,,,,0,0,0,0
1650450538.0369208,public.usertable,921576,120626,1203314688,16893,public,usertable,1,0,2388331,4186318,995589,58838,74013,26552,921576,120626,1128440,995589,,,,,0,0,0,0
1650450539.0692112,public.usertable,921951,120638,1203773440,16893,public,usertable,1,0,2389315,4186981,995975,58843,74024,26555,921951,120638,1128842,995975,,,,,0,0,0,0
1650450540.1003325,public.usertable,922326,120665,1204264960,16893,public,usertable,1,0,2390414,4187849,996365,58857,74039,26563,922326,120665,1129261,996365,,,,,0,0,0,0
1650450541.1347811,public.usertable,922716,120678,1204756480,16893,public,usertable,1,0,2391394,4188888,996765,58864,74049,26566,922716,120678,1129678,996765,,,,,0,0,0,0
1650450542.1635673,public.usertable,923110,120708,1205239808,16893,public,usertable,1,0,2392477,4189246,997175,58878,74065,26575,923110,120708,1130118,997175,,,,,0,0,0,0
1650450543.1936033,public.usertable,923480,120733,1205714944,16893,public,usertable,1,0,2393605,4190345,997566,58888,74086,26582,923480,120733,1130540,997566,,,,,0,0,0,0
1650450544.22411,public.usertable,923862,120758,1206206464,16893,public,usertable,1,0,2394533,4190643,997961,58900,74099,26586,923862,120758,1130960,997961,,,,,0,0,0,0
1650450545.2552261,public.usertable,924209,120789,1206665216,16893,public,usertable,1,0,2395566,4191218,998327,58916,74118,26593,924209,120789,1131361,998327,,,,,0,0,0,0
1650450546.2857568,public.usertable,924612,120802,1207173120,16893,public,usertable,1,0,2396561,4192350,998738,58924,74126,26600,924612,120802,1131788,998738,,,,,0,0,0,0
1650450547.314158,public.usertable,925018,120825,1207672832,16893,public,usertable,1,0,2397707,4193473,999158,58936,74140,26607,925018,120825,1132234,999158,,,,,0,0,0,0
1650450548.3444796,public.usertable,925408,120850,1208172544,16893,public,usertable,1,0,2398917,4193734,999560,58950,74152,26610,925408,120850,1132662,999560,,,,,0,0,0,0
1650450549.3748913,public.usertable,925786,120873,1208647680,16893,public,usertable,1,0,2400005,4194414,999952,58960,74166,26615,925786,120873,1133078,999952,,,,,0,0,0,0
1650450550.4077923,public.usertable,926177,120893,1209114624,16893,public,usertable,1,0,2401004,4194982,1000356,58967,74179,26618,926177,120893,1133502,1000356,,,,,0,0,0,0
1650450551.4374037,public.usertable,926708,120925,1209565184,16893,public,usertable,1,0,2402687,4195169,1000908,58978,74200,26622,926708,120925,1134086,1000908,,,,,0,0,0,0
1650450552.4716647,public.usertable,927100,120943,1210064896,16893,public,usertable,1,0,2403764,4196447,1001316,58988,74216,26628,927100,120943,1134520,1001316,,,,,0,0,0,0
1650450553.5003555,public.usertable,927507,120961,1210572800,16893,public,usertable,1,0,2404871,4197959,1001735,59000,74228,26635,927507,120961,1134963,1001735,,,,,0,0,0,0
1650450554.5303931,public.usertable,927904,120979,1211072512,16893,public,usertable,1,0,2405978,4198501,1002139,59013,74235,26644,927904,120979,1135387,1002139,,,,,0,0,0,0
1650450555.5592546,public.usertable,928299,120998,1211572224,16893,public,usertable,1,0,2407103,4199575,1002550,59022,74251,26648,928299,120998,1135823,1002550,,,,,0,0,0,0
1650450556.5886889,public.usertable,928698,121015,1212071936,16893,public,usertable,1,0,2408212,4200348,1002960,59033,74262,26652,928698,121015,1136255,1002960,,,,,0,0,0,0
1650450557.6178713,public.usertable,929116,121034,1212579840,16893,public,usertable,1,0,2409286,4200979,1003388,59044,74272,26660,929116,121034,1136704,1003388,,,,,0,0,0,0
1650450558.6471903,public.usertable,929509,121044,1213071360,16893,public,usertable,1,0,2410279,4202192,1003791,59053,74282,26666,929509,121044,1137126,1003791,,,,,0,0,0,0
1650450559.6783133,public.usertable,929903,121071,1213571072,16893,public,usertable,1,0,2411427,4203174,1004199,59070,74296,26676,929903,121071,1137565,1004199,,,,,0,0,0,0
1650450560.7075691,public.usertable,930315,121089,1214095360,16893,public,usertable,1,0,2412625,4204395,1004624,59078,74309,26683,930315,121089,1138011,1004624,,,,,0,0,0,0
1650450561.7393022,public.usertable,930742,121098,1214611456,16893,public,usertable,1,0,2413761,4204747,1005059,59082,74317,26685,930742,121098,1138458,1005059,,,,,0,0,0,0
1650450562.76816,public.usertable,931133,121116,1215086592,16893,public,usertable,1,0,2414809,4205333,1005463,59089,74330,26689,931133,121116,1138882,1005463,,,,,0,0,0,0
1650450563.798403,public.usertable,931498,121130,1215545344,16893,public,usertable,1,0,2415867,4205970,1005839,59101,74341,26696,931498,121130,1139281,1005839,,,,,0,0,0,0
1650450564.8266888,public.usertable,931882,121148,1216028672,16893,public,usertable,1,0,2416961,4206769,1006236,59113,74354,26702,931882,121148,1139703,1006236,,,,,0,0,0,0
1650450565.855263,public.usertable,932245,121166,1216487424,16893,public,usertable,1,0,2417978,4207856,1006609,59122,74364,26707,932245,121166,1140095,1006609,,,,,0,0,0,0
1650450566.8835273,public.usertable,932634,121184,1216978944,16893,public,usertable,1,0,2419063,4208641,1007010,59129,74376,26712,932634,121184,1140515,1007010,,,,,0,0,0,0
1650450567.9118958,public.usertable,933019,121207,1217429504,16893,public,usertable,1,0,2420071,4209025,1007407,59140,74388,26720,933019,121207,1140935,1007407,,,,,0,0,0,0
1650450568.941951,public.usertable,933548,121233,1217880064,16893,public,usertable,1,0,2421623,4209406,1007950,59155,74402,26728,933548,121233,1141507,1007950,,,,,0,0,0,0
1650450569.9701283,public.usertable,933917,121246,1218338816,16893,public,usertable,1,0,2422614,4209765,1008326,59161,74409,26730,933917,121246,1141896,1008326,,,,,0,0,0,0
1650450570.9990132,public.usertable,934260,121255,1218764800,16893,public,usertable,1,0,2423550,4210778,1008676,59170,74416,26734,934260,121255,1142262,1008676,,,,,0,0,0,0
1650450572.0304673,public.usertable,934567,121275,1219141632,16893,public,usertable,1,0,2424361,4211266,1008995,59178,74428,26739,934567,121275,1142601,1008995,,,,,0,0,0,0
1650450573.058613,public.usertable,934954,121300,1219649536,16893,public,usertable,1,0,2425389,4212013,1009399,59187,74445,26744,934954,121300,1143031,1009399,,,,,0,0,0,0
1650450574.0872135,public.usertable,935352,121315,1220132864,16893,public,usertable,1,0,2426406,4212960,1009804,59195,74452,26747,935352,121315,1143451,1009804,,,,,0,0,0,0
1650450575.116241,public.usertable,935739,121325,1220616192,16893,public,usertable,1,0,2427421,4213638,1010199,59200,74460,26749,935739,121325,1143859,1010199,,,,,0,0,0,0
1650450576.1453292,public.usertable,936114,121341,1221099520,16893,public,usertable,1,0,2428470,4214775,1010587,59206,74473,26751,936114,121341,1144266,1010587,,,,,0,0,0,0
1650450577.1767564,public.usertable,936486,121358,1221533696,16893,public,usertable,1,0,2429484,4215127,1010968,59214,74482,26758,936486,121358,1144664,1010968,,,,,0,0,0,0
1650450578.2053561,public.usertable,936766,121369,1221894144,16893,public,usertable,1,0,2430358,4215537,1011261,59219,74495,26760,936766,121369,1144975,1011261,,,,,0,0,0,0
1650450579.2375886,public.usertable,937118,121382,1222311936,16893,public,usertable,1,0,2431218,4215984,1011622,59223,74504,26762,937118,121382,1145349,1011622,,,,,0,0,0,0
1650450580.2668002,public.usertable,937455,121402,1222729728,16893,public,usertable,1,0,2432061,4216373,1011967,59236,74512,26769,937455,121402,1145715,1011967,,,,,0,0,0,0
1650450581.2956288,public.usertable,937774,121418,1223163904,16893,public,usertable,1,0,2432992,4216587,1012294,59244,74520,26773,937774,121418,1146058,1012294,,,,,0,0,0,0
1650450582.33101,public.usertable,938163,121432,1223630848,16893,public,usertable,1,0,2434012,4217049,1012692,59255,74529,26781,938163,121432,1146476,1012692,,,,,0,0,0,0
1650450583.3623939,public.usertable,938496,121453,1224065024,16893,public,usertable,1,0,2435007,4217942,1013039,59265,74543,26785,938496,121453,1146847,1013039,,,,,0,0,0,0
1650450584.391176,public.usertable,938787,121462,1224384512,16893,public,usertable,1,0,2435719,4218151,1013334,59272,74547,26787,938787,121462,1147153,1013334,,,,,0,0,0,0
1650450585.4196532,public.usertable,939035,121476,1224736768,16893,public,usertable,1,0,2436359,4218486,1013595,59275,74560,26789,939035,121476,1147430,1013595,,,,,0,0,0,0
1650450586.4492493,public.usertable,939374,121490,1225170944,16893,public,usertable,1,0,2437303,4219291,1013942,59285,74568,26795,939374,121490,1147795,1013942,,,,,0,0,0,0
1650450587.4793868,public.usertable,939745,121508,1225654272,16893,public,usertable,1,0,2438299,4220131,1014330,59290,74585,26798,939745,121508,1148205,1014330,,,,,0,0,0,0
1650450588.5116892,public.usertable,940239,121533,1226022912,16893,public,usertable,1,0,2439621,4220769,1014836,59306,74597,26807,940239,121533,1148739,1014836,,,,,0,0,0,0
1650450589.5423496,public.usertable,940510,121543,1226366976,16893,public,usertable,1,0,2440515,4221611,1015116,59312,74606,26812,940510,121543,1149034,1015116,,,,,0,0,0,0
1650450590.5753248,public.usertable,940841,121563,1226784768,16893,public,usertable,1,0,2441471,4222214,1015459,59320,74618,26816,940841,121563,1149397,1015459,,,,,0,0,0,0
1650450591.6057253,public.usertable,941197,121586,1227235328,16893,public,usertable,1,0,2442519,4222923,1015832,59330,74635,26824,941197,121586,1149797,1015832,,,,,0,0,0,0
1650450592.6355784,public.usertable,941566,121605,1227702272,16893,public,usertable,1,0,2443413,4223480,1016215,59336,74649,26829,941566,121605,1150200,1016215,,,,,0,0,0,0
1650450593.6649148,public.usertable,941961,121627,1228193792,16893,public,usertable,1,0,2444564,4224231,1016623,59347,74662,26834,941961,121627,1150632,1016623,,,,,0,0,0,0
1650450594.695366,public.usertable,942316,121648,1228644352,16893,public,usertable,1,0,2445439,4224627,1016991,59356,74675,26838,942316,121648,1151022,1016991,,,,,0,0,0,0
1650450595.7244065,public.usertable,942710,121658,1229135872,16893,public,usertable,1,0,2446525,4225110,1017393,59364,74683,26843,942710,121658,1151440,1017393,,,,,0,0,0,0
1650450596.7535641,public.usertable,943101,121676,1229611008,16893,public,usertable,1,0,2447597,4225608,1017791,59378,74690,26848,943101,121676,1151859,1017791,,,,,0,0,0,0
1650450597.781955,public.usertable,943486,121695,1230110720,16893,public,usertable,1,0,2448671,4226010,1018190,59385,74704,26854,943486,121695,1152279,1018190,,,,,0,0,0,0
1650450598.8109102,public.usertable,943889,121719,1230594048,16893,public,usertable,1,0,2449785,4226313,1018605,59400,74716,26860,943889,121719,1152721,1018605,,,,,0,0,0,0
1650450599.8404238,public.usertable,944246,121740,1231060992,16893,public,usertable,1,0,2450899,4226611,1018977,59410,74731,26867,944246,121740,1153118,1018977,,,,,0,0,0,0
1650450600.8682852,public.usertable,944638,121760,1231544320,16893,public,usertable,1,0,2452030,4226990,1019381,59418,74743,26872,944638,121760,1153542,1019381,,,,,0,0,0,0
1650450601.8969054,public.usertable,945022,121776,1232027648,16893,public,usertable,1,0,2453122,4227951,1019780,59424,74758,26876,945022,121776,1153962,1019780,,,,,0,0,0,0
1650450602.9265838,public.usertable,945394,121794,1232502784,16893,public,usertable,1,0,2454155,4228320,1020165,59430,74771,26879,945394,121794,1154366,1020165,,,,,0,0,0,0
1650450603.955348,public.usertable,945783,121821,1232994304,16893,public,usertable,1,0,2455304,4229613,1020567,59444,74784,26886,945783,121821,1154795,1020567,,,,,0,0,0,0
1650450604.983967,public.usertable,946179,121837,1233477632,16893,public,usertable,1,0,2456439,4229822,1020970,59453,74791,26890,946179,121837,1155214,1020970,,,,,0,0,0,0
1650450606.016185,public.usertable,946570,121852,1233985536,16893,public,usertable,1,0,2457467,4230387,1021373,59459,74803,26894,946570,121852,1155635,1021373,,,,,0,0,0,0
1650450607.0469713,public.usertable,947213,121876,1234534400,16893,public,usertable,1,0,2459284,4231985,1022035,59470,74822,26901,947213,121876,1156327,1022035,,,,,0,0,0,0
1650450608.0783417,public.usertable,947609,121891,1235034112,16893,public,usertable,1,0,2460396,4232764,1022440,59482,74831,26907,947609,121891,1156753,1022440,,,,,0,0,0,0
1650450609.1096504,public.usertable,947972,121921,1235509248,16893,public,usertable,1,0,2461354,4233481,1022825,59490,74853,26911,947972,121921,1157168,1022825,,,,,0,0,0,0
1650450610.1402674,public.usertable,948365,121942,1235992576,16893,public,usertable,1,0,2462445,4234426,1023228,59501,74863,26917,948365,121942,1157592,1023228,,,,,0,0,0,0
1650450611.17094,public.usertable,948741,121963,1236459520,16893,public,usertable,1,0,2463487,4234938,1023617,59509,74876,26922,948741,121963,1158002,1023617,,,,,0,0,0,0
1650450612.1998897,public.usertable,949135,121981,1236959232,16893,public,usertable,1,0,2464652,4236574,1024022,59522,74887,26928,949135,121981,1158431,1024022,,,,,0,0,0,0
1650450613.2285929,public.usertable,949540,122006,1237475328,16893,public,usertable,1,0,2465711,4236977,1024439,59535,74899,26933,949540,122006,1158873,1024439,,,,,0,0,0,0
1650450614.2577121,public.usertable,949935,122022,1237966848,16893,public,usertable,1,0,2466745,4237829,1024849,59540,74914,26936,949935,122022,1159303,1024849,,,,,0,0,0,0
1650450615.2864563,public.usertable,950325,122045,1238450176,16893,public,usertable,1,0,2467796,4238478,1025251,59552,74926,26942,950325,122045,1159729,1025251,,,,,0,0,0,0
1650450616.3158689,public.usertable,950676,122071,1238908928,16893,public,usertable,1,0,2468961,4239574,1025618,59566,74942,26948,950676,122071,1160126,1025618,,,,,0,0,0,0
1650450617.343968,public.usertable,951061,122085,1239384064,16893,public,usertable,1,0,2470091,4240737,1026014,59574,74953,26952,951061,122085,1160541,1026014,,,,,0,0,0,0
1650450618.372569,public.usertable,951446,122100,1239875584,16893,public,usertable,1,0,2471138,4240874,1026411,59580,74965,26954,951446,122100,1160956,1026411,,,,,0,0,0,0
1650450619.4015148,public.usertable,951851,122117,1240383488,16893,public,usertable,1,0,2472222,4242151,1026831,59588,74980,26957,951851,122117,1161399,1026831,,,,,0,0,0,0
1650450620.4316328,public.usertable,952270,122130,1240899584,16893,public,usertable,1,0,2473409,4242834,1027261,59592,74991,26959,952270,122130,1161844,1027261,,,,,0,0,0,0
1650450621.4611464,public.usertable,952695,122141,1241407488,16893,public,usertable,1,0,2474550,4243645,1027691,59601,74996,26965,952695,122141,1162288,1027691,,,,,0,0,0,0
1650450622.4913116,public.usertable,953077,122166,1241907200,16893,public,usertable,1,0,2475657,4244352,1028091,59608,75014,26968,953077,122166,1162713,1028091,,,,,0,0,0,0
1650450623.5207136,public.usertable,953475,122171,1242398720,16893,public,usertable,1,0,2476738,4245306,1028498,59613,75023,26971,953475,122171,1163134,1028498,,,,,0,0,0,0
1650450624.5504475,public.usertable,953885,122181,1242865664,16893,public,usertable,1,0,2477838,4246887,1028918,59620,75033,26977,953885,122181,1163571,1028918,,,,,0,0,0,0
1650450625.579443,public.usertable,954264,122199,1243365376,16893,public,usertable,1,0,2478898,4247616,1029303,59632,75039,26986,954264,122199,1163974,1029303,,,,,0,0,0,0
1650450626.6091592,public.usertable,954879,122221,1243897856,16893,public,usertable,1,0,2480668,4248807,1029934,59650,75055,26994,954879,122221,1164639,1029934,,,,,0,0,0,0
1650450627.639933,public.usertable,955312,122237,1244430336,16893,public,usertable,1,0,2481763,4249225,1030376,59657,75064,26995,955312,122237,1165097,1030376,,,,,0,0,0,0
1650450628.6687891,public.usertable,955690,122248,1244897280,16893,public,usertable,1,0,2482837,4249473,1030765,59666,75075,26998,955690,122248,1165506,1030765,,,,,0,0,0,0
1650450629.6981668,public.usertable,956066,122267,1245372416,16893,public,usertable,1,0,2483859,4249876,1031155,59671,75089,27002,956066,122267,1165915,1031155,,,,,0,0,0,0
1650450630.7262478,public.usertable,956438,122284,1245831168,16893,public,usertable,1,0,2484893,4250588,1031538,59681,75100,27010,956438,122284,1166319,1031538,,,,,0,0,0,0
1650450631.7555091,public.usertable,956812,122301,1246289920,16893,public,usertable,1,0,2485870,4251403,1031921,59689,75109,27015,956812,122301,1166719,1031921,,,,,0,0,0,0
1650450632.786013,public.usertable,957171,122321,1246748672,16893,public,usertable,1,0,2486847,4251925,1032292,59699,75121,27020,957171,122321,1167112,1032292,,,,,0,0,0,0
1650450633.8145802,public.usertable,957549,122340,1247232000,16893,public,usertable,1,0,2487885,4252291,1032680,59708,75131,27024,957549,122340,1167519,1032680,,,,,0,0,0,0
1650450634.8431168,public.usertable,957940,122361,1247715328,16893,public,usertable,1,0,2488990,4253227,1033086,59715,75146,27027,957940,122361,1167947,1033086,,,,,0,0,0,0
1650450635.872826,public.usertable,958307,122383,1248198656,16893,public,usertable,1,0,2490050,4253675,1033466,59727,75159,27031,958307,122383,1168352,1033466,,,,,0,0,0,0
1650450636.9018385,public.usertable,958728,122394,1248698368,16893,public,usertable,1,0,2491248,4254475,1033894,59733,75166,27035,958728,122394,1168793,1033894,,,,,0,0,0,0
1650450637.9317844,public.usertable,959109,122411,1249189888,16893,public,usertable,1,0,2492319,4255087,1034287,59739,75178,27039,959109,122411,1169204,1034287,,,,,0,0,0,0
1650450638.9635227,public.usertable,959494,122425,1249656832,16893,public,usertable,1,0,2493356,4255423,1034678,59747,75184,27043,959494,122425,1169609,1034678,,,,,0,0,0,0
1650450639.9951468,public.usertable,959858,122443,1250115584,16893,public,usertable,1,0,2494366,4256528,1035051,59756,75193,27047,959858,122443,1170000,1035051,,,,,0,0,0,0
1650450641.025831,public.usertable,960237,122462,1250582528,16893,public,usertable,1,0,2495473,4257166,1035444,59765,75207,27051,960237,122462,1170416,1035444,,,,,0,0,0,0
1650450642.0558965,public.usertable,960623,122482,1251090432,16893,public,usertable,1,0,2496365,4257535,1035843,59772,75220,27057,960623,122482,1170835,1035843,,,,,0,0,0,0
1650450643.085958,public.usertable,961010,122498,1251573760,16893,public,usertable,1,0,2497420,4258020,1036241,59782,75231,27061,961010,122498,1171254,1036241,,,,,0,0,0,0
1650450644.114881,public.usertable,961413,122519,1252057088,16893,public,usertable,1,0,2498477,4258149,1036654,59793,75241,27069,961413,122519,1171688,1036654,,,,,0,0,0,0
1650450645.1435666,public.usertable,961998,122542,1252540416,16893,public,usertable,1,0,2500139,4259163,1037251,59811,75253,27079,961998,122542,1172315,1037251,,,,,0,0,0,0
1650450646.173982,public.usertable,962381,122558,1253023744,16893,public,usertable,1,0,2501271,4260465,1037647,59820,75266,27084,962381,122558,1172733,1037647,,,,,0,0,0,0
1650450647.2049708,public.usertable,962782,122572,1253515264,16893,public,usertable,1,0,2502330,4261458,1038060,59823,75278,27086,962782,122572,1173161,1038060,,,,,0,0,0,0
1650450648.2332869,public.usertable,963162,122594,1253990400,16893,public,usertable,1,0,2503396,4262064,1038449,59838,75287,27093,963162,122594,1173574,1038449,,,,,0,0,0,0
1650450649.2622836,public.usertable,963547,122615,1254481920,16893,public,usertable,1,0,2504595,4262824,1038849,59845,75302,27096,963547,122615,1173996,1038849,,,,,0,0,0,0
1650450650.2939641,public.usertable,963944,122631,1254981632,16893,public,usertable,1,0,2505690,4263258,1039253,59854,75309,27101,963944,122631,1174416,1039253,,,,,0,0,0,0
1650450651.323199,public.usertable,964337,122643,1255473152,16893,public,usertable,1,0,2506846,4263625,1039654,59865,75317,27106,964337,122643,1174836,1039654,,,,,0,0,0,0
1650450652.35333,public.usertable,964731,122658,1255964672,16893,public,usertable,1,0,2507997,4264191,1040061,59869,75330,27109,964731,122658,1175260,1040061,,,,,0,0,0,0
1650450653.382023,public.usertable,965114,122674,1256448000,16893,public,usertable,1,0,2508959,4264479,1040458,59876,75344,27112,965114,122674,1175678,1040458,,,,,0,0,0,0
1650450654.4122372,public.usertable,965536,122690,1256955904,16893,public,usertable,1,0,2510045,4265570,1040891,59884,75355,27117,965536,122690,1176130,1040891,,,,,0,0,0,0
1650450655.4411476,public.usertable,965924,122710,1257406464,16893,public,usertable,1,0,2511119,4265827,1041295,59892,75371,27122,965924,122710,1176558,1041295,,,,,0,0,0,0
1650450656.4723804,public.usertable,966285,122725,1257922560,16893,public,usertable,1,0,2512174,4266086,1041664,59900,75379,27126,966285,122725,1176943,1041664,,,,,0,0,0,0
1650450657.5028744,public.usertable,966690,122748,1258422272,16893,public,usertable,1,0,2513316,4266679,1042080,59912,75390,27135,966690,122748,1177382,1042080,,,,,0,0,0,0
1650450658.5340557,public.usertable,967088,122766,1258905600,16893,public,usertable,1,0,2514359,4266876,1042489,59921,75401,27141,967088,122766,1177811,1042489,,,,,0,0,0,0
1650450659.5650928,public.usertable,967484,122785,1259372544,16893,public,usertable,1,0,2515408,4267310,1042896,59929,75412,27147,967484,122785,1178237,1042896,,,,,0,0,0,0
1650450660.5932198,public.usertable,967870,122806,1259872256,16893,public,usertable,1,0,2516522,4267704,1043292,59941,75422,27156,967870,122806,1178655,1043292,,,,,0,0,0,0
1650450661.6249657,public.usertable,968265,122825,1260371968,16893,public,usertable,1,0,2517585,4268619,1043700,59950,75435,27165,968265,122825,1179085,1043700,,,,,0,0,0,0
1650450662.65497,public.usertable,968824,122859,1260838912,16893,public,usertable,1,0,2519213,4269307,1044281,59965,75457,27171,968824,122859,1179703,1044281,,,,,0,0,0,0
1650450663.6859279,public.usertable,969228,122882,1261338624,16893,public,usertable,1,0,2520287,4270099,1044698,59977,75470,27178,969228,122882,1180145,1044698,,,,,0,0,0,0
1650450664.7155657,public.usertable,969597,122914,1261821952,16893,public,usertable,1,0,2521368,4270978,1045083,59994,75486,27186,969597,122914,1180563,1045083,,,,,0,0,0,0
1650450665.7468843,public.usertable,969964,122929,1262280704,16893,public,usertable,1,0,2522371,4271920,1045462,59999,75498,27188,969964,122929,1180959,1045462,,,,,0,0,0,0
1650450666.778021,public.usertable,970381,122949,1262796800,16893,public,usertable,1,0,2523580,4272797,1045895,60008,75514,27196,970381,122949,1181417,1045895,,,,,0,0,0,0
1650450667.806217,public.usertable,970768,122965,1263271936,16893,public,usertable,1,0,2524645,4273397,1046292,60019,75524,27204,970768,122965,1181835,1046292,,,,,0,0,0,0
1650450668.8356805,public.usertable,971029,122974,1263550464,16893,public,usertable,1,0,2525438,4274034,1046562,60025,75533,27208,971029,122974,1182120,1046562,,,,,0,0,0,0
1650450669.8665898,public.usertable,971243,122987,1263820800,16893,public,usertable,1,0,2526009,4274845,1046784,60032,75541,27214,971243,122987,1182357,1046784,,,,,0,0,0,0
1650450670.8968449,public.usertable,971476,122998,1264148480,16893,public,usertable,1,0,2526610,4275048,1047020,60040,75544,27219,971476,122998,1182604,1047020,,,,,0,0,0,0
1650450671.9255471,public.usertable,971815,123017,1264558080,16893,public,usertable,1,0,2527524,4275514,1047369,60049,75554,27224,971815,123017,1182972,1047369,,,,,0,0,0,0
1650450672.9537919,public.usertable,972094,123029,1264893952,16893,public,usertable,1,0,2528320,4275873,1047656,60056,75562,27231,972094,123029,1183274,1047656,,,,,0,0,0,0
1650450673.9859328,public.usertable,972402,123052,1265311744,16893,public,usertable,1,0,2529278,4276292,1047978,60065,75576,27236,972402,123052,1183619,1047978,,,,,0,0,0,0
1650450675.0162199,public.usertable,972741,123072,1265745920,16893,public,usertable,1,0,2530313,4276820,1048329,60074,75588,27242,972741,123072,1183991,1048329,,,,,0,0,0,0
1650450676.045775,public.usertable,973113,123094,1266245632,16893,public,usertable,1,0,2531444,4277033,1048718,60082,75605,27246,973113,123094,1184405,1048718,,,,,0,0,0,0
1650450677.0755692,public.usertable,973522,123105,1266761728,16893,public,usertable,1,0,2532441,4277443,1049139,60088,75617,27249,973522,123105,1184844,1049139,,,,,0,0,0,0
1650450678.1064322,public.usertable,973925,123128,1267261440,16893,public,usertable,1,0,2533636,4278256,1049552,60102,75627,27256,973925,123128,1185281,1049552,,,,,0,0,0,0
1650450679.1357489,public.usertable,974327,123140,1267761152,16893,public,usertable,1,0,2534776,4278603,1049960,60115,75633,27264,974327,123140,1185708,1049960,,,,,0,0,0,0
1650450680.1652231,public.usertable,974733,123161,1268269056,16893,public,usertable,1,0,2535888,4279484,1050376,60127,75643,27269,974733,123161,1186146,1050376,,,,,0,0,0,0
1650450681.1949313,public.usertable,975131,123183,1268760576,16893,public,usertable,1,0,2536967,4280366,1050785,60141,75654,27273,975131,123183,1186580,1050785,,,,,0,0,0,0
1650450682.2250562,public.usertable,975711,123210,1269260288,16893,public,usertable,1,0,2538569,4281293,1051384,60155,75673,27278,975711,123210,1187212,1051384,,,,,0,0,0,0
1650450683.253993,public.usertable,976106,123229,1269743616,16893,public,usertable,1,0,2539663,4281660,1051792,60161,75686,27281,976106,123229,1187639,1051792,,,,,0,0,0,0
1650450684.2844021,public.usertable,976497,123246,1270243328,16893,public,usertable,1,0,2540891,4282307,1052197,60170,75700,27285,976497,123246,1188067,1052197,,,,,0,0,0,0
1650450685.3137426,public.usertable,976882,123268,1270726656,16893,public,usertable,1,0,2542091,4282917,1052594,60183,75712,27293,976882,123268,1188489,1052594,,,,,0,0,0,0
1650450686.3428226,public.usertable,977265,123286,1271209984,16893,public,usertable,1,0,2543083,4283390,1052987,60191,75722,27294,977265,123286,1188900,1052987,,,,,0,0,0,0
1650450687.374139,public.usertable,977721,123304,1271783424,16893,public,usertable,1,0,2544295,4283634,1053457,60199,75736,27298,977721,123304,1189392,1053457,,,,,0,0,0,0
1650450688.4075391,public.usertable,978108,123333,1272274944,16893,public,usertable,1,0,2545435,4283983,1053864,60211,75756,27304,978108,123333,1189831,1053864,,,,,0,0,0,0
1650450689.439666,public.usertable,978471,123354,1272725504,16893,public,usertable,1,0,2546513,4284585,1054241,60218,75770,27307,978471,123354,1190229,1054241,,,,,0,0,0,0
1650450690.4679577,public.usertable,978836,123367,1273176064,16893,public,usertable,1,0,2547482,4285119,1054616,60223,75780,27309,978836,123367,1190619,1054616,,,,,0,0,0,0
1650450691.497727,public.usertable,979188,123383,1273618432,16893,public,usertable,1,0,2548535,4285443,1054975,60232,75787,27314,979188,123383,1190994,1054975,,,,,0,0,0,0
1650450692.5282657,public.usertable,979567,123399,1274085376,16893,public,usertable,1,0,2549717,4286082,1055366,60241,75799,27318,979567,123399,1191406,1055366,,,,,0,0,0,0
1650450693.5578384,public.usertable,979927,123419,1274544128,16893,public,usertable,1,0,2550605,4286333,1055739,60248,75812,27322,979927,123419,1191799,1055739,,,,,0,0,0,0
1650450694.587376,public.usertable,980258,123442,1274970112,16893,public,usertable,1,0,2551652,4287023,1056083,60259,75825,27329,980258,123442,1192167,1056083,,,,,0,0,0,0
1650450695.6172485,public.usertable,980620,123459,1275420672,16893,public,usertable,1,0,2552585,4287312,1056453,60268,75833,27334,980620,123459,1192554,1056453,,,,,0,0,0,0
1650450696.6462321,public.usertable,980968,123481,1275846656,16893,public,usertable,1,0,2553589,4287889,1056815,60276,75847,27338,980968,123481,1192938,1056815,,,,,0,0,0,0
1650450697.6746507,public.usertable,981276,123504,1276215296,16893,public,usertable,1,0,2554443,4288640,1057137,60286,75861,27345,981276,123504,1193284,1057137,,,,,0,0,0,0
1650450698.705652,public.usertable,981619,123514,1276657664,16893,public,usertable,1,0,2555329,4289097,1057487,60294,75868,27348,981619,123514,1193649,1057487,,,,,0,0,0,0
1650450699.7358513,public.usertable,981974,123537,1277100032,16893,public,usertable,1,0,2556291,4289918,1057853,60306,75879,27350,981974,123537,1194038,1057853,,,,,0,0,0,0
1650450700.7680302,public.usertable,982514,123552,1277566976,16893,public,usertable,1,0,2557807,4291373,1058404,60317,75890,27357,982514,123552,1194611,1058404,,,,,0,0,0,0
1650450701.7986724,public.usertable,982880,123567,1278017536,16893,public,usertable,1,0,2558820,4291682,1058774,60328,75894,27365,982880,123567,1194996,1058774,,,,,0,0,0,0
1650450702.828125,public.usertable,983238,123581,1278468096,16893,public,usertable,1,0,2559812,4292169,1059139,60336,75901,27370,983238,123581,1195376,1059139,,,,,0,0,0,0
1650450703.8580108,public.usertable,983646,123593,1278967808,16893,public,usertable,1,0,2560870,4293107,1059556,60344,75910,27375,983646,123593,1195810,1059556,,,,,0,0,0,0
1650450704.8877065,public.usertable,984032,123610,1279451136,16893,public,usertable,1,0,2561935,4293479,1059956,60352,75924,27381,984032,123610,1196232,1059956,,,,,0,0,0,0
1650450705.9188662,public.usertable,984426,123637,1279942656,16893,public,usertable,1,0,2563035,4293970,1060360,60369,75934,27391,984426,123637,1196663,1060360,,,,,0,0,0,0
1650450706.9538393,public.usertable,984834,123650,1280450560,16893,public,usertable,1,0,2564205,4294820,1060781,60375,75947,27395,984834,123650,1197103,1060781,,,,,0,0,0,0
1650450707.986926,public.usertable,985243,123666,1280958464,16893,public,usertable,1,0,2565265,4295118,1061196,60385,75953,27401,985243,123666,1197534,1061196,,,,,0,0,0,0
1650450709.0148578,public.usertable,985617,123696,1281441792,16893,public,usertable,1,0,2566270,4295699,1061587,60401,75970,27410,985617,123696,1197958,1061587,,,,,0,0,0,0
1650450710.0430064,public.usertable,986019,123715,1281949696,16893,public,usertable,1,0,2567370,4296875,1062000,60410,75981,27415,986019,123715,1198391,1062000,,,,,0,0,0,0
1650450711.0727487,public.usertable,986406,123735,1282424832,16893,public,usertable,1,0,2568499,4297020,1062401,60419,75995,27421,986406,123735,1198815,1062401,,,,,0,0,0,0
1650450712.1024487,public.usertable,986757,123753,1282818048,16893,public,usertable,1,0,2569374,4297470,1062764,60425,76007,27423,986757,123753,1199196,1062764,,,,,0,0,0,0
1650450713.1320052,public.usertable,987089,123765,1283260416,16893,public,usertable,1,0,2570280,4298145,1063105,60430,76016,27428,987089,123765,1199551,1063105,,,,,0,0,0,0
1650450714.1604388,public.usertable,987454,123776,1283710976,16893,public,usertable,1,0,2571238,4298559,1063475,60441,76021,27435,987454,123776,1199937,1063475,,,,,0,0,0,0
1650450715.1898081,public.usertable,987815,123791,1284161536,16893,public,usertable,1,0,2572137,4299157,1063845,60453,76030,27440,987815,123791,1200328,1063845,,,,,0,0,0,0
1650450716.2197084,public.usertable,988173,123811,1284620288,16893,public,usertable,1,0,2573138,4299946,1064220,60460,76047,27444,988173,123811,1200727,1064220,,,,,0,0,0,0
1650450717.2503252,public.usertable,988506,123828,1285062656,16893,public,usertable,1,0,2574012,4300057,1064562,60468,76056,27450,988506,123828,1201086,1064562,,,,,0,0,0,0
1650450718.2809963,public.usertable,988892,123842,1285529600,16893,public,usertable,1,0,2575104,4301315,1064956,60474,76064,27453,988892,123842,1201494,1064956,,,,,0,0,0,0
1650450719.309344,public.usertable,989465,123858,1285996544,16893,public,usertable,1,0,2576682,4302197,1065541,60484,76076,27458,989465,123858,1202101,1065541,,,,,0,0,0,0
1650450720.3415792,public.usertable,989865,123867,1286488064,16893,public,usertable,1,0,2577744,4303077,1065950,60494,76085,27466,989865,123867,1202529,1065950,,,,,0,0,0,0
1650450721.37107,public.usertable,990250,123886,1286971392,16893,public,usertable,1,0,2578769,4303794,1066347,60504,76097,27471,990250,123886,1202948,1066347,,,,,0,0,0,0
1650450722.4017568,public.usertable,990635,123906,1287454720,16893,public,usertable,1,0,2579831,4304299,1066744,60514,76109,27472,990635,123906,1203367,1066744,,,,,0,0,0,0
1650450723.4311237,public.usertable,991002,123923,1287913472,16893,public,usertable,1,0,2580942,4304715,1067120,60522,76118,27478,991002,123923,1203760,1067120,,,,,0,0,0,0
1650450724.4639118,public.usertable,991377,123934,1288380416,16893,public,usertable,1,0,2581968,4305245,1067505,60526,76128,27479,991377,123934,1204159,1067505,,,,,0,0,0,0
1650450725.4949834,public.usertable,991744,123948,1288830976,16893,public,usertable,1,0,2582955,4305622,1067880,60532,76136,27482,991744,123948,1204548,1067880,,,,,0,0,0,0
1650450726.5272574,public.usertable,992116,123962,1289297920,16893,public,usertable,1,0,2584022,4305947,1068263,60535,76147,27483,992116,123962,1204945,1068263,,,,,0,0,0,0
1650450727.5572162,public.usertable,992486,123983,1289756672,16893,public,usertable,1,0,2585086,4306464,1068645,60544,76159,27484,992486,123983,1205348,1068645,,,,,0,0,0,0
1650450728.5863538,public.usertable,992843,124004,1290199040,16893,public,usertable,1,0,2586025,4307176,1069014,60557,76171,27489,992843,124004,1205742,1069014,,,,,0,0,0,0
1650450729.6153715,public.usertable,993206,124026,1290674176,16893,public,usertable,1,0,2587062,4308071,1069392,60564,76186,27494,993206,124026,1206142,1069392,,,,,0,0,0,0
1650450730.6447172,public.usertable,993562,124052,1291108352,16893,public,usertable,1,0,2588111,4308740,1069762,60577,76200,27502,993562,124052,1206539,1069762,,,,,0,0,0,0
1650450731.673601,public.usertable,993912,124074,1291558912,16893,public,usertable,1,0,2589143,4309364,1070127,60587,76215,27508,993912,124074,1206929,1070127,,,,,0,0,0,0
1650450732.7029784,public.usertable,994267,124093,1292017664,16893,public,usertable,1,0,2590120,4309652,1070492,60596,76225,27512,994267,124093,1207313,1070492,,,,,0,0,0,0
1650450733.7335653,public.usertable,994629,124105,1292468224,16893,public,usertable,1,0,2591130,4309891,1070866,60608,76237,27518,994629,124105,1207711,1070866,,,,,0,0,0,0
1650450734.7641447,public.usertable,995002,124120,1292935168,16893,public,usertable,1,0,2592213,4310196,1071247,60619,76245,27523,995002,124120,1208111,1071247,,,,,0,0,0,0
1650450735.793833,public.usertable,995391,124132,1293410304,16893,public,usertable,1,0,2593203,4310929,1071646,60628,76255,27527,995391,124132,1208529,1071646,,,,,0,0,0,0
1650450736.8228528,public.usertable,995783,124150,1293910016,16893,public,usertable,1,0,2594140,4311218,1072047,60637,76264,27530,995783,124150,1208948,1072047,,,,,0,0,0,0
1650450737.858301,public.usertable,996156,124167,1294376960,16893,public,usertable,1,0,2595226,4311539,1072429,60645,76273,27537,996156,124167,1209347,1072429,,,,,0,0,0,0
1650450738.8890548,public.usertable,996528,124184,1294819328,16893,public,usertable,1,0,2596261,4312618,1072812,60655,76284,27546,996528,124184,1209751,1072812,,,,,0,0,0,0
1650450739.9198256,public.usertable,997093,124205,1295294464,16893,public,usertable,1,0,2597796,4314422,1073388,60669,76295,27554,997093,124205,1210352,1073388,,,,,0,0,0,0
1650450740.9489717,public.usertable,997429,124222,1295720448,16893,public,usertable,1,0,2598852,4314490,1073737,60674,76308,27557,997429,124222,1210719,1073737,,,,,0,0,0,0
1650450741.9794269,public.usertable,997765,124243,1296121856,16893,public,usertable,1,0,2599818,4315316,1074082,60686,76317,27562,997765,124243,1211085,1074082,,,,,0,0,0,0
1650450743.0076063,public.usertable,998105,124263,1296572416,16893,public,usertable,1,0,2600907,4315873,1074432,60697,76327,27565,998105,124263,1211456,1074432,,,,,0,0,0,0
1650450744.0367112,public.usertable,998459,124278,1297014784,16893,public,usertable,1,0,2601887,4316633,1074790,60708,76331,27570,998459,124278,1211829,1074790,,,,,0,0,0,0
1650450745.0652425,public.usertable,998814,124285,1297440768,16893,public,usertable,1,0,2602890,4317327,1075159,60710,76345,27570,998814,124285,1212214,1075159,,,,,0,0,0,0
1650450746.0953047,public.usertable,999170,124303,1297915904,16893,public,usertable,1,0,2603968,4317741,1075525,60718,76355,27576,999170,124303,1212598,1075525,,,,,0,0,0,0
1650450747.134422,public.usertable,999568,124318,1298391040,16893,public,usertable,1,0,2605047,4319176,1075931,60728,76363,27581,999568,124318,1213022,1075931,,,,,0,0,0,0
1650450748.1626287,public.usertable,999910,124333,1298792448,16893,public,usertable,1,0,2605913,4319243,1076280,60738,76370,27585,999910,124333,1213388,1076280,,,,,0,0,0,0
1650450749.192482,public.usertable,1000254,124354,1299243008,16893,public,usertable,1,0,2606847,4319839,1076637,60748,76383,27589,1000254,124354,1213768,1076637,,,,,0,0,0,0
1650450750.2219565,public.usertable,1000625,124365,1299693568,16893,public,usertable,1,0,2607836,4320599,1077015,60754,76390,27592,1000625,124365,1214159,1077015,,,,,0,0,0,0
1650450751.2581112,public.usertable,1000943,124387,1300086784,16893,public,usertable,1,0,2608772,4321668,1077347,60764,76404,27595,1000943,124387,1214515,1077347,,,,,0,0,0,0
1650450752.2863104,public.usertable,1001271,124404,1300537344,16893,public,usertable,1,0,2609651,4322160,1077683,60776,76412,27601,1001271,124404,1214871,1077683,,,,,0,0,0,0
1650450753.3175938,public.usertable,1001559,124412,1300873216,16893,public,usertable,1,0,2610436,4323005,1077979,60778,76420,27602,1001559,124412,1215177,1077979,,,,,0,0,0,0
1650450754.3479936,public.usertable,1001831,124424,1301184512,16893,public,usertable,1,0,2611200,4323196,1078259,60782,76428,27605,1001831,124424,1215469,1078259,,,,,0,0,0,0
1650450755.3773942,public.usertable,1002098,124441,1301471232,16893,public,usertable,1,0,2611935,4323490,1078539,60787,76441,27609,1002098,124441,1215767,1078539,,,,,0,0,0,0
1650450756.4064596,public.usertable,1002297,124446,1301733376,16893,public,usertable,1,0,2612585,4323774,1078742,60788,76445,27610,1002297,124446,1215975,1078742,,,,,0,0,0,0
1650450757.435907,public.usertable,1002508,124452,1301970944,16893,public,usertable,1,0,2613089,4324010,1078959,60789,76451,27610,1002508,124452,1216199,1078959,,,,,0,0,0,0
1650450758.465268,public.usertable,1002714,124466,1302282240,16893,public,usertable,1,0,2613666,4324116,1079169,60799,76455,27614,1002714,124466,1216423,1079169,,,,,0,0,0,0
1650450759.496417,public.usertable,1002930,124475,1302519808,16893,public,usertable,1,0,2614266,4324724,1079392,60801,76462,27616,1002930,124475,1216655,1079392,,,,,0,0,0,0
1650450760.5249498,public.usertable,1003271,124488,1302806528,16893,public,usertable,1,0,2615169,4325258,1079740,60812,76469,27623,1003271,124488,1217021,1079740,,,,,0,0,0,0
1650450761.5555112,public.usertable,1003599,124505,1303224320,16893,public,usertable,1,0,2616024,4325866,1080075,60822,76476,27629,1003599,124505,1217373,1080075,,,,,0,0,0,0
1650450762.5847332,public.usertable,1003988,124518,1303707648,16893,public,usertable,1,0,2617055,4326503,1080471,60828,76483,27630,1003988,124518,1217782,1080471,,,,,0,0,0,0
1650450763.6170757,public.usertable,1004405,124530,1304215552,16893,public,usertable,1,0,2618057,4326973,1080896,60832,76491,27631,1004405,124530,1218219,1080896,,,,,0,0,0,0
1650450764.647667,public.usertable,1004779,124548,1304698880,16893,public,usertable,1,0,2619195,4327871,1081285,60844,76506,27637,1004779,124548,1218635,1081285,,,,,0,0,0,0
1650450765.6763842,public.usertable,1005168,124565,1305182208,16893,public,usertable,1,0,2620337,4328438,1081688,60849,76520,27640,1005168,124565,1219057,1081688,,,,,0,0,0,0
1650450766.7067094,public.usertable,1005537,124584,1305632768,16893,public,usertable,1,0,2621384,4328895,1082070,60859,76533,27644,1005537,124584,1219462,1082070,,,,,0,0,0,0
1650450767.7374165,public.usertable,1005902,124599,1306099712,16893,public,usertable,1,0,2622340,4329819,1082445,60868,76543,27646,1005902,124599,1219856,1082445,,,,,0,0,0,0
1650450768.7655613,public.usertable,1006284,124606,1306591232,16893,public,usertable,1,0,2623311,4330650,1082830,60876,76546,27649,1006284,124606,1220252,1082830,,,,,0,0,0,0
1650450769.7970552,public.usertable,1006693,124614,1307074560,16893,public,usertable,1,0,2624350,4331162,1083244,60879,76551,27652,1006693,124614,1220674,1083244,,,,,0,0,0,0
1650450770.8290842,public.usertable,1007067,124629,1307533312,16893,public,usertable,1,0,2625446,4331731,1083625,60889,76558,27656,1007067,124629,1221072,1083625,,,,,0,0,0,0
1650450771.858569,public.usertable,1007453,124647,1308024832,16893,public,usertable,1,0,2626591,4332362,1084022,60900,76569,27660,1007453,124647,1221491,1084022,,,,,0,0,0,0
1650450772.8883781,public.usertable,1007844,124663,1308516352,16893,public,usertable,1,0,2627730,4333234,1084425,60904,76581,27661,1007844,124663,1221910,1084425,,,,,0,0,0,0
1650450773.9183948,public.usertable,1008225,124682,1308999680,16893,public,usertable,1,0,2628825,4334456,1084821,60914,76596,27668,1008225,124682,1222331,1084821,,,,,0,0,0,0
1650450774.948717,public.usertable,1008623,124696,1309483008,16893,public,usertable,1,0,2629863,4334663,1085229,60918,76606,27669,1008623,124696,1222753,1085229,,,,,0,0,0,0
1650450775.977722,public.usertable,1009006,124709,1309982720,16893,public,usertable,1,0,2630987,4335454,1085622,60924,76616,27674,1009006,124709,1223162,1085622,,,,,0,0,0,0
1650450777.0084326,public.usertable,1009407,124723,1310457856,16893,public,usertable,1,0,2632117,4335793,1086034,60927,76627,27675,1009407,124723,1223588,1086034,,,,,0,0,0,0
1650450778.037801,public.usertable,1009814,124739,1310965760,16893,public,usertable,1,0,2633162,4336624,1086453,60936,76639,27680,1009814,124739,1224028,1086453,,,,,0,0,0,0
1650450779.066547,public.usertable,1010383,124767,1311440896,16893,public,usertable,1,0,2634708,4337277,1087034,60952,76651,27685,1010383,124767,1224637,1087034,,,,,0,0,0,0
1650450780.0975761,public.usertable,1010768,124785,1311924224,16893,public,usertable,1,0,2635819,4337485,1087433,60959,76665,27688,1010768,124785,1225057,1087433,,,,,0,0,0,0
1650450781.1291018,public.usertable,1011166,124803,1312423936,16893,public,usertable,1,0,2636839,4337686,1087842,60966,76676,27690,1011166,124803,1225484,1087842,,,,,0,0,0,0
1650450782.159019,public.usertable,1011576,124818,1312931840,16893,public,usertable,1,0,2637887,4338043,1088262,60973,76686,27693,1011576,124818,1225921,1088262,,,,,0,0,0,0
1650450783.1897295,public.usertable,1011945,124831,1313398784,16893,public,usertable,1,0,2638946,4338652,1088639,60981,76694,27695,1011945,124831,1226314,1088639,,,,,0,0,0,0
1650450784.2214806,public.usertable,1012335,124844,1313873920,16893,public,usertable,1,0,2640010,4339537,1089037,60993,76702,27702,1012335,124844,1226732,1089037,,,,,0,0,0,0
1650450785.2499337,public.usertable,1012705,124859,1314332672,16893,public,usertable,1,0,2641025,4340226,1089417,61002,76712,27707,1012705,124859,1227131,1089417,,,,,0,0,0,0
1650450786.2783134,public.usertable,1013077,124873,1314816000,16893,public,usertable,1,0,2642044,4340760,1089801,61008,76724,27712,1013077,124873,1227533,1089801,,,,,0,0,0,0
1650450787.3071115,public.usertable,1013457,124890,1315266560,16893,public,usertable,1,0,2642977,4341378,1090197,61012,76740,27716,1013457,124890,1227949,1090197,,,,,0,0,0,0
1650450788.3356786,public.usertable,1013837,124896,1315741696,16893,public,usertable,1,0,2644089,4342402,1090583,61021,76746,27721,1013837,124896,1228350,1090583,,,,,0,0,0,0
1650450789.3660746,public.usertable,1014194,124913,1316184064,16893,public,usertable,1,0,2645067,4342940,1090950,61034,76756,27726,1014194,124913,1228740,1090950,,,,,0,0,0,0
1650450790.400471,public.usertable,1014517,124927,1316593664,16893,public,usertable,1,0,2645968,4343169,1091280,61041,76763,27727,1014517,124927,1229084,1091280,,,,,0,0,0,0
1650450791.4314988,public.usertable,1014887,124942,1317060608,16893,public,usertable,1,0,2646941,4343651,1091658,61048,76771,27730,1014887,124942,1229477,1091658,,,,,0,0,0,0
1650450792.4623168,public.usertable,1015224,124962,1317462016,16893,public,usertable,1,0,2647828,4344596,1092006,61058,76782,27733,1015224,124962,1229846,1092006,,,,,0,0,0,0
1650450793.4935343,public.usertable,1015492,124966,1317822464,16893,public,usertable,1,0,2648597,4345308,1092277,61064,76785,27736,1015492,124966,1230126,1092277,,,,,0,0,0,0
1650450794.5257506,public.usertable,1015869,124984,1318297600,16893,public,usertable,1,0,2649595,4345566,1092664,61073,76795,27739,1015869,124984,1230532,1092664,,,,,0,0,0,0
1650450795.556455,public.usertable,1016244,125002,1318739968,16893,public,usertable,1,0,2650656,4346787,1093048,61087,76804,27745,1016244,125002,1230939,1093048,,,,,0,0,0,0
1650450796.5877762,public.usertable,1016527,125014,1319100416,16893,public,usertable,1,0,2651376,4347033,1093339,61091,76812,27747,1016527,125014,1231242,1093339,,,,,0,0,0,0
1650450797.617105,public.usertable,1016980,125027,1319452672,16893,public,usertable,1,0,2652580,4347696,1093803,61096,76823,27750,1016980,125027,1231722,1093803,,,,,0,0,0,0
1650450798.6452913,public.usertable,1017240,125044,1319780352,16893,public,usertable,1,0,2653291,4347958,1094070,61106,76830,27755,1017240,125044,1232006,1094070,,,,,0,0,0,0
1650450799.676217,public.usertable,1017499,125049,1320099840,16893,public,usertable,1,0,2654054,4348457,1094335,61109,76836,27756,1017499,125049,1232280,1094335,,,,,0,0,0,0
1650450800.7085028,public.usertable,1017748,125062,1320419328,16893,public,usertable,1,0,2654826,4349124,1094596,61115,76848,27760,1017748,125062,1232559,1094596,,,,,0,0,0,0
1650450801.737508,public.usertable,1018003,125065,1320730624,16893,public,usertable,1,0,2655510,4349661,1094858,61119,76855,27762,1018003,125065,1232832,1094858,,,,,0,0,0,0
1650450802.7673855,public.usertable,1018248,125078,1321041920,16893,public,usertable,1,0,2656248,4350212,1095112,61125,76864,27765,1018248,125078,1233101,1095112,,,,,0,0,0,0
1650450803.7974133,public.usertable,1018489,125091,1321361408,16893,public,usertable,1,0,2656903,4350890,1095359,61132,76870,27770,1018489,125091,1233361,1095359,,,,,0,0,0,0
1650450804.8275046,public.usertable,1018828,125104,1321762816,16893,public,usertable,1,0,2657735,4351329,1095709,61137,76881,27772,1018828,125104,1233727,1095709,,,,,0,0,0,0
1650450805.85839,public.usertable,1019125,125115,1322123264,16893,public,usertable,1,0,2658510,4351715,1096011,61143,76886,27774,1019125,125115,1234040,1096011,,,,,0,0,0,0
1650450806.8881948,public.usertable,1019465,125137,1322532864,16893,public,usertable,1,0,2659424,4352175,1096362,61154,76897,27779,1019465,125137,1234413,1096362,,,,,0,0,0,0
1650450807.9171376,public.usertable,1019779,125148,1322975232,16893,public,usertable,1,0,2660215,4352313,1096682,61159,76903,27782,1019779,125148,1234744,1096682,,,,,0,0,0,0
1650450808.948028,public.usertable,1020159,125157,1323409408,16893,public,usertable,1,0,2661301,4353263,1097073,61167,76914,27786,1020159,125157,1235154,1097073,,,,,0,0,0,0
1650450809.9773905,public.usertable,1020512,125169,1323900928,16893,public,usertable,1,0,2662207,4353640,1097435,61173,76923,27787,1020512,125169,1235531,1097435,,,,,0,0,0,0
1650450811.0114834,public.usertable,1020904,125181,1324359680,16893,public,usertable,1,0,2663285,4354360,1097835,61181,76931,27791,1020904,125181,1235947,1097835,,,,,0,0,0,0
1650450812.041071,public.usertable,1021260,125204,1324826624,16893,public,usertable,1,0,2664313,4355109,1098208,61187,76948,27793,1021260,125204,1236343,1098208,,,,,0,0,0,0
1650450813.0718446,public.usertable,1021621,125218,1325277184,16893,public,usertable,1,0,2665326,4356628,1098578,61201,76957,27797,1021621,125218,1236736,1098578,,,,,0,0,0,0
1650450814.1025283,public.usertable,1021967,125227,1325719552,16893,public,usertable,1,0,2666289,4357190,1098932,61206,76965,27799,1021967,125227,1237103,1098932,,,,,0,0,0,0
1650450815.1337419,public.usertable,1022357,125247,1326211072,16893,public,usertable,1,0,2667344,4357916,1099337,61212,76980,27803,1022357,125247,1237529,1099337,,,,,0,0,0,0
1650450816.16363,public.usertable,1022743,125275,1326710784,16893,public,usertable,1,0,2668417,4358236,1099741,61222,76998,27806,1022743,125275,1237961,1099741,,,,,0,0,0,0
1650450817.19504,public.usertable,1023338,125310,1327210496,16893,public,usertable,1,0,2670132,4359277,1100356,61238,77018,27815,1023338,125310,1238612,1100356,,,,,0,0,0,0
1650450818.2245953,public.usertable,1023753,125332,1327726592,16893,public,usertable,1,0,2671231,4359665,1100779,61252,77026,27821,1023753,125332,1239057,1100779,,,,,0,0,0,0
1650450819.257181,public.usertable,1024140,125348,1328218112,16893,public,usertable,1,0,2672246,4360789,1101181,61260,77041,27825,1024140,125348,1239482,1101181,,,,,0,0,0,0
1650450820.2866805,public.usertable,1024542,125363,1328717824,16893,public,usertable,1,0,2673365,4361550,1101594,61272,77052,27830,1024542,125363,1239918,1101594,,,,,0,0,0,0
1650450821.3155115,public.usertable,1024919,125379,1329184768,16893,public,usertable,1,0,2674456,4362077,1101977,61282,77058,27835,1024919,125379,1240317,1101977,,,,,0,0,0,0
1650450822.3446052,public.usertable,1025323,125392,1329692672,16893,public,usertable,1,0,2675549,4362754,1102389,61288,77066,27836,1025323,125392,1240743,1102389,,,,,0,0,0,0
1650450823.3738487,public.usertable,1025721,125411,1330192384,16893,public,usertable,1,0,2676628,4363366,1102801,61297,77080,27841,1025721,125411,1241178,1102801,,,,,0,0,0,0
1650450824.402883,public.usertable,1026070,125434,1330618368,16893,public,usertable,1,0,2677552,4363515,1103164,61306,77094,27845,1026070,125434,1241564,1103164,,,,,0,0,0,0
1650450825.4316468,public.usertable,1026430,125448,1331093504,16893,public,usertable,1,0,2678568,4364121,1103529,61319,77099,27851,1026430,125448,1241947,1103529,,,,,0,0,0,0
1650450826.4645941,public.usertable,1026830,125457,1331593216,16893,public,usertable,1,0,2679691,4364503,1103939,61330,77109,27857,1026830,125457,1242378,1103939,,,,,0,0,0,0
1650450827.4936104,public.usertable,1027226,125472,1332084736,16893,public,usertable,1,0,2680795,4365219,1104347,61338,77121,27861,1027226,125472,1242806,1104347,,,,,0,0,0,0
1650450828.5217354,public.usertable,1027626,125484,1332576256,16893,public,usertable,1,0,2681907,4365755,1104758,61342,77132,27863,1027626,125484,1243232,1104758,,,,,0,0,0,0
1650450829.5515933,public.usertable,1027990,125498,1333035008,16893,public,usertable,1,0,2682944,4366479,1105134,61351,77144,27865,1027990,125498,1243629,1105134,,,,,0,0,0,0
1650450830.580151,public.usertable,1028382,125516,1333526528,16893,public,usertable,1,0,2684046,4366967,1105539,61357,77157,27868,1028382,125516,1244053,1105539,,,,,0,0,0,0
1650450831.6090322,public.usertable,1028769,125529,1334001664,16893,public,usertable,1,0,2685093,4367632,1105936,61364,77167,27873,1028769,125529,1244467,1105936,,,,,0,0,0,0
1650450832.6371088,public.usertable,1029144,125546,1334484992,16893,public,usertable,1,0,2686154,4368866,1106327,61373,77183,27876,1029144,125546,1244883,1106327,,,,,0,0,0,0
1650450833.6662874,public.usertable,1029525,125566,1334951936,16893,public,usertable,1,0,2687256,4369040,1106717,61386,77192,27883,1029525,125566,1245295,1106717,,,,,0,0,0,0
1650450834.6957192,public.usertable,1029889,125583,1335435264,16893,public,usertable,1,0,2688274,4370036,1107092,61392,77203,27884,1029889,125583,1245687,1107092,,,,,0,0,0,0
1650450835.7269926,public.usertable,1030474,125604,1335910400,16893,public,usertable,1,0,2689877,4370474,1107688,61403,77214,27887,1030474,125604,1246305,1107688,,,,,0,0,0,0
1650450836.758696,public.usertable,1030866,125620,1336393728,16893,public,usertable,1,0,2690956,4371033,1108091,61411,77225,27890,1030866,125620,1246727,1108091,,,,,0,0,0,0
1650450837.7954133,public.usertable,1031237,125633,1336868864,16893,public,usertable,1,0,2691954,4371461,1108471,61417,77234,27894,1031237,125633,1247122,1108471,,,,,0,0,0,0
1650450838.824197,public.usertable,1031656,125646,1337376768,16893,public,usertable,1,0,2692984,4372224,1108896,61425,77240,27899,1031656,125646,1247561,1108896,,,,,0,0,0,0
1650450839.8554468,public.usertable,1032021,125657,1337835520,16893,public,usertable,1,0,2694069,4372552,1109270,61429,77249,27900,1032021,125657,1247948,1109270,,,,,0,0,0,0
1650450840.8856113,public.usertable,1032404,125676,1338302464,16893,public,usertable,1,0,2695124,4373036,1109660,61442,77256,27909,1032404,125676,1248358,1109660,,,,,0,0,0,0
1650450841.9149058,public.usertable,1032773,125693,1338744832,16893,public,usertable,1,0,2696083,4374041,1110038,61452,77265,27915,1032773,125693,1248755,1110038,,,,,0,0,0,0
1650450842.944805,public.usertable,1033150,125706,1339219968,16893,public,usertable,1,0,2696978,4374265,1110423,61457,77273,27919,1033150,125706,1249153,1110423,,,,,0,0,0,0
1650450843.9775012,public.usertable,1033525,125706,1339678720,16893,public,usertable,1,0,2698008,4375079,1110802,61467,77277,27926,1033525,125706,1249546,1110802,,,,,0,0,0,0
1650450845.0061097,public.usertable,1033876,125735,1340137472,16893,public,usertable,1,0,2699019,4375263,1111169,61480,77293,27935,1033876,125735,1249942,1111169,,,,,0,0,0,0
1650450846.035099,public.usertable,1034256,125753,1340620800,16893,public,usertable,1,0,2699964,4375714,1111561,61487,77305,27938,1034256,125753,1250353,1111561,,,,,0,0,0,0
1650450847.0670714,public.usertable,1034624,125765,1341054976,16893,public,usertable,1,0,2700837,4375994,1111936,61492,77312,27941,1034624,125765,1250740,1111936,,,,,0,0,0,0
1650450848.0966246,public.usertable,1034962,125780,1341464576,16893,public,usertable,1,0,2701747,4377097,1112286,61497,77324,27945,1034962,125780,1251107,1112286,,,,,0,0,0,0
1650450849.1253061,public.usertable,1035280,125796,1341833216,16893,public,usertable,1,0,2702627,4377478,1112616,61505,77336,27949,1035280,125796,1251457,1112616,,,,,0,0,0,0
1650450850.155793,public.usertable,1035592,125809,1342251008,16893,public,usertable,1,0,2703426,4377865,1112933,61513,77341,27952,1035592,125809,1251787,1112933,,,,,0,0,0,0
1650450851.1871307,public.usertable,1035896,125820,1342586880,16893,public,usertable,1,0,2704221,4377937,1113246,61516,77350,27953,1035896,125820,1252112,1113246,,,,,0,0,0,0
1650450852.215516,public.usertable,1036123,125832,1342947328,16893,public,usertable,1,0,2704849,4378650,1113483,61522,77360,27956,1036123,125832,1252365,1113483,,,,,0,0,0,0
1650450853.2476885,public.usertable,1036434,125851,1343356928,16893,public,usertable,1,0,2705751,4379082,1113804,61531,77370,27960,1036434,125851,1252705,1113804,,,,,0,0,0,0
1650450854.2778738,public.usertable,1036978,125880,1343799296,16893,public,usertable,1,0,2707213,4380064,1114366,61544,77388,27965,1036978,125880,1253298,1114366,,,,,0,0,0,0
1650450855.3058016,public.usertable,1037284,125887,1344167936,16893,public,usertable,1,0,2708059,4380477,1114680,61548,77396,27967,1037284,125887,1253624,1114680,,,,,0,0,0,0
1650450856.336216,public.usertable,1037476,125895,1344405504,16893,public,usertable,1,0,2708597,4380636,1114876,61552,77400,27969,1037476,125895,1253828,1114876,,,,,0,0,0,0
1650450857.3647935,public.usertable,1037701,125901,1344692224,16893,public,usertable,1,0,2709199,4380715,1115105,61557,77404,27971,1037701,125901,1254066,1115105,,,,,0,0,0,0
1650450858.3943002,public.usertable,1037972,125914,1345036288,16893,public,usertable,1,0,2709997,4381812,1115384,61564,77412,27975,1037972,125914,1254360,1115384,,,,,0,0,0,0
1650450859.4274259,public.usertable,1038280,125930,1345429504,16893,public,usertable,1,0,2710857,4382154,1115703,61573,77423,27979,1038280,125930,1254699,1115703,,,,,0,0,0,0
1650450860.4593751,public.usertable,1038585,125951,1345822720,16893,public,usertable,1,0,2711771,4382935,1116022,61580,77437,27981,1038585,125951,1255039,1116022,,,,,0,0,0,0
1650450861.487758,public.usertable,1038909,125965,1346224128,16893,public,usertable,1,0,2712680,4383476,1116357,61584,77448,27982,1038909,125965,1255389,1116357,,,,,0,0,0,0
1650450862.5201004,public.usertable,1039232,125975,1346617344,16893,public,usertable,1,0,2713616,4384166,1116691,61584,77459,27982,1039232,125975,1255734,1116691,,,,,0,0,0,0
1650450863.5490632,public.usertable,1039534,125990,1346985984,16893,public,usertable,1,0,2714480,4384405,1117003,61591,77469,27986,1039534,125990,1256063,1117003,,,,,0,0,0,0
1650450864.5799482,public.usertable,1039808,126004,1347346432,16893,public,usertable,1,0,2715253,4384660,1117289,61598,77481,27989,1039808,126004,1256368,1117289,,,,,0,0,0,0
1650450865.6106384,public.usertable,1040144,126015,1347813376,16893,public,usertable,1,0,2716075,4384779,1117634,61605,77490,27993,1040144,126015,1256729,1117634,,,,,0,0,0,0
1650450866.6426408,public.usertable,1040544,126036,1348321280,16893,public,usertable,1,0,2717193,4385151,1118050,61610,77506,27995,1040544,126036,1257166,1118050,,,,,0,0,0,0
1650450867.6716132,public.usertable,1040955,126058,1348812800,16893,public,usertable,1,0,2718375,4386365,1118472,61624,77517,28001,1040955,126058,1257613,1118472,,,,,0,0,0,0
1650450868.7011228,public.usertable,1041326,126078,1349279744,16893,public,usertable,1,0,2719506,4387181,1118858,61633,77532,28005,1041326,126078,1258023,1118858,,,,,0,0,0,0
1650450869.7304103,public.usertable,1041696,126096,1349730304,16893,public,usertable,1,0,2720548,4388338,1119237,61646,77541,28013,1041696,126096,1258424,1119237,,,,,0,0,0,0
1650450870.7597542,public.usertable,1042052,126108,1350172672,16893,public,usertable,1,0,2721511,4389242,1119602,61653,77550,28016,1042052,126108,1258805,1119602,,,,,0,0,0,0
1650450871.7887816,public.usertable,1042421,126126,1350656000,16893,public,usertable,1,0,2722557,4389452,1119978,61664,77557,28023,1042421,126126,1259199,1119978,,,,,0,0,0,0
1650450872.8177927,public.usertable,1042822,126143,1351147520,16893,public,usertable,1,0,2723712,4389883,1120391,61669,77569,28025,1042822,126143,1259629,1120391,,,,,0,0,0,0
1650450873.8483782,public.usertable,1043367,126172,1351598080,16893,public,usertable,1,0,2725222,4390455,1120952,61684,77585,28031,1043367,126172,1260221,1120952,,,,,0,0,0,0
1650450874.879359,public.usertable,1043739,126194,1352065024,16893,public,usertable,1,0,2726257,4390971,1121338,61692,77599,28033,1043739,126194,1260629,1121338,,,,,0,0,0,0
1650450875.9099512,public.usertable,1044128,126213,1352556544,16893,public,usertable,1,0,2727281,4391490,1121739,61699,77611,28037,1044128,126213,1261049,1121739,,,,,0,0,0,0
1650450876.94112,public.usertable,1044524,126223,1353048064,16893,public,usertable,1,0,2728369,4391938,1122146,61704,77622,28041,1044524,126223,1261472,1122146,,,,,0,0,0,0
1650450877.9717886,public.usertable,1044907,126246,1353523200,16893,public,usertable,1,0,2729618,4392436,1122540,61716,77633,28046,1044907,126246,1261889,1122540,,,,,0,0,0,0
1650450879.0015218,public.usertable,1045313,126258,1354022912,16893,public,usertable,1,0,2730636,4392785,1122954,61721,77641,28048,1045313,126258,1262316,1122954,,,,,0,0,0,0
1650450880.0322099,public.usertable,1045720,126263,1354522624,16893,public,usertable,1,0,2731753,4393795,1123364,61733,77644,28052,1045720,126263,1262741,1123364,,,,,0,0,0,0
1650450881.061249,public.usertable,1046110,126276,1355005952,16893,public,usertable,1,0,2732880,4394133,1123762,61738,77652,28055,1046110,126276,1263152,1123762,,,,,0,0,0,0
1650450882.090233,public.usertable,1046493,126288,1355489280,16893,public,usertable,1,0,2733936,4394730,1124158,61743,77665,28056,1046493,126288,1263566,1124158,,,,,0,0,0,0
1650450883.1200652,public.usertable,1046875,126304,1355964416,16893,public,usertable,1,0,2734961,4395099,1124552,61749,77677,28059,1046875,126304,1263978,1124552,,,,,0,0,0,0
1650450884.148308,public.usertable,1047260,126322,1356439552,16893,public,usertable,1,0,2736008,4395589,1124952,61754,77692,28063,1047260,126322,1264398,1124952,,,,,0,0,0,0
1650450885.1794255,public.usertable,1047662,126335,1356955648,16893,public,usertable,1,0,2737171,4395954,1125363,61758,77701,28065,1047662,126335,1264822,1125363,,,,,0,0,0,0
1650450886.2107968,public.usertable,1048063,126349,1357438976,16893,public,usertable,1,0,2738297,4396955,1125776,61765,77713,28068,1048063,126349,1265254,1125776,,,,,0,0,0,0
1650450887.240582,public.usertable,1048460,126369,1357955072,16893,public,usertable,1,0,2739414,4397284,1126184,61774,77724,28074,1048460,126369,1265682,1126184,,,,,0,0,0,0
1650450888.2700312,public.usertable,1048860,126383,1358438400,16893,public,usertable,1,0,2740483,4397739,1126592,61783,77732,28080,1048860,126383,1266107,1126592,,,,,0,0,0,0
1650450889.3000133,public.usertable,1049262,126398,1358954496,16893,public,usertable,1,0,2741582,4398150,1127005,61789,77743,28081,1049262,126398,1266537,1127005,,,,,0,0,0,0
1650450890.3334372,public.usertable,1049665,126417,1359446016,16893,public,usertable,1,0,2742756,4398981,1127420,61800,77755,28087,1049665,126417,1266975,1127420,,,,,0,0,0,0
1650450891.3631432,public.usertable,1050062,126425,1359937536,16893,public,usertable,1,0,2743835,4399434,1127821,61807,77759,28091,1050062,126425,1267387,1127821,,,,,0,0,0,0
1650450892.3950522,public.usertable,1050661,126467,1360445440,16893,public,usertable,1,0,2745545,4399839,1128438,61831,77777,28103,1050661,126467,1268046,1128438,,,,,0,0,0,0
1650450893.4273376,public.usertable,1051036,126490,1360920576,16893,public,usertable,1,0,2746664,4400136,1128829,61839,77793,28108,1051036,126490,1268461,1128829,,,,,0,0,0,0
1650450894.4566898,public.usertable,1051433,126501,1361412096,16893,public,usertable,1,0,2747726,4400743,1129234,61845,77801,28110,1051433,126501,1268880,1129234,,,,,0,0,0,0
1650450895.48577,public.usertable,1051817,126518,1361887232,16893,public,usertable,1,0,2748836,4401171,1129626,61855,77809,28115,1051817,126518,1269290,1129626,,,,,0,0,0,0
1650450896.514793,public.usertable,1052205,126533,1362378752,16893,public,usertable,1,0,2750016,4402060,1130026,61861,77821,28120,1052205,126533,1269708,1130026,,,,,0,0,0,0
1650450897.5442114,public.usertable,1052607,126545,1362862080,16893,public,usertable,1,0,2751179,4402248,1130434,61867,77827,28121,1052607,126545,1270128,1130434,,,,,0,0,0,0
1650450898.5742702,public.usertable,1053014,126558,1363369984,16893,public,usertable,1,0,2752303,4402469,1130846,61877,77832,28129,1053014,126558,1270555,1130846,,,,,0,0,0,0
1650450899.6047602,public.usertable,1053405,126568,1363845120,16893,public,usertable,1,0,2753415,4403290,1131245,61887,77840,28137,1053405,126568,1270972,1131245,,,,,0,0,0,0
1650450900.636648,public.usertable,1053813,126586,1364377600,16893,public,usertable,1,0,2754630,4403690,1131668,61893,77855,28142,1053813,126586,1271416,1131668,,,,,0,0,0,0
1650450901.6659272,public.usertable,1054235,126593,1364869120,16893,public,usertable,1,0,2755683,4404586,1132099,61897,77864,28142,1054235,126593,1271860,1132099,,,,,0,0,0,0
1650450902.6946297,public.usertable,1054623,126612,1365327872,16893,public,usertable,1,0,2756734,4405169,1132501,61904,77878,28143,1054623,126612,1272283,1132501,,,,,0,0,0,0
1650450903.7253668,public.usertable,1055016,126627,1365827584,16893,public,usertable,1,0,2757800,4405831,1132899,61914,77883,28149,1055016,126627,1272696,1132899,,,,,0,0,0,0
1650450904.755698,public.usertable,1055409,126631,1366302720,16893,public,usertable,1,0,2758873,4406314,1133300,61919,77891,28153,1055409,126631,1273110,1133300,,,,,0,0,0,0
1650450905.7875073,public.usertable,1055821,126645,1366818816,16893,public,usertable,1,0,2759970,4406756,1133721,61927,77900,28157,1055821,126645,1273548,1133721,,,,,0,0,0,0
1650450906.817917,public.usertable,1056209,126659,1367334912,16893,public,usertable,1,0,2761137,4407359,1134119,61939,77910,28162,1056209,126659,1273968,1134119,,,,,0,0,0,0
1650450907.8471076,public.usertable,1056636,126674,1367851008,16893,public,usertable,1,0,2762261,4407593,1134554,61946,77918,28165,1056636,126674,1274418,1134554,,,,,0,0,0,0
1650450908.8785763,public.usertable,1057045,126690,1368367104,16893,public,usertable,1,0,2763222,4407833,1134975,61950,77930,28166,1057045,126690,1274855,1134975,,,,,0,0,0,0
1650450909.906909,public.usertable,1057463,126703,1368850432,16893,public,usertable,1,0,2764318,4409317,1135400,61961,77937,28170,1057463,126703,1275298,1135400,,,,,0,0,0,0
1650450910.9381435,public.usertable,1057849,126720,1369358336,16893,public,usertable,1,0,2765313,4410392,1135795,61969,77946,28174,1057849,126720,1275710,1135795,,,,,0,0,0,0
1650450911.968094,public.usertable,1058258,126733,1369858048,16893,public,usertable,1,0,2766473,4410719,1136217,61977,77959,28178,1058258,126733,1276153,1136217,,,,,0,0,0,0
1650450912.997182,public.usertable,1058854,126763,1370357760,16893,public,usertable,1,0,2768079,4411560,1136825,61995,77971,28191,1058854,126763,1276791,1136825,,,,,0,0,0,0
1650450914.0260625,public.usertable,1059277,126778,1370882048,16893,public,usertable,1,0,2769132,4412180,1137254,62004,77977,28194,1059277,126778,1277235,1137254,,,,,0,0,0,0
1650450915.0552254,public.usertable,1059701,126787,1371398144,16893,public,usertable,1,0,2770298,4412781,1137685,62014,77984,28199,1059701,126787,1277683,1137685,,,,,0,0,0,0
1650450916.0845184,public.usertable,1060072,126799,1371856896,16893,public,usertable,1,0,2771256,4413871,1138065,62018,77993,28201,1060072,126799,1278076,1138065,,,,,0,0,0,0
1650450917.1134725,public.usertable,1060460,126818,1372340224,16893,public,usertable,1,0,2772426,4414006,1138463,62027,78003,28206,1060460,126818,1278493,1138463,,,,,0,0,0,0
1650450918.1431067,public.usertable,1060841,126830,1372807168,16893,public,usertable,1,0,2773484,4414609,1138853,62030,78012,28207,1060841,126830,1278895,1138853,,,,,0,0,0,0
1650450919.171994,public.usertable,1061230,126844,1373298688,16893,public,usertable,1,0,2774515,4414804,1139250,62036,78020,28209,1061230,126844,1279306,1139250,,,,,0,0,0,0
1650450920.2048278,public.usertable,1061608,126867,1373782016,16893,public,usertable,1,0,2775531,4415384,1139639,62051,78031,28216,1061608,126867,1279721,1139639,,,,,0,0,0,0
1650450921.2346795,public.usertable,1062010,126879,1374273536,16893,public,usertable,1,0,2776613,4416000,1140049,62059,78039,28219,1062010,126879,1280147,1140049,,,,,0,0,0,0
1650450922.2644806,public.usertable,1062412,126895,1374773248,16893,public,usertable,1,0,2777706,4416776,1140460,62068,78048,28226,1062412,126895,1280576,1140460,,,,,0,0,0,0
1650450923.295309,public.usertable,1062816,126911,1375289344,16893,public,usertable,1,0,2778932,4417574,1140873,62077,78057,28229,1062816,126911,1281007,1140873,,,,,0,0,0,0
1650450924.3272047,public.usertable,1063228,126928,1375813632,16893,public,usertable,1,0,2780058,4418223,1141301,62083,78073,28233,1063228,126928,1281457,1141301,,,,,0,0,0,0
1650450925.3570812,public.usertable,1063654,126952,1376321536,16893,public,usertable,1,0,2781122,4418717,1141740,62094,78086,28240,1063654,126952,1281920,1141740,,,,,0,0,0,0
1650450926.3857608,public.usertable,1064077,126972,1376870400,16893,public,usertable,1,0,2782323,4419444,1142174,62106,78097,28249,1064077,126972,1282377,1142174,,,,,0,0,0,0
1650450927.4178472,public.usertable,1064536,126987,1377452032,16893,public,usertable,1,0,2783506,4419580,1142641,62113,78105,28254,1064536,126987,1282859,1142641,,,,,0,0,0,0
1650450928.446171,public.usertable,1064969,126998,1377943552,16893,public,usertable,1,0,2784603,4420252,1143084,62119,78115,28258,1064969,126998,1283318,1143084,,,,,0,0,0,0
1650450929.474303,public.usertable,1065351,127018,1378443264,16893,public,usertable,1,0,2785681,4420469,1143479,62126,78128,28263,1065351,127018,1283733,1143479,,,,,0,0,0,0
1650450930.5035589,public.usertable,1065767,127032,1378934784,16893,public,usertable,1,0,2786894,4421332,1143904,62132,78137,28266,1065767,127032,1284173,1143904,,,,,0,0,0,0
1650450931.532501,public.usertable,1066337,127054,1379409920,16893,public,usertable,1,0,2788393,4422305,1144488,62152,78151,28276,1066337,127054,1284791,1144488,,,,,0,0,0,0
1650450932.5629442,public.usertable,1066689,127066,1379844096,16893,public,usertable,1,0,2789309,4423055,1144852,62153,78163,28276,1066689,127066,1285168,1144852,,,,,0,0,0,0
1650450933.5921202,public.usertable,1067066,127090,1380319232,16893,public,usertable,1,0,2790373,4423786,1145244,62163,78178,28282,1067066,127090,1285585,1145244,,,,,0,0,0,0
1650450934.6212926,public.usertable,1067440,127109,1380777984,16893,public,usertable,1,0,2791312,4424383,1145627,62173,78187,28286,1067440,127109,1285987,1145627,,,,,0,0,0,0
1650450935.649874,public.usertable,1067779,127130,1381195776,16893,public,usertable,1,0,2792353,4425096,1145978,62182,78199,28288,1067779,127130,1286359,1145978,,,,,0,0,0,0
1650450936.67841,public.usertable,1068026,127139,1381515264,16893,public,usertable,1,0,2793089,4425851,1146233,62187,78207,28290,1068026,127139,1286627,1146233,,,,,0,0,0,0
1650450937.7081149,public.usertable,1068292,127141,1381826560,16893,public,usertable,1,0,2793765,4426431,1146504,62190,78212,28291,1068292,127141,1286906,1146504,,,,,0,0,0,0
1650450938.7395,public.usertable,1068546,127147,1382162432,16893,public,usertable,1,0,2794496,4426823,1146763,62191,78217,28291,1068546,127147,1287171,1146763,,,,,0,0,0,0
1650450939.7681837,public.usertable,1068828,127155,1382490112,16893,public,usertable,1,0,2795308,4427163,1147049,62196,78221,28293,1068828,127155,1287466,1147049,,,,,0,0,0,0
1650450940.7977996,public.usertable,1069115,127166,1382858752,16893,public,usertable,1,0,2796108,4427404,1147341,62202,78226,28295,1069115,127166,1287769,1147341,,,,,0,0,0,0
1650450941.8270526,public.usertable,1069400,127179,1383211008,16893,public,usertable,1,0,2796944,4427648,1147636,62207,78236,28299,1069400,127179,1288079,1147636,,,,,0,0,0,0
1650450942.857703,public.usertable,1069668,127186,1383514112,16893,public,usertable,1,0,2797598,4428025,1147906,62212,78238,28302,1069668,127186,1288356,1147906,,,,,0,0,0,0
1650450943.8874726,public.usertable,1069919,127189,1383858176,16893,public,usertable,1,0,2798268,4428300,1148165,62217,78246,28306,1069919,127189,1288628,1148165,,,,,0,0,0,0
1650450944.917727,public.usertable,1070213,127201,1384226816,16893,public,usertable,1,0,2799025,4428660,1148467,62221,78254,28308,1070213,127201,1288942,1148467,,,,,0,0,0,0
1650450945.9486895,public.usertable,1070522,127215,1384595456,16893,public,usertable,1,0,2799890,4429181,1148788,62225,78266,28310,1070522,127215,1289279,1148788,,,,,0,0,0,0
1650450946.9783165,public.usertable,1070839,127224,1384980480,16893,public,usertable,1,0,2800726,4429563,1149110,62231,78271,28313,1070839,127224,1289612,1149110,,,,,0,0,0,0
1650450948.0097136,public.usertable,1071092,127232,1385299968,16893,public,usertable,1,0,2801465,4429694,1149369,62233,78277,28315,1071092,127232,1289879,1149369,,,,,0,0,0,0
1650450949.0417159,public.usertable,1071387,127247,1385676800,16893,public,usertable,1,0,2802284,4430082,1149672,62240,78285,28318,1071387,127247,1290197,1149672,,,,,0,0,0,0
1650450950.0720818,public.usertable,1071713,127256,1386127360,16893,public,usertable,1,0,2803112,4430313,1150005,62242,78292,28320,1071713,127256,1290539,1150005,,,,,0,0,0,0
1650450951.1078513,public.usertable,1072284,127290,1386618880,16893,public,usertable,1,0,2804728,4430959,1150594,62258,78310,28327,1072284,127290,1291162,1150594,,,,,0,0,0,0
1650450952.140634,public.usertable,1072664,127305,1387085824,16893,public,usertable,1,0,2805743,4431877,1150984,62265,78320,28330,1072664,127305,1291569,1150984,,,,,0,0,0,0
1650450953.170056,public.usertable,1073023,127317,1387536384,16893,public,usertable,1,0,2806753,4432640,1151355,62269,78332,28332,1073023,127317,1291956,1151355,,,,,0,0,0,0
1650450954.198172,public.usertable,1073401,127337,1388011520,16893,public,usertable,1,0,2807811,4432961,1151744,62278,78343,28336,1073401,127337,1292365,1151744,,,,,0,0,0,0
1650450955.22859,public.usertable,1073790,127355,1388511232,16893,public,usertable,1,0,2808972,4433442,1152147,62282,78357,28337,1073790,127355,1292786,1152147,,,,,0,0,0,0
1650450956.2573934,public.usertable,1074181,127369,1388994560,16893,public,usertable,1,0,2810118,4434591,1152548,62292,78367,28342,1074181,127369,1293207,1152548,,,,,0,0,0,0
1650450957.2880566,public.usertable,1074571,127387,1389477888,16893,public,usertable,1,0,2811194,4434974,1152950,62301,78379,28350,1074571,127387,1293630,1152950,,,,,0,0,0,0
1650450958.31827,public.usertable,1074977,127405,1389977600,16893,public,usertable,1,0,2812210,4435163,1153368,62309,78391,28354,1074977,127405,1294068,1153368,,,,,0,0,0,0
1650450959.3476048,public.usertable,1075406,127420,1390510080,16893,public,usertable,1,0,2813265,4435775,1153806,62315,78400,28356,1075406,127420,1294521,1153806,,,,,0,0,0,0
1650450960.377537,public.usertable,1075796,127437,1390993408,16893,public,usertable,1,0,2814296,4436205,1154204,62324,78408,28362,1075796,127437,1294936,1154204,,,,,0,0,0,0
1650450961.4084086,public.usertable,1076202,127457,1391517696,16893,public,usertable,1,0,2815491,4436661,1154623,62335,78421,28367,1076202,127457,1295379,1154623,,,,,0,0,0,0
1650450962.4399846,public.usertable,1076596,127469,1391960064,16893,public,usertable,1,0,2816615,4437351,1155028,62339,78432,28369,1076596,127469,1295799,1155028,,,,,0,0,0,0
1650450963.4693308,public.usertable,1076974,127477,1392451584,16893,public,usertable,1,0,2817499,4438191,1155413,62340,78439,28370,1076974,127477,1296192,1155413,,,,,0,0,0,0
1650450964.5007784,public.usertable,1077345,127496,1392918528,16893,public,usertable,1,0,2818531,4438515,1155788,62355,78443,28377,1077345,127496,1296586,1155788,,,,,0,0,0,0
1650450965.5296824,public.usertable,1077728,127512,1393369088,16893,public,usertable,1,0,2819553,4439030,1156183,62363,78455,28384,1077728,127512,1297001,1156183,,,,,0,0,0,0
1650450966.5595148,public.usertable,1078093,127518,1393844224,16893,public,usertable,1,0,2820572,4439863,1156555,62369,78462,28389,1078093,127518,1297386,1156555,,,,,0,0,0,0
1650450967.5897117,public.usertable,1078443,127527,1394253824,16893,public,usertable,1,0,2821506,4440663,1156912,62375,78469,28391,1078443,127527,1297756,1156912,,,,,0,0,0,0
1650450968.6178281,public.usertable,1078788,127537,1394679808,16893,public,usertable,1,0,2822503,4441631,1157267,62383,78479,28395,1078788,127537,1298129,1157267,,,,,0,0,0,0
1650450969.6472635,public.usertable,1079323,127566,1395146752,16893,public,usertable,1,0,2823917,4442131,1157820,62397,78497,28400,1079323,127566,1298714,1157820,,,,,0,0,0,0
1650450970.6769404,public.usertable,1079616,127583,1395515392,16893,public,usertable,1,0,2824774,4442544,1158125,62402,78509,28404,1079616,127583,1299036,1158125,,,,,0,0,0,0
1650450971.7061048,public.usertable,1079919,127594,1395892224,16893,public,usertable,1,0,2825597,4443193,1158435,62406,78516,28408,1079919,127594,1299357,1158435,,,,,0,0,0,0
1650450972.7371817,public.usertable,1080192,127603,1396228096,16893,public,usertable,1,0,2826431,4443672,1158711,62416,78519,28413,1080192,127603,1299646,1158711,,,,,0,0,0,0
1650450973.7680275,public.usertable,1080450,127613,1396523008,16893,public,usertable,1,0,2827185,4444308,1158976,62420,78526,28416,1080450,127613,1299922,1158976,,,,,0,0,0,0
1650450974.7979271,public.usertable,1080755,127629,1396948992,16893,public,usertable,1,0,2828207,4444640,1159294,62424,78539,28418,1080755,127629,1300257,1159294,,,,,0,0,0,0
1650450975.8273072,public.usertable,1081156,127652,1397456896,16893,public,usertable,1,0,2829242,4445139,1159713,62429,78557,28420,1081156,127652,1300699,1159713,,,,,0,0,0,0
1650450976.8576415,public.usertable,1081572,127663,1397964800,16893,public,usertable,1,0,2830416,4445321,1160137,62433,78565,28421,1081572,127663,1301135,1160137,,,,,0,0,0,0
1650450977.8872907,public.usertable,1081998,127676,1398489088,16893,public,usertable,1,0,2831597,4445519,1160573,62443,78575,28427,1081998,127676,1301591,1160573,,,,,0,0,0,0
1650450978.9175696,public.usertable,1082381,127691,1398980608,16893,public,usertable,1,0,2832726,4446070,1160972,62448,78591,28430,1082381,127691,1302011,1160972,,,,,0,0,0,0
1650450979.9489782,public.usertable,1082796,127707,1399488512,16893,public,usertable,1,0,2833810,4446156,1161397,62454,78601,28432,1082796,127707,1302452,1161397,,,,,0,0,0,0
1650450980.9802823,public.usertable,1083195,127719,1399988224,16893,public,usertable,1,0,2835012,4447160,1161806,62464,78611,28440,1083195,127719,1302881,1161806,,,,,0,0,0,0
1650450982.0094516,public.usertable,1083609,127733,1400512512,16893,public,usertable,1,0,2836172,4448090,1162230,62471,78621,28445,1083609,127733,1303322,1162230,,,,,0,0,0,0
1650450983.038713,public.usertable,1084020,127745,1401020416,16893,public,usertable,1,0,2837310,4448716,1162648,62479,78628,28447,1084020,127745,1303755,1162648,,,,,0,0,0,0
1650450984.0700982,public.usertable,1084415,127765,1401528320,16893,public,usertable,1,0,2838329,4448996,1163054,62488,78639,28451,1084415,127765,1304181,1163054,,,,,0,0,0,0
1650450985.1013937,public.usertable,1084822,127790,1402003456,16893,public,usertable,1,0,2839497,4449188,1163475,62499,78653,28454,1084822,127790,1304627,1163475,,,,,0,0,0,0
1650450986.1316066,public.usertable,1085220,127804,1402535936,16893,public,usertable,1,0,2840531,4449924,1163883,62503,78663,28455,1085220,127804,1305049,1163883,,,,,0,0,0,0
1650450987.166175,public.usertable,1085653,127825,1403084800,16893,public,usertable,1,0,2841857,4450311,1164326,62514,78673,28462,1085653,127825,1305513,1164326,,,,,0,0,0,0
1650450988.196675,public.usertable,1086090,127834,1403584512,16893,public,usertable,1,0,2842968,4451173,1164771,62520,78681,28465,1086090,127834,1305972,1164771,,,,,0,0,0,0
1650450989.2276678,public.usertable,1086639,127865,1404051456,16893,public,usertable,1,0,2844506,4452027,1165341,62532,78702,28469,1086639,127865,1306575,1165341,,,,,0,0,0,0
1650450990.2615106,public.usertable,1087030,127873,1404526592,16893,public,usertable,1,0,2845561,4452725,1165739,62540,78709,28474,1087030,127873,1306988,1165739,,,,,0,0,0,0
1650450991.2891743,public.usertable,1087420,127887,1405009920,16893,public,usertable,1,0,2846760,4453251,1166140,62545,78720,28478,1087420,127887,1307405,1166140,,,,,0,0,0,0
1650450992.3200364,public.usertable,1087824,127902,1405501440,16893,public,usertable,1,0,2847887,4453861,1166553,62551,78729,28482,1087824,127902,1307833,1166553,,,,,0,0,0,0
1650450993.3498087,public.usertable,1088191,127916,1405976576,16893,public,usertable,1,0,2848821,4453944,1166928,62557,78737,28483,1088191,127916,1308222,1166928,,,,,0,0,0,0
1650450994.3788986,public.usertable,1088582,127925,1406443520,16893,public,usertable,1,0,2849856,4454681,1167323,62563,78741,28485,1088582,127925,1308627,1167323,,,,,0,0,0,0
1650450995.40809,public.usertable,1088949,127949,1406902272,16893,public,usertable,1,0,2850931,4455365,1167701,62576,78752,28489,1088949,127949,1309029,1167701,,,,,0,0,0,0
1650450996.4379165,public.usertable,1089323,127967,1407377408,16893,public,usertable,1,0,2852003,4455605,1168086,62588,78763,28493,1089323,127967,1309437,1168086,,,,,0,0,0,0
1650450997.4673874,public.usertable,1089702,127984,1407868928,16893,public,usertable,1,0,2853068,4456173,1168474,62596,78772,28497,1089702,127984,1309842,1168474,,,,,0,0,0,0
1650450998.4962904,public.usertable,1090083,128004,1408344064,16893,public,usertable,1,0,2854041,4456547,1168866,62605,78783,28502,1090083,128004,1310254,1168866,,,,,0,0,0,0
1650450999.5260048,public.usertable,1090503,128017,1408851968,16893,public,usertable,1,0,2855126,4457015,1169296,62609,78793,28502,1090503,128017,1310698,1169296,,,,,0,0,0,0
1650451000.5555775,public.usertable,1090920,128021,1409376256,16893,public,usertable,1,0,2856211,4457729,1169719,62615,78799,28506,1090920,128021,1311133,1169719,,,,,0,0,0,0
1650451001.5850408,public.usertable,1091298,128033,1409818624,16893,public,usertable,1,0,2857160,4458518,1170105,62622,78807,28509,1091298,128033,1311534,1170105,,,,,0,0,0,0
1650451002.614447,public.usertable,1091670,128048,1410293760,16893,public,usertable,1,0,2858148,4459014,1170485,62629,78815,28515,1091670,128048,1311929,1170485,,,,,0,0,0,0
1650451003.6431391,public.usertable,1092048,128062,1410768896,16893,public,usertable,1,0,2859121,4459117,1170871,62635,78823,28518,1092048,128062,1312329,1170871,,,,,0,0,0,0
1650451004.6725855,public.usertable,1092437,128081,1411227648,16893,public,usertable,1,0,2860185,4459712,1171280,62640,78843,28521,1092437,128081,1312763,1171280,,,,,0,0,0,0
1650451005.7038102,public.usertable,1092753,128094,1411637248,16893,public,usertable,1,0,2861090,4460139,1171604,62648,78851,28524,1092753,128094,1313103,1171604,,,,,0,0,0,0
1650451006.7339153,public.usertable,1093252,128110,1412038656,16893,public,usertable,1,0,2862379,4460707,1172118,62654,78866,28528,1093252,128110,1313638,1172118,,,,,0,0,0,0
1650451007.7660882,public.usertable,1093567,128119,1412423680,16893,public,usertable,1,0,2863228,4461140,1172437,62660,78870,28531,1093567,128119,1313967,1172437,,,,,0,0,0,0
1650451008.796684,public.usertable,1093925,128130,1412874240,16893,public,usertable,1,0,2864206,4461426,1172804,62664,78879,28535,1093925,128130,1314347,1172804,,,,,0,0,0,0
1650451009.8268964,public.usertable,1094280,128148,1413308416,16893,public,usertable,1,0,2865176,4462044,1173168,62673,78888,28539,1094280,128148,1314729,1173168,,,,,0,0,0,0
1650451010.8552568,public.usertable,1094650,128160,1413742592,16893,public,usertable,1,0,2866171,4462310,1173544,62679,78894,28542,1094650,128160,1315117,1173544,,,,,0,0,0,0
1650451011.8839421,public.usertable,1094962,128170,1414135808,16893,public,usertable,1,0,2867082,4462883,1173864,62685,78902,28546,1094962,128170,1315451,1173864,,,,,0,0,0,0
1650451012.9148946,public.usertable,1095337,128186,1414602752,16893,public,usertable,1,0,2868049,4463443,1174247,62693,78910,28550,1095337,128186,1315850,1174247,,,,,0,0,0,0
1650451013.9444244,public.usertable,1095706,128200,1415069696,16893,public,usertable,1,0,2869039,4463887,1174625,62698,78919,28552,1095706,128200,1316242,1174625,,,,,0,0,0,0
1650451014.9740558,public.usertable,1096084,128213,1415536640,16893,public,usertable,1,0,2870165,4464907,1175015,62702,78931,28555,1096084,128213,1316648,1175015,,,,,0,0,0,0
1650451016.0033047,public.usertable,1096465,128223,1416028160,16893,public,usertable,1,0,2871243,4465815,1175404,62707,78939,28557,1096465,128223,1317050,1175404,,,,,0,0,0,0
1650451017.0343065,public.usertable,1096836,128239,1416462336,16893,public,usertable,1,0,2872300,4466264,1175787,62713,78951,28560,1096836,128239,1317451,1175787,,,,,0,0,0,0
1650451018.0643744,public.usertable,1097191,128258,1416937472,16893,public,usertable,1,0,2873298,4466851,1176157,62723,78966,28566,1097191,128258,1317846,1176157,,,,,0,0,0,0
1650451019.0941339,public.usertable,1097572,128261,1417388032,16893,public,usertable,1,0,2874208,4467646,1176543,62727,78971,28569,1097572,128261,1318241,1176543,,,,,0,0,0,0
1650451020.1250956,public.usertable,1097947,128271,1417854976,16893,public,usertable,1,0,2875274,4468226,1176924,62733,78977,28571,1097947,128271,1318634,1176924,,,,,0,0,0,0
1650451021.1538303,public.usertable,1098323,128284,1418305536,16893,public,usertable,1,0,2876236,4468704,1177308,62738,78985,28573,1098323,128284,1319031,1177308,,,,,0,0,0,0
1650451022.1845932,public.usertable,1098709,128300,1418780672,16893,public,usertable,1,0,2877183,4468930,1177706,62745,78997,28578,1098709,128300,1319448,1177706,,,,,0,0,0,0
1650451023.2145617,public.usertable,1099061,128318,1419223040,16893,public,usertable,1,0,2878239,4469119,1178065,62756,79004,28582,1099061,128318,1319825,1178065,,,,,0,0,0,0
1650451024.2437885,public.usertable,1099400,128328,1419608064,16893,public,usertable,1,0,2879243,4469492,1178412,62759,79012,28585,1099400,128328,1320183,1178412,,,,,0,0,0,0
1650451025.2727757,public.usertable,1099734,128346,1420050432,16893,public,usertable,1,0,2880132,4469702,1178761,62765,79027,28589,1099734,128346,1320553,1178761,,,,,0,0,0,0
1650451026.301581,public.usertable,1100093,128361,1420509184,16893,public,usertable,1,0,2881113,4470541,1179136,62768,79043,28590,1100093,128361,1320947,1179136,,,,,0,0,0,0
1650451027.330258,public.usertable,1100490,128375,1421008896,16893,public,usertable,1,0,2882098,4470743,1179541,62774,79051,28592,1100490,128375,1321366,1179541,,,,,0,0,0,0
1650451028.3597171,public.usertable,1100868,128386,1421451264,16893,public,usertable,1,0,2883078,4471360,1179923,62781,79055,28597,1100868,128386,1321759,1179923,,,,,0,0,0,0
1650451029.389059,public.usertable,1101406,128410,1421893632,16893,public,usertable,1,0,2884495,4472124,1180476,62792,79070,28605,1101406,128410,1322338,1180476,,,,,0,0,0,0
1650451030.4181945,public.usertable,1101753,128423,1422327808,16893,public,usertable,1,0,2885387,4472523,1180830,62800,79077,28611,1101753,128423,1322707,1180830,,,,,0,0,0,0
1650451031.4518037,public.usertable,1102147,128435,1422819328,16893,public,usertable,1,0,2886406,4472926,1181232,62804,79085,28612,1102147,128435,1323121,1181232,,,,,0,0,0,0
1650451032.4822648,public.usertable,1102502,128455,1423269888,16893,public,usertable,1,0,2887386,4473342,1181601,62810,79099,28616,1102502,128455,1323510,1181601,,,,,0,0,0,0
1650451033.5101225,public.usertable,1102875,128463,1423712256,16893,public,usertable,1,0,2888344,4474286,1181984,62814,79109,28617,1102875,128463,1323907,1181984,,,,,0,0,0,0
1650451034.5384998,public.usertable,1103222,128485,1424154624,16893,public,usertable,1,0,2889420,4474524,1182344,62823,79122,28621,1103222,128485,1324289,1182344,,,,,0,0,0,0
1650451035.5666215,public.usertable,1103583,128496,1424588800,16893,public,usertable,1,0,2890336,4474920,1182712,62828,79129,28623,1103583,128496,1324669,1182712,,,,,0,0,0,0
1650451036.5951316,public.usertable,1103949,128511,1425072128,16893,public,usertable,1,0,2891323,4475470,1183088,62835,79139,28626,1103949,128511,1325062,1183088,,,,,0,0,0,0
1650451037.625209,public.usertable,1104309,128524,1425489920,16893,public,usertable,1,0,2892375,4476013,1183455,62842,79146,28629,1104309,128524,1325443,1183455,,,,,0,0,0,0
1650451038.6548505,public.usertable,1104644,128529,1425907712,16893,public,usertable,1,0,2893306,4476927,1183797,62846,79153,28631,1104644,128529,1325796,1183797,,,,,0,0,0,0
1650451039.6852243,public.usertable,1104920,128536,1426251776,16893,public,usertable,1,0,2894045,4477032,1184078,62848,79158,28631,1104920,128536,1326084,1184078,,,,,0,0,0,0
1650451040.7177558,public.usertable,1105254,128548,1426694144,16893,public,usertable,1,0,2894953,4477624,1184422,62854,79168,28635,1105254,128548,1326444,1184422,,,,,0,0,0,0
1650451041.746684,public.usertable,1105644,128566,1427169280,16893,public,usertable,1,0,2895947,4477927,1184821,62863,79177,28637,1105644,128566,1326861,1184821,,,,,0,0,0,0
1650451042.7780259,public.usertable,1106014,128585,1427644416,16893,public,usertable,1,0,2896999,4478708,1185199,62874,79185,28640,1106014,128585,1327258,1185199,,,,,0,0,0,0
1650451043.8084722,public.usertable,1106377,128597,1428094976,16893,public,usertable,1,0,2898040,4478850,1185571,62877,79194,28643,1106377,128597,1327642,1185571,,,,,0,0,0,0
1650451044.8376198,public.usertable,1106772,128610,1428553728,16893,public,usertable,1,0,2899116,4479396,1185971,62885,79199,28647,1106772,128610,1328055,1185971,,,,,0,0,0,0
1650451045.8683593,public.usertable,1107112,128628,1428987904,16893,public,usertable,1,0,2900087,4479801,1186320,62894,79208,28652,1107112,128628,1328422,1186320,,,,,0,0,0,0
1650451046.896733,public.usertable,1107502,128642,1429454848,16893,public,usertable,1,0,2901120,4480594,1186717,62907,79215,28658,1107502,128642,1328839,1186717,,,,,0,0,0,0
1650451047.9255342,public.usertable,1107862,128651,1429913600,16893,public,usertable,1,0,2902119,4481008,1187088,62911,79226,28659,1107862,128651,1329225,1187088,,,,,0,0,0,0
1650451048.9561636,public.usertable,1108363,128667,1430315008,16893,public,usertable,1,0,2903451,4481861,1187599,62923,79236,28665,1108363,128667,1329758,1187599,,,,,0,0,0,0
1650451049.9879096,public.usertable,1108727,128679,1430773760,16893,public,usertable,1,0,2904394,4482419,1187969,62929,79242,28668,1108727,128679,1330140,1187969,,,,,0,0,0,0
1650451051.0178237,public.usertable,1109078,128693,1431207936,16893,public,usertable,1,0,2905385,4482581,1188328,62938,79250,28670,1109078,128693,1330516,1188328,,,,,0,0,0,0
1650451052.0461817,public.usertable,1109451,128705,1431666688,16893,public,usertable,1,0,2906331,4482954,1188706,62945,79255,28675,1109451,128705,1330906,1188706,,,,,0,0,0,0
1650451053.0782037,public.usertable,1109791,128716,1432084480,16893,public,usertable,1,0,2907336,4483289,1189056,62952,79265,28680,1109791,128716,1331273,1189056,,,,,0,0,0,0
1650451054.1063228,public.usertable,1110140,128728,1432510464,16893,public,usertable,1,0,2908291,4483602,1189414,62958,79274,28683,1110140,128728,1331646,1189414,,,,,0,0,0,0
1650451055.136445,public.usertable,1110454,128743,1432903680,16893,public,usertable,1,0,2909172,4484012,1189734,62969,79280,28689,1110454,128743,1331983,1189734,,,,,0,0,0,0
1650451056.167216,public.usertable,1110850,128758,1433411584,16893,public,usertable,1,0,2910224,4484431,1190137,62979,79287,28694,1110850,128758,1332403,1190137,,,,,0,0,0,0
1650451057.1974103,public.usertable,1111248,128777,1433911296,16893,public,usertable,1,0,2911357,4484680,1190544,62989,79296,28700,1111248,128777,1332829,1190544,,,,,0,0,0,0
1650451058.229086,public.usertable,1111635,128791,1434394624,16893,public,usertable,1,0,2912418,4485187,1190941,62997,79306,28706,1111635,128791,1333244,1190941,,,,,0,0,0,0
1650451059.258337,public.usertable,1112036,128807,1434886144,16893,public,usertable,1,0,2913500,4485457,1191354,63001,79318,28709,1112036,128807,1333673,1191354,,,,,0,0,0,0
1650451060.2873738,public.usertable,1112431,128821,1435385856,16893,public,usertable,1,0,2914491,4485612,1191757,63007,79326,28713,1112431,128821,1334090,1191757,,,,,0,0,0,0
1650451061.3171246,public.usertable,1112806,128840,1435852800,16893,public,usertable,1,0,2915593,4485980,1192144,63014,79338,28716,1112806,128840,1334496,1192144,,,,,0,0,0,0
1650451062.3472052,public.usertable,1113192,128855,1436327936,16893,public,usertable,1,0,2916626,4486196,1192542,63020,79350,28717,1113192,128855,1334912,1192542,,,,,0,0,0,0
1650451063.3759081,public.usertable,1113578,128871,1436827648,16893,public,usertable,1,0,2917788,4486715,1192940,63026,79362,28718,1113578,128871,1335328,1192940,,,,,0,0,0,0
1650451064.4042702,public.usertable,1113991,128889,1437319168,16893,public,usertable,1,0,2918918,4487312,1193361,63036,79370,28725,1113991,128889,1335767,1193361,,,,,0,0,0,0
1650451065.433369,public.usertable,1114321,128900,1437704192,16893,public,usertable,1,0,2919831,4487494,1193701,63038,79380,28726,1114321,128900,1336119,1193701,,,,,0,0,0,0
1650451066.4633353,public.usertable,1114646,128914,1438081024,16893,public,usertable,1,0,2920779,4487578,1194034,63044,79388,28730,1114646,128914,1336466,1194034,,,,,0,0,0,0
1650451067.4926546,public.usertable,1115116,128932,1438482432,16893,public,usertable,1,0,2922015,4488606,1194514,63054,79398,28736,1115116,128932,1336966,1194514,,,,,0,0,0,0
1650451068.5204182,public.usertable,1115404,128948,1438842880,16893,public,usertable,1,0,2922809,4488865,1194812,63060,79408,28741,1115404,128948,1337280,1194812,,,,,0,0,0,0
1650451069.5493836,public.usertable,1115656,128958,1439162368,16893,public,usertable,1,0,2923524,4488983,1195070,63064,79414,28743,1115656,128958,1337548,1195070,,,,,0,0,0,0
1650451070.580308,public.usertable,1115964,128970,1439539200,16893,public,usertable,1,0,2924404,4489362,1195388,63067,79424,28745,1115964,128970,1337879,1195388,,,,,0,0,0,0
1650451071.6123233,public.usertable,1116199,128977,1439801344,16893,public,usertable,1,0,2924990,4489659,1195626,63071,79427,28748,1116199,128977,1338124,1195626,,,,,0,0,0,0
1650451072.6417654,public.usertable,1116489,128982,1440194560,16893,public,usertable,1,0,2925808,4489907,1195921,63075,79432,28750,1116489,128982,1338428,1195921,,,,,0,0,0,0
1650451073.6713552,public.usertable,1116750,128991,1440489472,16893,public,usertable,1,0,2926437,4490085,1196189,63077,79439,28751,1116750,128991,1338705,1196189,,,,,0,0,0,0
1650451074.7004118,public.usertable,1116962,129002,1440735232,16893,public,usertable,1,0,2927025,4490169,1196407,63082,79445,28752,1116962,129002,1338934,1196407,,,,,0,0,0,0
1650451075.7285697,public.usertable,1117197,129011,1441071104,16893,public,usertable,1,0,2927668,4490229,1196647,63086,79450,28756,1117197,129011,1339183,1196647,,,,,0,0,0,0
1650451076.7572987,public.usertable,1117550,129028,1441497088,16893,public,usertable,1,0,2928651,4490749,1197012,63091,79462,28758,1117550,129028,1339565,1197012,,,,,0,0,0,0
1650451077.785849,public.usertable,1117848,129045,1441906688,16893,public,usertable,1,0,2929457,4491330,1197318,63102,79470,28763,1117848,129045,1339890,1197318,,,,,0,0,0,0
1650451078.8153992,public.usertable,1118233,129056,1442381824,16893,public,usertable,1,0,2930438,4491619,1197712,63104,79479,28764,1118233,129056,1340295,1197712,,,,,0,0,0,0
1650451079.8446517,public.usertable,1118624,129058,1442865152,16893,public,usertable,1,0,2931487,4492858,1198111,63108,79487,28765,1118624,129058,1340706,1198111,,,,,0,0,0,0
1650451080.8749528,public.usertable,1119014,129078,1443356672,16893,public,usertable,1,0,2932435,4493209,1198513,63118,79499,28770,1119014,129078,1341130,1198513,,,,,0,0,0,0
1650451081.9032981,public.usertable,1119426,129093,1443872768,16893,public,usertable,1,0,2933566,4493935,1198935,63124,79509,28771,1119426,129093,1341568,1198935,,,,,0,0,0,0
1650451082.933771,public.usertable,1119826,129101,1444347904,16893,public,usertable,1,0,2934608,4494636,1199345,63130,79519,28775,1119826,129101,1341994,1199345,,,,,0,0,0,0
1650451083.9636102,public.usertable,1120208,129121,1444855808,16893,public,usertable,1,0,2935660,4494778,1199741,63136,79533,28779,1120208,129121,1342410,1199741,,,,,0,0,0,0
1650451084.9964535,public.usertable,1120614,129148,1445363712,16893,public,usertable,1,0,2936756,4494892,1200162,63148,79548,28786,1120614,129148,1342858,1200162,,,,,0,0,0,0
1650451086.0260997,public.usertable,1120985,129161,1445806080,16893,public,usertable,1,0,2937652,4495063,1200538,63156,79553,28789,1120985,129161,1343247,1200538,,,,,0,0,0,0
1650451087.0556436,public.usertable,1121575,129191,1446313984,16893,public,usertable,1,0,2939271,4495644,1201148,63171,79573,28800,1121575,129191,1343892,1201148,,,,,0,0,0,0
1650451088.086551,public.usertable,1121946,129203,1446772736,16893,public,usertable,1,0,2940247,4496498,1201529,63176,79583,28804,1121946,129203,1344288,1201529,,,,,0,0,0,0
1650451089.1187005,public.usertable,1122303,129214,1447215104,16893,public,usertable,1,0,2941268,4497153,1201893,63182,79590,28808,1122303,129214,1344665,1201893,,,,,0,0,0,0
1650451090.1478343,public.usertable,1122677,129225,1447665664,16893,public,usertable,1,0,2942319,4497916,1202273,63191,79596,28811,1122677,129225,1345060,1202273,,,,,0,0,0,0
1650451091.1777446,public.usertable,1123050,129237,1448148992,16893,public,usertable,1,0,2943388,4498976,1202656,63198,79606,28816,1123050,129237,1345460,1202656,,,,,0,0,0,0
1650451092.2074757,public.usertable,1123443,129266,1448640512,16893,public,usertable,1,0,2944480,4499318,1203064,63212,79621,28824,1123443,129266,1345897,1203064,,,,,0,0,0,0
1650451093.2407997,public.usertable,1123821,129284,1449123840,16893,public,usertable,1,0,2945497,4499662,1203452,63220,79631,28826,1123821,129284,1346303,1203452,,,,,0,0,0,0
1650451094.2695994,public.usertable,1124226,129295,1449607168,16893,public,usertable,1,0,2946595,4500200,1203862,63226,79636,28829,1124226,129295,1346724,1203862,,,,,0,0,0,0
1650451095.2981224,public.usertable,1124626,129305,1450106880,16893,public,usertable,1,0,2947682,4500547,1204267,63233,79641,28833,1124626,129305,1347141,1204267,,,,,0,0,0,0
1650451096.328817,public.usertable,1125011,129328,1450582016,16893,public,usertable,1,0,2948802,4501430,1204662,63246,79651,28842,1125011,129328,1347559,1204662,,,,,0,0,0,0
1650451097.3596036,public.usertable,1125418,129339,1451089920,16893,public,usertable,1,0,2949889,4501666,1205077,63251,79659,28845,1125418,129339,1347987,1205077,,,,,0,0,0,0
1650451098.3904662,public.usertable,1125811,129349,1451556864,16893,public,usertable,1,0,2950978,4502743,1205477,63257,79666,28848,1125811,129349,1348400,1205477,,,,,0,0,0,0
1650451099.4209785,public.usertable,1126195,129362,1452032000,16893,public,usertable,1,0,2952112,4503085,1205870,63266,79675,28850,1126195,129362,1348811,1205870,,,,,0,0,0,0
1650451100.451178,public.usertable,1126517,129381,1452408832,16893,public,usertable,1,0,2953019,4503153,1206202,63275,79685,28857,1126517,129381,1349162,1206202,,,,,0,0,0,0
1650451101.4799976,public.usertable,1126779,129392,1452736512,16893,public,usertable,1,0,2953719,4504414,1206472,63281,79693,28861,1126779,129392,1349446,1206472,,,,,0,0,0,0
1650451102.5101926,public.usertable,1127066,129403,1453088768,16893,public,usertable,1,0,2954447,4504506,1206766,63285,79700,28864,1127066,129403,1349751,1206766,,,,,0,0,0,0
1650451103.5387113,public.usertable,1127366,129416,1453449216,16893,public,usertable,1,0,2955185,4504722,1207074,63290,79708,28869,1127366,129416,1350072,1207074,,,,,0,0,0,0
1650451104.570348,public.usertable,1127655,129429,1453826048,16893,public,usertable,1,0,2956020,4505147,1207376,63294,79721,28870,1127655,129429,1350391,1207376,,,,,0,0,0,0
1650451105.599902,public.usertable,1127974,129440,1454252032,16893,public,usertable,1,0,2956936,4505481,1207702,63299,79728,28872,1127974,129440,1350729,1207702,,,,,0,0,0,0
1650451106.628143,public.usertable,1128414,129451,1454579712,16893,public,usertable,1,0,2958128,4505666,1208155,63303,79741,28873,1128414,129451,1351199,1208155,,,,,0,0,0,0
1650451107.6574104,public.usertable,1128671,129464,1454899200,16893,public,usertable,1,0,2958778,4505735,1208419,63309,79748,28877,1128671,129464,1351476,1208419,,,,,0,0,0,0
1650451108.6884425,public.usertable,1128922,129475,1455210496,16893,public,usertable,1,0,2959543,4505957,1208677,63315,79755,28881,1128922,129475,1351747,1208677,,,,,0,0,0,0
1650451109.718158,public.usertable,1129159,129485,1455497216,16893,public,usertable,1,0,2960167,4506008,1208918,63322,79759,28885,1129159,129485,1351999,1208918,,,,,0,0,0,0
1650451110.7468598,public.usertable,1129400,129488,1455792128,16893,public,usertable,1,0,2960868,4506414,1209163,63329,79763,28891,1129400,129488,1352255,1209163,,,,,0,0,0,0
1650451111.7776802,public.usertable,1129665,129492,1456160768,16893,public,usertable,1,0,2961488,4506823,1209431,63332,79766,28892,1129665,129492,1352529,1209431,,,,,0,0,0,0
1650451112.8076274,public.usertable,1130028,129509,1456570368,16893,public,usertable,1,0,2962528,4507266,1209806,63338,79778,28895,1130028,129509,1352922,1209806,,,,,0,0,0,0
1650451113.8384168,public.usertable,1130302,129519,1456906240,16893,public,usertable,1,0,2963276,4507460,1210087,63343,79785,28899,1130302,129519,1353215,1210087,,,,,0,0,0,0
1650451114.8680797,public.usertable,1130570,129531,1457250304,16893,public,usertable,1,0,2964024,4507769,1210361,63350,79791,28904,1130570,129531,1353502,1210361,,,,,0,0,0,0
1650451115.8969462,public.usertable,1130856,129539,1457610752,16893,public,usertable,1,0,2964766,4507975,1210651,63355,79795,28906,1130856,129539,1353801,1210651,,,,,0,0,0,0
1650451116.9271781,public.usertable,1131113,129542,1457938432,16893,public,usertable,1,0,2965391,4508576,1210913,63360,79800,28909,1131113,129542,1354073,1210913,,,,,0,0,0,0
1650451117.9552417,public.usertable,1131408,129545,1458298880,16893,public,usertable,1,0,2966179,4509315,1211216,63362,79808,28909,1131408,129545,1354386,1211216,,,,,0,0,0,0
1650451118.9834645,public.usertable,1131754,129556,1458733056,16893,public,usertable,1,0,2967137,4509863,1211564,63371,79810,28912,1131754,129556,1354745,1211564,,,,,0,0,0,0
1650451120.012782,public.usertable,1132108,129568,1459142656,16893,public,usertable,1,0,2968145,4510327,1211924,63379,79816,28917,1132108,129568,1355119,1211924,,,,,0,0,0,0
1650451121.0421572,public.usertable,1132390,129580,1459519488,16893,public,usertable,1,0,2968873,4510717,1212213,63384,79823,28920,1132390,129580,1355420,1212213,,,,,0,0,0,0
1650451122.070993,public.usertable,1132650,129593,1459814400,16893,public,usertable,1,0,2969568,4510795,1212482,63388,79832,28922,1132650,129593,1355702,1212482,,,,,0,0,0,0
1650451123.1002595,public.usertable,1132983,129602,1460273152,16893,public,usertable,1,0,2970454,4511462,1212818,63394,79835,28926,1132983,129602,1356047,1212818,,,,,0,0,0,0
1650451124.1326768,public.usertable,1133366,129619,1460781056,16893,public,usertable,1,0,2971560,4511692,1213217,63395,79851,28927,1133366,129619,1356463,1213217,,,,,0,0,0,0
1650451125.1614597,public.usertable,1133971,129636,1461272576,16893,public,usertable,1,0,2973207,4512716,1213834,63404,79863,28932,1133971,129636,1357101,1213834,,,,,0,0,0,0
1650451126.1916063,public.usertable,1134387,129641,1461788672,16893,public,usertable,1,0,2974312,4512999,1214257,63406,79870,28933,1134387,129641,1357533,1214257,,,,,0,0,0,0
1650451127.220225,public.usertable,1134798,129658,1462280192,16893,public,usertable,1,0,2975435,4513154,1214674,63417,79876,28938,1134798,129658,1357967,1214674,,,,,0,0,0,0
1650451128.250881,public.usertable,1135191,129670,1462771712,16893,public,usertable,1,0,2976484,4513635,1215075,63424,79884,28943,1135191,129670,1358383,1215075,,,,,0,0,0,0
1650451129.2793846,public.usertable,1135594,129687,1463271424,16893,public,usertable,1,0,2977653,4513779,1215488,63432,79894,28947,1135594,129687,1358814,1215488,,,,,0,0,0,0
1650451130.3105202,public.usertable,1135981,129702,1463754752,16893,public,usertable,1,0,2978697,4514145,1215887,63437,79906,28950,1135981,129702,1359230,1215887,,,,,0,0,0,0
1650451131.3457398,public.usertable,1136384,129712,1464254464,16893,public,usertable,1,0,2979714,4514891,1216298,63443,79914,28954,1136384,129712,1359655,1216298,,,,,0,0,0,0
1650451132.375111,public.usertable,1136784,129722,1464745984,16893,public,usertable,1,0,2980838,4515419,1216708,63451,79924,28960,1136784,129722,1360083,1216708,,,,,0,0,0,0
1650451133.4063017,public.usertable,1137176,129740,1465237504,16893,public,usertable,1,0,2981950,4515572,1217106,63463,79930,28965,1137176,129740,1360499,1217106,,,,,0,0,0,0
1650451134.4360912,public.usertable,1137577,129753,1465737216,16893,public,usertable,1,0,2983039,4515834,1217517,63466,79940,28965,1137577,129753,1360923,1217517,,,,,0,0,0,0
1650451135.4652286,public.usertable,1137976,129767,1466236928,16893,public,usertable,1,0,2984182,4516419,1217928,63471,79952,28966,1137976,129767,1361351,1217928,,,,,0,0,0,0
1650451136.4955251,public.usertable,1138387,129776,1466761216,16893,public,usertable,1,0,2985297,4516629,1218349,63474,79962,28967,1138387,129776,1361785,1218349,,,,,0,0,0,0
1650451137.5246463,public.usertable,1138811,129794,1467277312,16893,public,usertable,1,0,2986400,4516966,1218785,63480,79974,28970,1138811,129794,1362239,1218785,,,,,0,0,0,0
1650451138.555166,public.usertable,1139216,129810,1467785216,16893,public,usertable,1,0,2987619,4517236,1219198,63491,79982,28973,1139216,129810,1362671,1219198,,,,,0,0,0,0
1650451139.5849137,public.usertable,1139626,129817,1468284928,16893,public,usertable,1,0,2988770,4517482,1219614,63494,79988,28975,1139626,129817,1363096,1219614,,,,,0,0,0,0
1650451140.6159327,public.usertable,1140040,129828,1468801024,16893,public,usertable,1,0,2989970,4518139,1220035,63499,79995,28977,1140040,129828,1363529,1220035,,,,,0,0,0,0
1650451141.6447296,public.usertable,1140450,129846,1469317120,16893,public,usertable,1,0,2991127,4518603,1220455,63507,80005,28979,1140450,129846,1363967,1220455,,,,,0,0,0,0
1650451142.6728177,public.usertable,1140865,129862,1469833216,16893,public,usertable,1,0,2992332,4519056,1220881,63512,80016,28982,1140865,129862,1364409,1220881,,,,,0,0,0,0
1650451143.7008574,public.usertable,1141295,129874,1470365696,16893,public,usertable,1,0,2993507,4519663,1221321,63518,80026,28985,1141295,129874,1364865,1221321,,,,,0,0,0,0
1650451144.7315176,public.usertable,1141915,129903,1470873600,16893,public,usertable,1,0,2995146,4520516,1221955,63533,80040,28993,1141915,129903,1365528,1221955,,,,,0,0,0,0
1650451145.7621455,public.usertable,1142320,129917,1471373312,16893,public,usertable,1,0,2996232,4520721,1222370,63537,80050,28994,1142320,129917,1365957,1222370,,,,,0,0,0,0
1650451146.7939227,public.usertable,1142721,129932,1471848448,16893,public,usertable,1,0,2997344,4520927,1222779,63544,80058,28997,1142721,129932,1366381,1222779,,,,,0,0,0,0
1650451147.8246503,public.usertable,1143123,129943,1472364544,16893,public,usertable,1,0,2998487,4522057,1223186,63552,80063,29002,1143123,129943,1366801,1223186,,,,,0,0,0,0
1650451148.85373,public.usertable,1143534,129958,1472880640,16893,public,usertable,1,0,2999709,4522534,1223606,63560,80072,29005,1143534,129958,1367238,1223606,,,,,0,0,0,0
1650451149.8823068,public.usertable,1143955,129976,1473413120,16893,public,usertable,1,0,3000717,4522930,1224039,63568,80084,29008,1143955,129976,1367691,1224039,,,,,0,0,0,0
1650451150.9134295,public.usertable,1144353,129994,1473904640,16893,public,usertable,1,0,3001766,4523567,1224446,63579,80093,29013,1144353,129994,1368118,1224446,,,,,0,0,0,0
1650451151.9434001,public.usertable,1144769,129999,1474412544,16893,public,usertable,1,0,3002856,4525281,1224865,63586,80096,29016,1144769,129999,1368547,1224865,,,,,0,0,0,0
1650451152.9751492,public.usertable,1145155,130009,1474887680,16893,public,usertable,1,0,3003900,4525985,1225262,63594,80107,29019,1145155,130009,1368963,1225262,,,,,0,0,0,0
1650451154.0031407,public.usertable,1145574,130022,1475411968,16893,public,usertable,1,0,3005029,4526240,1225687,63601,80113,29024,1145574,130022,1369401,1225687,,,,,0,0,0,0
1650451155.0349464,public.usertable,1145968,130033,1475895296,16893,public,usertable,1,0,3006117,4526613,1226091,63604,80123,29026,1145968,130033,1369818,1226091,,,,,0,0,0,0
1650451156.0649571,public.usertable,1146364,130051,1476386816,16893,public,usertable,1,0,3007157,4526783,1226498,63611,80134,29032,1146364,130051,1370243,1226498,,,,,0,0,0,0
1650451157.0950367,public.usertable,1146761,130066,1476886528,16893,public,usertable,1,0,3008396,4526944,1226909,63616,80148,29034,1146761,130066,1370673,1226909,,,,,0,0,0,0
1650451158.125646,public.usertable,1147159,130081,1477378048,16893,public,usertable,1,0,3009587,4527808,1227316,63625,80157,29039,1147159,130081,1371098,1227316,,,,,0,0,0,0
1650451159.154999,public.usertable,1147573,130097,1477894144,16893,public,usertable,1,0,3010835,4528307,1227737,63635,80164,29044,1147573,130097,1371536,1227737,,,,,0,0,0,0
1650451160.1840355,public.usertable,1147993,130118,1478418432,16893,public,usertable,1,0,3012106,4529162,1228170,63646,80177,29048,1147993,130118,1371993,1228170,,,,,0,0,0,0
1650451161.2121081,public.usertable,1148412,130127,1478950912,16893,public,usertable,1,0,3013433,4530132,1228598,63653,80186,29052,1148412,130127,1372437,1228598,,,,,0,0,0,0
1650451162.2406795,public.usertable,1149046,130141,1479475200,16893,public,usertable,1,0,3015113,4531004,1229244,63662,80198,29057,1149046,130141,1373104,1229244,,,,,0,0,0,0
1650451163.270475,public.usertable,1149477,130152,1480007680,16893,public,usertable,1,0,3016124,4531228,1229682,63668,80205,29061,1149477,130152,1373555,1229682,,,,,0,0,0,0
1650451164.3002026,public.usertable,1149871,130168,1480491008,16893,public,usertable,1,0,3017176,4532054,1230087,63674,80216,29063,1149871,130168,1373977,1230087,,,,,0,0,0,0
1650451165.3338044,public.usertable,1150261,130177,1480974336,16893,public,usertable,1,0,3018173,4532320,1230483,63677,80222,29065,1150261,130177,1374382,1230483,,,,,0,0,0,0
1650451166.3633435,public.usertable,1150641,130196,1481457664,16893,public,usertable,1,0,3019297,4532959,1230874,63688,80233,29070,1150641,130196,1374795,1230874,,,,,0,0,0,0
1650451167.393059,public.usertable,1151017,130213,1481908224,16893,public,usertable,1,0,3020382,4533771,1231260,63695,80243,29073,1151017,130213,1375198,1231260,,,,,0,0,0,0
1650451168.4229412,public.usertable,1151399,130224,1482399744,16893,public,usertable,1,0,3021335,4534190,1231647,63701,80248,29075,1151399,130224,1375596,1231647,,,,,0,0,0,0
1650451169.452016,public.usertable,1151811,130241,1482891264,16893,public,usertable,1,0,3022436,4534394,1232065,63712,80254,29079,1151811,130241,1376031,1232065,,,,,0,0,0,0
1650451170.4818008,public.usertable,1152139,130250,1483276288,16893,public,usertable,1,0,3023285,4534812,1232399,63719,80260,29083,1152139,130250,1376378,1232399,,,,,0,0,0,0
1650451171.5109255,public.usertable,1152425,130252,1483612160,16893,public,usertable,1,0,3024081,4535437,1232688,63723,80263,29085,1152425,130252,1376674,1232688,,,,,0,0,0,0
1650451172.5419338,public.usertable,1152698,130255,1483948032,16893,public,usertable,1,0,3024841,4535743,1232962,63727,80264,29086,1152698,130255,1376953,1232962,,,,,0,0,0,0
1650451173.5734162,public.usertable,1152938,130262,1484267520,16893,public,usertable,1,0,3025517,4536011,1233211,63731,80273,29089,1152938,130262,1377215,1233211,,,,,0,0,0,0
1650451174.6043284,public.usertable,1153247,130271,1484619776,16893,public,usertable,1,0,3026267,4536095,1233523,63737,80276,29093,1153247,130271,1377536,1233523,,,,,0,0,0,0
1650451175.6338117,public.usertable,1153521,130286,1484955648,16893,public,usertable,1,0,3027086,4536268,1233808,63741,80287,29094,1153521,130286,1377836,1233808,,,,,0,0,0,0
1650451176.6633077,public.usertable,1153765,130295,1485266944,16893,public,usertable,1,0,3027691,4536356,1234057,63745,80292,29098,1153765,130295,1378094,1234057,,,,,0,0,0,0
1650451177.6932473,public.usertable,1154033,130305,1485594624,16893,public,usertable,1,0,3028416,4536469,1234331,63749,80298,29101,1154033,130305,1378378,1234331,,,,,0,0,0,0
1650451178.7240267,public.usertable,1154307,130316,1485971456,16893,public,usertable,1,0,3029110,4536690,1234612,63753,80305,29102,1154307,130316,1378670,1234612,,,,,0,0,0,0
1650451179.7522647,public.usertable,1154597,130325,1486340096,16893,public,usertable,1,0,3029955,4537053,1234909,63757,80312,29106,1154597,130325,1378978,1234909,,,,,0,0,0,0
1650451180.782786,public.usertable,1154902,130332,1486659584,16893,public,usertable,1,0,3030828,4537274,1235218,63761,80316,29109,1154902,130332,1379295,1235218,,,,,0,0,0,0
1650451181.81231,public.usertable,1155164,130337,1487003648,16893,public,usertable,1,0,3031491,4537637,1235483,63765,80319,29112,1155164,130337,1379567,1235483,,,,,0,0,0,0
1650451182.8420212,public.usertable,1155621,130357,1487380480,16893,public,usertable,1,0,3032766,4537855,1235951,63774,80330,29115,1155621,130357,1380055,1235951,,,,,0,0,0,0
1650451183.872563,public.usertable,1155922,130368,1487773696,16893,public,usertable,1,0,3033650,4538162,1236260,63777,80338,29117,1155922,130368,1380375,1236260,,,,,0,0,0,0
1650451184.9013517,public.usertable,1156324,130380,1488273408,16893,public,usertable,1,0,3034731,4538679,1236674,63780,80350,29117,1156324,130380,1380804,1236674,,,,,0,0,0,0
1650451185.9309309,public.usertable,1156718,130395,1488756736,16893,public,usertable,1,0,3035794,4539376,1237079,63784,80361,29118,1156718,130395,1381224,1237079,,,,,0,0,0,0
1650451186.9594526,public.usertable,1157124,130407,1489256448,16893,public,usertable,1,0,3036817,4539568,1237490,63791,80366,29122,1157124,130407,1381647,1237490,,,,,0,0,0,0
1650451187.9882882,public.usertable,1157519,130424,1489756160,16893,public,usertable,1,0,3037869,4540343,1237899,63799,80380,29125,1157519,130424,1382078,1237899,,,,,0,0,0,0
1650451189.017316,public.usertable,1157916,130435,1490239488,16893,public,usertable,1,0,3038845,4540769,1238306,63803,80390,29125,1157916,130435,1382499,1238306,,,,,0,0,0,0
1650451190.0455513,public.usertable,1158309,130445,1490722816,16893,public,usertable,1,0,3039787,4541335,1238705,63807,80396,29127,1158309,130445,1382908,1238705,,,,,0,0,0,0
1650451191.0792801,public.usertable,1158690,130455,1491206144,16893,public,usertable,1,0,3040775,4542115,1239094,63811,80404,29127,1158690,130455,1383309,1239094,,,,,0,0,0,0
1650451192.1098132,public.usertable,1159079,130473,1491681280,16893,public,usertable,1,0,3042014,4542700,1239491,63822,80412,29134,1159079,130473,1383725,1239491,,,,,0,0,0,0
1650451193.1405888,public.usertable,1159473,130479,1492172800,16893,public,usertable,1,0,3043088,4543161,1239889,63828,80416,29136,1159473,130479,1384133,1239889,,,,,0,0,0,0
1650451194.171392,public.usertable,1159873,130492,1492664320,16893,public,usertable,1,0,3044137,4543373,1240296,63838,80423,29141,1159873,130492,1384557,1240296,,,,,0,0,0,0
1650451195.2041063,public.usertable,1160272,130505,1493164032,16893,public,usertable,1,0,3045230,4543703,1240708,63843,80436,29144,1160272,130505,1384987,1240708,,,,,0,0,0,0
1650451196.2356322,public.usertable,1160672,130516,1493680128,16893,public,usertable,1,0,3046306,4544276,1241118,63846,80446,29145,1160672,130516,1385410,1241118,,,,,0,0,0,0
1650451197.2657204,public.usertable,1161082,130538,1494163456,16893,public,usertable,1,0,3047425,4544472,1241541,63855,80459,29148,1161082,130538,1385855,1241541,,,,,0,0,0,0
1650451198.2955647,public.usertable,1161465,130545,1494671360,16893,public,usertable,1,0,3048481,4545105,1241933,63862,80468,29150,1161465,130545,1386263,1241933,,,,,0,0,0,0
1650451199.3311675,public.usertable,1161884,130556,1495179264,16893,public,usertable,1,0,3049536,4545543,1242358,63867,80474,29151,1161884,130556,1386699,1242358,,,,,0,0,0,0
1650451200.3592942,public.usertable,1162495,130578,1495687168,16893,public,usertable,1,0,3051182,4546482,1242982,63877,80487,29156,1162495,130578,1387346,1242982,,,,,0,0,0,0
1650451201.3915284,public.usertable,1162859,130593,1496129536,16893,public,usertable,1,0,3052068,4546642,1243353,63886,80494,29160,1162859,130593,1387733,1243353,,,,,0,0,0,0
1650451202.420696,public.usertable,1163166,130603,1496506368,16893,public,usertable,1,0,3052875,4547569,1243666,63891,80500,29162,1163166,130603,1388057,1243666,,,,,0,0,0,0
1650451203.449602,public.usertable,1163492,130608,1496915968,16893,public,usertable,1,0,3053823,4548412,1244000,63895,80508,29163,1163492,130608,1388403,1244000,,,,,0,0,0,0
1650451204.4782636,public.usertable,1163790,130623,1497284608,16893,public,usertable,1,0,3054612,4548732,1244308,63900,80518,29166,1163790,130623,1388726,1244308,,,,,0,0,0,0
1650451205.5086012,public.usertable,1164092,130629,1497645056,16893,public,usertable,1,0,3055439,4549018,1244618,63903,80526,29166,1164092,130629,1389047,1244618,,,,,0,0,0,0
1650451206.537501,public.usertable,1164377,130640,1498013696,16893,public,usertable,1,0,3056224,4549249,1244911,63909,80534,29170,1164377,130640,1389354,1244911,,,,,0,0,0,0
1650451207.5665176,public.usertable,1164671,130649,1498374144,16893,public,usertable,1,0,3056980,4549546,1245209,63915,80538,29173,1164671,130649,1389662,1245209,,,,,0,0,0,0
1650451208.5952988,public.usertable,1164944,130663,1498718208,16893,public,usertable,1,0,3057710,4549837,1245487,63924,80543,29176,1164944,130663,1389954,1245487,,,,,0,0,0,0
1650451209.626444,public.usertable,1165271,130672,1499119616,16893,public,usertable,1,0,3058556,4550418,1245820,63928,80549,29178,1165271,130672,1390297,1245820,,,,,0,0,0,0
1650451210.6562636,public.usertable,1165643,130683,1499594752,16893,public,usertable,1,0,3059586,4550882,1246198,63933,80555,29182,1165643,130683,1390686,1246198,,,,,0,0,0,0
1650451211.6852908,public.usertable,1166029,130699,1500069888,16893,public,usertable,1,0,3060617,4551387,1246591,63944,80562,29189,1166029,130699,1391097,1246591,,,,,0,0,0,0
1650451212.7136958,public.usertable,1166429,130716,1500585984,16893,public,usertable,1,0,3061684,4551617,1247002,63954,80573,29192,1166429,130716,1391529,1247002,,,,,0,0,0,0
1650451213.7453022,public.usertable,1166815,130735,1501077504,16893,public,usertable,1,0,3062730,4551711,1247400,63961,80585,29196,1166815,130735,1391946,1247400,,,,,0,0,0,0
1650451214.7763922,public.usertable,1167200,130757,1501560832,16893,public,usertable,1,0,3063830,4552026,1247799,63969,80599,29201,1167200,130757,1392367,1247799,,,,,0,0,0,0
1650451215.8085449,public.usertable,1167584,130770,1502035968,16893,public,usertable,1,0,3064864,4552431,1248192,63975,80608,29204,1167584,130770,1392775,1248192,,,,,0,0,0,0
1650451216.838323,public.usertable,1167978,130775,1502527488,16893,public,usertable,1,0,3065906,4553111,1248592,63979,80614,29205,1167978,130775,1393185,1248592,,,,,0,0,0,0
1650451217.8672779,public.usertable,1168382,130783,1503002624,16893,public,usertable,1,0,3066942,4553656,1249003,63983,80621,29207,1168382,130783,1393607,1249003,,,,,0,0,0,0
1650451218.8963795,public.usertable,1168779,130794,1503510528,16893,public,usertable,1,0,3068018,4554213,1249406,63991,80627,29210,1168779,130794,1394024,1249406,,,,,0,0,0,0
1650451219.92574,public.usertable,1169381,130811,1504002048,16893,public,usertable,1,0,3069635,4554936,1250017,64004,80636,29219,1169381,130811,1394657,1250017,,,,,0,0,0,0
1650451220.958647,public.usertable,1169796,130818,1504509952,16893,public,usertable,1,0,3070752,4555481,1250441,64007,80645,29221,1169796,130818,1395093,1250441,,,,,0,0,0,0
1650451221.9862444,public.usertable,1170200,130830,1505001472,16893,public,usertable,1,0,3071836,4555611,1250853,64011,80653,29223,1170200,130830,1395517,1250853,,,,,0,0,0,0
1650451223.0162802,public.usertable,1170584,130848,1505484800,16893,public,usertable,1,0,3072899,4555892,1251248,64018,80664,29225,1170584,130848,1395930,1251248,,,,,0,0,0,0
1650451224.046901,public.usertable,1171004,130860,1506009088,16893,public,usertable,1,0,3073988,4556218,1251675,64023,80671,29227,1171004,130860,1396369,1251675,,,,,0,0,0,0
1650451225.078729,public.usertable,1171411,130876,1506500608,16893,public,usertable,1,0,3075165,4556810,1252092,64031,80681,29232,1171411,130876,1396804,1252092,,,,,0,0,0,0
1650451226.1090949,public.usertable,1171738,130883,1506902016,16893,public,usertable,1,0,3075996,4556941,1252423,64034,80685,29233,1171738,130883,1397142,1252423,,,,,0,0,0,0
1650451227.1386504,public.usertable,1172138,130903,1507434496,16893,public,usertable,1,0,3077137,4557039,1252836,64041,80698,29236,1172138,130903,1397575,1252836,,,,,0,0,0,0
1650451228.1671917,public.usertable,1172555,130911,1507917824,16893,public,usertable,1,0,3078248,4557136,1253257,64047,80702,29238,1172555,130911,1398006,1253257,,,,,0,0,0,0
1650451229.195505,public.usertable,1172837,130929,1508237312,16893,public,usertable,1,0,3079049,4557925,1253552,64053,80715,29243,1172837,130929,1398320,1253552,,,,,0,0,0,0
1650451230.2256575,public.usertable,1173147,130938,1508663296,16893,public,usertable,1,0,3079920,4558079,1253868,64057,80721,29245,1173147,130938,1398646,1253868,,,,,0,0,0,0
1650451231.2568743,public.usertable,1173448,130944,1509023744,16893,public,usertable,1,0,3080736,4558461,1254176,64061,80728,29248,1173448,130944,1398965,1254176,,,,,0,0,0,0
1650451232.285643,public.usertable,1173729,130956,1509376000,16893,public,usertable,1,0,3081473,4558618,1254464,64066,80735,29249,1173729,130956,1399265,1254464,,,,,0,0,0,0
1650451233.314181,public.usertable,1174069,130970,1509769216,16893,public,usertable,1,0,3082416,4559067,1254810,64074,80741,29253,1174069,130970,1399625,1254810,,,,,0,0,0,0
1650451234.3453448,public.usertable,1174375,130978,1510137856,16893,public,usertable,1,0,3083115,4559453,1255121,64077,80746,29254,1174375,130978,1399944,1255121,,,,,0,0,0,0
1650451235.376402,public.usertable,1174660,130983,1510481920,16893,public,usertable,1,0,3083905,4559565,1255408,64080,80748,29256,1174660,130983,1400236,1255408,,,,,0,0,0,0
1650451236.4053292,public.usertable,1174973,130996,1510932480,16893,public,usertable,1,0,3084643,4559969,1255729,64085,80756,29260,1174973,130996,1400570,1255729,,,,,0,0,0,0
1650451237.4337945,public.usertable,1175385,131009,1511440384,16893,public,usertable,1,0,3085757,4560773,1256152,64093,80767,29265,1175385,131009,1401012,1256152,,,,,0,0,0,0
1650451238.4626236,public.usertable,1175802,131017,1511948288,16893,public,usertable,1,0,3086892,4561314,1256579,64095,80777,29267,1175802,131017,1401451,1256579,,,,,0,0,0,0
1650451239.4934175,public.usertable,1176176,131031,1512431616,16893,public,usertable,1,0,3087863,4561665,1256961,64103,80785,29273,1176176,131031,1401849,1256961,,,,,0,0,0,0
1650451240.5227098,public.usertable,1176801,131052,1512931328,16893,public,usertable,1,0,3089656,4562760,1257599,64113,80798,29277,1176801,131052,1402510,1257599,,,,,0,0,0,0
1650451241.5538664,public.usertable,1177192,131062,1513422848,16893,public,usertable,1,0,3090802,4562979,1257998,64120,80806,29281,1177192,131062,1402924,1257998,,,,,0,0,0,0
1650451242.5849996,public.usertable,1177597,131077,1513922560,16893,public,usertable,1,0,3091849,4563492,1258409,64130,80812,29286,1177597,131077,1403351,1258409,,,,,0,0,0,0
1650451243.6137447,public.usertable,1177985,131092,1514397696,16893,public,usertable,1,0,3092977,4563776,1258808,64136,80823,29291,1177985,131092,1403767,1258808,,,,,0,0,0,0
1650451244.643482,public.usertable,1178376,131106,1514881024,16893,public,usertable,1,0,3094084,4564169,1259204,64145,80828,29297,1178376,131106,1404177,1259204,,,,,0,0,0,0
1650451245.6719644,public.usertable,1178784,131111,1515364352,16893,public,usertable,1,0,3095113,4564750,1259616,64149,80832,29299,1178784,131111,1404597,1259616,,,,,0,0,0,0
1650451246.7013967,public.usertable,1179180,131123,1515872256,16893,public,usertable,1,0,3096174,4565050,1260020,64153,80840,29301,1179180,131123,1405013,1260020,,,,,0,0,0,0
1650451247.7297387,public.usertable,1179590,131145,1516380160,16893,public,usertable,1,0,3097240,4565363,1260442,64163,80852,29307,1179590,131145,1405457,1260442,,,,,0,0,0,0
1650451248.75951,public.usertable,1179975,131151,1516847104,16893,public,usertable,1,0,3098215,4565863,1260835,64166,80860,29307,1179975,131151,1405861,1260835,,,,,0,0,0,0
1650451249.7946632,public.usertable,1180371,131155,1517346816,16893,public,usertable,1,0,3099206,4566467,1261240,64172,80869,29311,1180371,131155,1406281,1261240,,,,,0,0,0,0
1650451250.8244956,public.usertable,1180751,131169,1517805568,16893,public,usertable,1,0,3100226,4566667,1261628,64178,80877,29313,1180751,131169,1406683,1261628,,,,,0,0,0,0
1650451251.8527262,public.usertable,1181132,131181,1518280704,16893,public,usertable,1,0,3101249,4567269,1262016,64185,80884,29315,1181132,131181,1407085,1262016,,,,,0,0,0,0
1650451252.8830037,public.usertable,1181491,131190,1518714880,16893,public,usertable,1,0,3102125,4567588,1262381,64189,80890,29316,1181491,131190,1407460,1262381,,,,,0,0,0,0
1650451253.9124956,public.usertable,1181856,131196,1519190016,16893,public,usertable,1,0,3103024,4567788,1262751,64195,80895,29319,1181856,131196,1407841,1262751,,,,,0,0,0,0
1650451254.9444313,public.usertable,1182229,131208,1519640576,16893,public,usertable,1,0,3104020,4568314,1263134,64200,80905,29321,1182229,131208,1408239,1263134,,,,,0,0,0,0
1650451255.9729545,public.usertable,1182623,131219,1520140288,16893,public,usertable,1,0,3105064,4568553,1263534,64206,80911,29322,1182623,131219,1408651,1263534,,,,,0,0,0,0
1650451257.0012076,public.usertable,1183025,131234,1520631808,16893,public,usertable,1,0,3106132,4568891,1263944,64216,80919,29327,1183025,131234,1409079,1263944,,,,,0,0,0,0
1650451258.0354989,public.usertable,1183400,131250,1521098752,16893,public,usertable,1,0,3107105,4569191,1264332,64223,80932,29332,1183400,131250,1409487,1264332,,,,,0,0,0,0
1650451259.0681496,public.usertable,1183957,131266,1521549312,16893,public,usertable,1,0,3108724,4570405,1264898,64234,80941,29338,1183957,131266,1410073,1264898,,,,,0,0,0,0
1650451260.0969546,public.usertable,1184351,131282,1522040832,16893,public,usertable,1,0,3109733,4571008,1265305,64240,80954,29340,1184351,131282,1410499,1265305,,,,,0,0,0,0
1650451261.1250248,public.usertable,1184709,131298,1522483200,16893,public,usertable,1,0,3110719,4571231,1265671,64248,80962,29343,1184709,131298,1410881,1265671,,,,,0,0,0,0
1650451262.1558597,public.usertable,1185068,131313,1522933760,16893,public,usertable,1,0,3111770,4571756,1266038,64256,80970,29345,1185068,131313,1411264,1266038,,,,,0,0,0,0
1650451263.1848652,public.usertable,1185419,131331,1523376128,16893,public,usertable,1,0,3112748,4571942,1266400,64265,80981,29351,1185419,131331,1411646,1266400,,,,,0,0,0,0
1650451264.213994,public.usertable,1185787,131346,1523834880,16893,public,usertable,1,0,3113785,4572317,1266775,64273,80988,29355,1185787,131346,1412036,1266775,,,,,0,0,0,0
1650451265.2445753,public.usertable,1186177,131361,1524260864,16893,public,usertable,1,0,3114844,4573000,1267173,64280,80996,29359,1186177,131361,1412449,1267173,,,,,0,0,0,0
1650451266.2741885,public.usertable,1186521,131379,1524752384,16893,public,usertable,1,0,3115727,4573707,1267524,64291,81003,29366,1186521,131379,1412818,1267524,,,,,0,0,0,0
1650451267.307169,public.usertable,1186913,131389,1525219328,16893,public,usertable,1,0,3116714,4574658,1267920,64300,81007,29369,1186913,131389,1413227,1267920,,,,,0,0,0,0
1650451268.3384635,public.usertable,1187263,131398,1525669888,16893,public,usertable,1,0,3117636,4575138,1268277,64302,81014,29370,1187263,131398,1413593,1268277,,,,,0,0,0,0
1650451269.3675709,public.usertable,1187666,131407,1526136832,16893,public,usertable,1,0,3118679,4575797,1268685,64308,81019,29373,1187666,131407,1414012,1268685,,,,,0,0,0,0
1650451270.3978238,public.usertable,1188039,131422,1526603776,16893,public,usertable,1,0,3119639,4576015,1269068,64315,81029,29377,1188039,131422,1414412,1269068,,,,,0,0,0,0
1650451271.4293349,public.usertable,1188402,131436,1527078912,16893,public,usertable,1,0,3120652,4576066,1269437,64323,81035,29382,1188402,131436,1414795,1269437,,,,,0,0,0,0
1650451272.4586937,public.usertable,1188778,131452,1527529472,16893,public,usertable,1,0,3121705,4576338,1269821,64331,81043,29387,1188778,131452,1415195,1269821,,,,,0,0,0,0
1650451273.4859624,public.usertable,1189135,131475,1527980032,16893,public,usertable,1,0,3122677,4576612,1270194,64338,81059,29391,1189135,131475,1415591,1270194,,,,,0,0,0,0
1650451274.514974,public.usertable,1189490,131487,1528406016,16893,public,usertable,1,0,3123732,4577314,1270560,64344,81070,29396,1189490,131487,1415974,1270560,,,,,0,0,0,0
1650451275.5450482,public.usertable,1189851,131500,1528872960,16893,public,usertable,1,0,3124691,4578185,1270930,64352,81079,29398,1189851,131500,1416361,1270930,,,,,0,0,0,0
1650451276.5757413,public.usertable,1190172,131506,1529249792,16893,public,usertable,1,0,3125677,4578827,1271256,64358,81084,29402,1190172,131506,1416698,1271256,,,,,0,0,0,0
1650451277.6051426,public.usertable,1190560,131512,1529749504,16893,public,usertable,1,0,3126837,4579501,1271650,64361,81090,29404,1190560,131512,1417101,1271650,,,,,0,0,0,0
1650451278.635724,public.usertable,1191173,131534,1530257408,16893,public,usertable,1,0,3128535,4580842,1272272,64374,81099,29412,1191173,131534,1417745,1272272,,,,,0,0,0,0
1650451279.6659157,public.usertable,1191546,131544,1530716160,16893,public,usertable,1,0,3129535,4580991,1272652,64380,81106,29414,1191546,131544,1418138,1272652,,,,,0,0,0,0
1650451280.7004187,public.usertable,1191930,131559,1531199488,16893,public,usertable,1,0,3130723,4581301,1273047,64385,81117,29414,1191930,131559,1418549,1273047,,,,,0,0,0,0
1650451281.7326355,public.usertable,1192312,131567,1531658240,16893,public,usertable,1,0,3131699,4581400,1273435,64390,81123,29416,1192312,131567,1418948,1273435,,,,,0,0,0,0
1650451282.7613819,public.usertable,1192591,131578,1531994112,16893,public,usertable,1,0,3132445,4581542,1273721,64394,81130,29418,1192591,131578,1419245,1273721,,,,,0,0,0,0
1650451283.7891383,public.usertable,1192857,131586,1532338176,16893,public,usertable,1,0,3133112,4581737,1273993,64396,81136,29419,1192857,131586,1419525,1273993,,,,,0,0,0,0
1650451284.819745,public.usertable,1193134,131603,1532682240,16893,public,usertable,1,0,3134026,4581990,1274280,64404,81146,29424,1193134,131603,1419830,1274280,,,,,0,0,0,0
1650451285.8509543,public.usertable,1193425,131612,1533001728,16893,public,usertable,1,0,3134789,4582065,1274577,64407,81152,29426,1193425,131612,1420136,1274577,,,,,0,0,0,0
1650451286.8800428,public.usertable,1193698,131619,1533362176,16893,public,usertable,1,0,3135448,4582406,1274852,64414,81154,29431,1193698,131619,1420420,1274852,,,,,0,0,0,0
1650451287.9085088,public.usertable,1193966,131625,1533665280,16893,public,usertable,1,0,3136161,4582643,1275123,64417,81157,29431,1193966,131625,1420697,1275123,,,,,0,0,0,0
1650451288.9407623,public.usertable,1194217,131629,1534001152,16893,public,usertable,1,0,3136838,4582847,1275378,64417,81161,29431,1194217,131629,1420956,1275378,,,,,0,0,0,0
1650451289.9718897,public.usertable,1194501,131632,1534328832,16893,public,usertable,1,0,3137578,4583360,1275669,64419,81168,29433,1194501,131632,1421256,1275669,,,,,0,0,0,0
1650451291.0011263,public.usertable,1194710,131637,1534590976,16893,public,usertable,1,0,3138238,4583773,1275885,64422,81175,29433,1194710,131637,1421482,1275885,,,,,0,0,0,0
1650451292.0314,public.usertable,1194969,131643,1534935040,16893,public,usertable,1,0,3138903,4584130,1276151,64426,81182,29436,1194969,131643,1421759,1276151,,,,,0,0,0,0
1650451293.059632,public.usertable,1195248,131655,1535279104,16893,public,usertable,1,0,3139615,4584236,1276436,64432,81188,29439,1195248,131655,1422056,1276436,,,,,0,0,0,0
1650451294.0918188,public.usertable,1195493,131667,1535541248,16893,public,usertable,1,0,3140211,4584368,1276684,64441,81191,29442,1195493,131667,1422316,1276684,,,,,0,0,0,0
1650451295.1217868,public.usertable,1195715,131674,1535844352,16893,public,usertable,1,0,3140791,4584489,1276911,64443,81196,29443,1195715,131674,1422550,1276911,,,,,0,0,0,0
1650451296.152377,public.usertable,1195965,131683,1536172032,16893,public,usertable,1,0,3141575,4584820,1277168,64448,81203,29447,1195965,131683,1422819,1277168,,,,,0,0,0,0
1650451297.1819408,public.usertable,1196262,131688,1536524288,16893,public,usertable,1,0,3142274,4584908,1277468,64450,81206,29449,1196262,131688,1423124,1277468,,,,,0,0,0,0
1650451298.2132354,public.usertable,1196535,131696,1536876544,16893,public,usertable,1,0,3143080,4585564,1277745,64454,81210,29450,1196535,131696,1423409,1277745,,,,,0,0,0,0
1650451299.2441585,public.usertable,1196812,131700,1537220608,16893,public,usertable,1,0,3143887,4585939,1278030,64455,81218,29450,1196812,131700,1423703,1278030,,,,,0,0,0,0
1650451300.2735353,public.usertable,1197084,131713,1537540096,16893,public,usertable,1,0,3144624,4586086,1278310,64463,81226,29456,1197084,131713,1423999,1278310,,,,,0,0,0,0
1650451301.30087,public.usertable,1197459,131732,1537835008,16893,public,usertable,1,0,3145586,4586528,1278696,64473,81237,29460,1197459,131732,1424406,1278696,,,,,0,0,0,0
1650451302.3313572,public.usertable,1197750,131741,1538203648,16893,public,usertable,1,0,3146470,4587158,1278993,64476,81243,29461,1197750,131741,1424712,1278993,,,,,0,0,0,0
1650451303.36034,public.usertable,1198126,131750,1538670592,16893,public,usertable,1,0,3147651,4587504,1279374,64483,81248,29464,1198126,131750,1425105,1279374,,,,,0,0,0,0
1650451304.391074,public.usertable,1198513,131760,1539137536,16893,public,usertable,1,0,3148595,4587619,1279765,64489,81252,29468,1198513,131760,1425506,1279765,,,,,0,0,0,0
1650451305.4209185,public.usertable,1198911,131766,1539612672,16893,public,usertable,1,0,3149683,4587838,1280170,64491,81259,29469,1198911,131766,1425920,1280170,,,,,0,0,0,0
1650451306.4494686,public.usertable,1199285,131784,1540079616,16893,public,usertable,1,0,3150691,4588196,1280551,64502,81266,29476,1199285,131784,1426319,1280551,,,,,0,0,0,0
1650451307.4794035,public.usertable,1199673,131795,1540546560,16893,public,usertable,1,0,3151692,4588321,1280950,64504,81277,29477,1199673,131795,1426731,1280950,,,,,0,0,0,0
1650451308.5085254,public.usertable,1200033,131807,1541005312,16893,public,usertable,1,0,3152685,4588566,1281317,64512,81284,29479,1200033,131807,1427113,1281317,,,,,0,0,0,0
1650451309.5403848,public.usertable,1200420,131823,1541464064,16893,public,usertable,1,0,3153715,4589204,1281712,64521,81292,29486,1200420,131823,1427525,1281712,,,,,0,0,0,0
1650451310.5731487,public.usertable,1200776,131839,1541931008,16893,public,usertable,1,0,3154732,4589664,1282078,64531,81302,29490,1200776,131839,1427911,1282078,,,,,0,0,0,0
1650451311.6041102,public.usertable,1201129,131851,1542365184,16893,public,usertable,1,0,3155694,4590174,1282441,64538,81312,29491,1201129,131851,1428291,1282441,,,,,0,0,0,0
1650451312.6345515,public.usertable,1201487,131867,1542799360,16893,public,usertable,1,0,3156670,4590542,1282808,64547,81321,29495,1201487,131867,1428676,1282808,,,,,0,0,0,0
1650451313.6632605,public.usertable,1201822,131874,1543241728,16893,public,usertable,1,0,3157694,4590702,1283153,64550,81331,29497,1201822,131874,1429034,1283153,,,,,0,0,0,0
1650451314.6930778,public.usertable,1202203,131883,1543716864,16893,public,usertable,1,0,3158706,4590990,1283537,64556,81334,29498,1202203,131883,1429427,1283537,,,,,0,0,0,0
1650451315.722678,public.usertable,1202600,131899,1544200192,16893,public,usertable,1,0,3159719,4591219,1283945,64561,81345,29500,1202600,131899,1429851,1283945,,,,,0,0,0,0
1650451316.7525282,public.usertable,1202961,131913,1544658944,16893,public,usertable,1,0,3160607,4591512,1284313,64568,81352,29504,1202961,131913,1430233,1284313,,,,,0,0,0,0
1650451317.781378,public.usertable,1203366,131930,1545158656,16893,public,usertable,1,0,3161770,4591661,1284728,64575,81362,29508,1203366,131930,1430665,1284728,,,,,0,0,0,0
1650451318.8122199,public.usertable,1203748,131949,1545617408,16893,public,usertable,1,0,3162741,4591901,1285120,64584,81372,29513,1203748,131949,1431076,1285120,,,,,0,0,0,0
1650451319.842122,public.usertable,1204133,131964,1546092544,16893,public,usertable,1,0,3163748,4592023,1285513,64591,81380,29517,1204133,131964,1431484,1285513,,,,,0,0,0,0
1650451320.870847,public.usertable,1204526,131976,1546592256,16893,public,usertable,1,0,3164766,4592481,1285915,64597,81389,29521,1204526,131976,1431901,1285915,,,,,0,0,0,0
1650451321.8997877,public.usertable,1205111,132000,1547075584,16893,public,usertable,1,0,3166464,4592790,1286513,64608,81402,29525,1205111,132000,1432523,1286513,,,,,0,0,0,0
1650451322.932776,public.usertable,1205478,132017,1547526144,16893,public,usertable,1,0,3167519,4592897,1286885,64620,81407,29530,1205478,132017,1432912,1286885,,,,,0,0,0,0
1650451323.9630394,public.usertable,1205800,132027,1547919360,16893,public,usertable,1,0,3168523,4593132,1287212,64628,81412,29534,1205800,132027,1433252,1287212,,,,,0,0,0,0
1650451324.9977956,public.usertable,1206104,132031,1548304384,16893,public,usertable,1,0,3169414,4593569,1287523,64633,81419,29535,1206104,132031,1433575,1287523,,,,,0,0,0,0
1650451326.0304592,public.usertable,1206404,132045,1548697600,16893,public,usertable,1,0,3170210,4593958,1287832,64640,81428,29540,1206404,132045,1433900,1287832,,,,,0,0,0,0
1650451327.0605788,public.usertable,1206791,132055,1549164544,16893,public,usertable,1,0,3171186,4594226,1288224,64649,81433,29545,1206791,132055,1434306,1288224,,,,,0,0,0,0
1650451328.0901768,public.usertable,1207179,132071,1549639680,16893,public,usertable,1,0,3172224,4594390,1288623,64657,81444,29550,1207179,132071,1434724,1288623,,,,,0,0,0,0
1650451329.1193218,public.usertable,1207563,132080,1550131200,16893,public,usertable,1,0,3173225,4595091,1289012,64664,81449,29555,1207563,132080,1435125,1289012,,,,,0,0,0,0
1650451330.1489415,public.usertable,1207941,132096,1550573568,16893,public,usertable,1,0,3174239,4595500,1289400,64670,81459,29560,1207941,132096,1435529,1289400,,,,,0,0,0,0
1650451331.1782167,public.usertable,1208326,132112,1551032320,16893,public,usertable,1,0,3175306,4595898,1289796,64675,81470,29565,1208326,132112,1435941,1289796,,,,,0,0,0,0
1650451332.207416,public.usertable,1208654,132127,1551450112,16893,public,usertable,1,0,3176209,4595987,1290133,64681,81479,29566,1208654,132127,1436293,1290133,,,,,0,0,0,0
1650451333.2366354,public.usertable,1209017,132138,1551917056,16893,public,usertable,1,0,3177120,4596239,1290501,64687,81484,29569,1209017,132138,1436672,1290501,,,,,0,0,0,0
1650451334.267274,public.usertable,1209369,132150,1552367616,16893,public,usertable,1,0,3178055,4596429,1290860,64692,81491,29573,1209369,132150,1437043,1290860,,,,,0,0,0,0
1650451335.297378,public.usertable,1209755,132159,1552793600,16893,public,usertable,1,0,3179089,4596644,1291250,64698,81495,29575,1209755,132159,1437443,1291250,,,,,0,0,0,0
1650451336.3257442,public.usertable,1210108,132167,1553235968,16893,public,usertable,1,0,3179961,4596941,1291607,64703,81499,29578,1210108,132167,1437809,1291607,,,,,0,0,0,0
1650451337.3547912,public.usertable,1210453,132179,1553670144,16893,public,usertable,1,0,3180891,4597535,1291962,64707,81509,29580,1210453,132179,1438178,1291962,,,,,0,0,0,0
1650451338.3837693,public.usertable,1210809,132191,1554096128,16893,public,usertable,1,0,3181925,4597908,1292323,64714,81514,29584,1210809,132191,1438551,1292323,,,,,0,0,0,0
1650451339.415246,public.usertable,1211140,132195,1554489344,16893,public,usertable,1,0,3182791,4598127,1292657,64718,81517,29586,1211140,132195,1438892,1292657,,,,,0,0,0,0
1650451340.445731,public.usertable,1211466,132209,1554898944,16893,public,usertable,1,0,3183762,4598301,1292993,64722,81527,29587,1211466,132209,1439242,1292993,,,,,0,0,0,0
1650451341.4771893,public.usertable,1211983,132208,1555333120,16893,public,usertable,1,0,3185111,4598819,1293516,64728,81533,29590,1211983,132208,1439777,1293516,,,,,0,0,0,0
1650451342.50624,public.usertable,1212320,132223,1555767296,16893,public,usertable,1,0,3186008,4598921,1293858,64738,81538,29592,1212320,132223,1440134,1293858,,,,,0,0,0,0
1650451343.5365286,public.usertable,1212684,132233,1556209664,16893,public,usertable,1,0,3187003,4599147,1294230,64742,81546,29594,1212684,132233,1440518,1294230,,,,,0,0,0,0
1650451344.5699933,public.usertable,1213038,132255,1556635648,16893,public,usertable,1,0,3188023,4599294,1294592,64756,81554,29601,1213038,132255,1440902,1294592,,,,,0,0,0,0
1650451345.599664,public.usertable,1213387,132263,1557086208,16893,public,usertable,1,0,3188969,4599718,1294945,64762,81558,29606,1213387,132263,1441265,1294945,,,,,0,0,0,0
1650451346.6299937,public.usertable,1213774,132272,1557561344,16893,public,usertable,1,0,3190045,4600244,1295339,64765,81565,29607,1213774,132272,1441669,1295339,,,,,0,0,0,0
1650451347.65962,public.usertable,1214171,132286,1558052864,16893,public,usertable,1,0,3191108,4600580,1295743,64775,81572,29608,1214171,132286,1442090,1295743,,,,,0,0,0,0
1650451348.6902816,public.usertable,1214570,132305,1558544384,16893,public,usertable,1,0,3192160,4600956,1296153,64783,81583,29614,1214570,132305,1442519,1296153,,,,,0,0,0,0
1650451349.7200272,public.usertable,1214962,132321,1559052288,16893,public,usertable,1,0,3193250,4601419,1296553,64793,81591,29618,1214962,132321,1442937,1296553,,,,,0,0,0,0
1650451350.7512352,public.usertable,1215353,132333,1559519232,16893,public,usertable,1,0,3194378,4602034,1296952,64800,81599,29622,1215353,132333,1443351,1296952,,,,,0,0,0,0
1650451351.7839046,public.usertable,1215748,132341,1560018944,16893,public,usertable,1,0,3195540,4602780,1297354,64806,81606,29626,1215748,132341,1443766,1297354,,,,,0,0,0,0
1650451352.8145702,public.usertable,1216126,132363,1560485888,16893,public,usertable,1,0,3196534,4603048,1297742,64818,81616,29631,1216126,132363,1444176,1297742,,,,,0,0,0,0
1650451353.8427658,public.usertable,1216515,132377,1560977408,16893,public,usertable,1,0,3197631,4603487,1298137,64826,81622,29632,1216515,132377,1444585,1298137,,,,,0,0,0,0
1650451354.8731081,public.usertable,1216906,132392,1561436160,16893,public,usertable,1,0,3198707,4603898,1298534,64835,81628,29637,1216906,132392,1444997,1298534,,,,,0,0,0,0
1650451355.9016438,public.usertable,1217288,132409,1561944064,16893,public,usertable,1,0,3199722,4604050,1298926,64842,81638,29642,1217288,132409,1445406,1298926,,,,,0,0,0,0
1650451356.9316034,public.usertable,1217716,132410,1562460160,16893,public,usertable,1,0,3200741,4604718,1299357,64846,81641,29643,1217716,132410,1445844,1299357,,,,,0,0,0,0
1650451357.9628088,public.usertable,1218107,132439,1562951680,16893,public,usertable,1,0,3201821,4604985,1299762,64861,81655,29651,1218107,132439,1446278,1299762,,,,,0,0,0,0
1650451358.9917972,public.usertable,1218509,132452,1563443200,16893,public,usertable,1,0,3202907,4605070,1300170,64871,81661,29658,1218509,132452,1446702,1300170,,,,,0,0,0,0
1650451360.0210543,public.usertable,1219112,132477,1563934720,16893,public,usertable,1,0,3204597,4605876,1300785,64884,81673,29665,1219112,132477,1447342,1300785,,,,,0,0,0,0
1650451361.0493872,public.usertable,1219492,132493,1564409856,16893,public,usertable,1,0,3205665,4606492,1301175,64891,81683,29666,1219492,132493,1447749,1301175,,,,,0,0,0,0
1650451362.0784624,public.usertable,1219853,132508,1564876800,16893,public,usertable,1,0,3206658,4607055,1301547,64899,81694,29669,1219853,132508,1448140,1301547,,,,,0,0,0,0
1650451363.1065001,public.usertable,1220277,132521,1565392896,16893,public,usertable,1,0,3207825,4608019,1301981,64906,81704,29673,1220277,132521,1448591,1301981,,,,,0,0,0,0
1650451364.1360128,public.usertable,1220679,132538,1565892608,16893,public,usertable,1,0,3208912,4608399,1302393,64913,81714,29678,1220679,132538,1449020,1302393,,,,,0,0,0,0
1650451365.165493,public.usertable,1221078,132555,1566392320,16893,public,usertable,1,0,3210053,4608924,1302800,64926,81722,29684,1221078,132555,1449448,1302800,,,,,0,0,0,0
1650451366.1939433,public.usertable,1221509,132561,1566916608,16893,public,usertable,1,0,3211121,4609239,1303239,64928,81730,29684,1221509,132561,1449897,1303239,,,,,0,0,0,0
1650451367.222176,public.usertable,1221920,132575,1567424512,16893,public,usertable,1,0,3212237,4609460,1303657,64935,81737,29689,1221920,132575,1450329,1303657,,,,,0,0,0,0
1650451368.2522852,public.usertable,1222332,132574,1567948800,16893,public,usertable,1,0,3213361,4610131,1304075,64940,81743,29691,1222332,132574,1450758,1304075,,,,,0,0,0,0
1650451369.2822852,public.usertable,1222756,132585,1568464896,16893,public,usertable,1,0,3214512,4610802,1304506,64948,81750,29695,1222756,132585,1451204,1304506,,,,,0,0,0,0
1650451370.311006,public.usertable,1223168,132596,1568972800,16893,public,usertable,1,0,3215607,4611270,1304925,64953,81757,29697,1223168,132596,1451635,1304925,,,,,0,0,0,0
1650451371.340746,public.usertable,1223568,132599,1569464320,16893,public,usertable,1,0,3216726,4612300,1305335,64956,81767,29698,1223568,132599,1452058,1305335,,,,,0,0,0,0
1650451372.3720994,public.usertable,1223976,132612,1569964032,16893,public,usertable,1,0,3217818,4612456,1305747,64965,81771,29701,1223976,132612,1452483,1305747,,,,,0,0,0,0
1650451373.4005222,public.usertable,1224393,132622,1570471936,16893,public,usertable,1,0,3218920,4613094,1306171,64970,81778,29704,1224393,132622,1452919,1306171,,,,,0,0,0,0
1650451374.4301333,public.usertable,1224785,132632,1570963456,16893,public,usertable,1,0,3219965,4613741,1306572,64978,81787,29709,1224785,132632,1453337,1306572,,,,,0,0,0,0
1650451375.4637988,public.usertable,1225208,132645,1571495936,16893,public,usertable,1,0,3221052,4614274,1307002,64984,81794,29714,1225208,132645,1453780,1307002,,,,,0,0,0,0
1650451376.4927738,public.usertable,1225626,132658,1572003840,16893,public,usertable,1,0,3222228,4614719,1307429,64993,81803,29717,1225626,132658,1454225,1307429,,,,,0,0,0,0
1650451377.5278432,public.usertable,1226025,132669,1572495360,16893,public,usertable,1,0,3223311,4615207,1307835,64997,81810,29719,1226025,132669,1454642,1307835,,,,,0,0,0,0
1650451378.5591812,public.usertable,1226669,132698,1573052416,16893,public,usertable,1,0,3225033,4615962,1308499,65012,81830,29728,1226669,132698,1455341,1308499,,,,,0,0,0,0
1650451379.587595,public.usertable,1227107,132713,1573593088,16893,public,usertable,1,0,3226280,4616746,1308948,65022,81841,29735,1227107,132713,1455811,1308948,,,,,0,0,0,0
1650451380.6195197,public.usertable,1227476,132727,1574043648,16893,public,usertable,1,0,3227431,4616836,1309324,65029,81848,29739,1227476,132727,1456201,1309324,,,,,0,0,0,0
1650451381.6501017,public.usertable,1227853,132745,1574510592,16893,public,usertable,1,0,3228479,4617260,1309711,65038,81858,29743,1227853,132745,1456607,1309711,,,,,0,0,0,0
1650451382.6781955,public.usertable,1228212,132759,1574952960,16893,public,usertable,1,0,3229482,4617480,1310080,65042,81868,29745,1228212,132759,1456990,1310080,,,,,0,0,0,0
1650451383.705759,public.usertable,1228576,132770,1575419904,16893,public,usertable,1,0,3230533,4617785,1310455,65048,81879,29749,1228576,132770,1457382,1310455,,,,,0,0,0,0
1650451384.735196,public.usertable,1228952,132780,1575878656,16893,public,usertable,1,0,3231561,4618055,1310839,65054,81887,29752,1228952,132780,1457780,1310839,,,,,0,0,0,0
1650451385.7662847,public.usertable,1229313,132782,1576329216,16893,public,usertable,1,0,3232538,4618272,1311204,65057,81891,29753,1229313,132782,1458152,1311204,,,,,0,0,0,0
1650451386.797698,public.usertable,1229680,132788,1576755200,16893,public,usertable,1,0,3233474,4618721,1311577,65061,81897,29756,1229680,132788,1458535,1311577,,,,,0,0,0,0
1650451387.8282268,public.usertable,1229980,132800,1577115648,16893,public,usertable,1,0,3234334,4619183,1311884,65066,81904,29759,1229980,132800,1458854,1311884,,,,,0,0,0,0
1650451388.8578057,public.usertable,1230299,132811,1577541632,16893,public,usertable,1,0,3235259,4619230,1312208,65072,81909,29763,1230299,132811,1459189,1312208,,,,,0,0,0,0
1650451389.8869586,public.usertable,1230640,132825,1577984000,16893,public,usertable,1,0,3236076,4620120,1312558,65080,81918,29764,1230640,132825,1459556,1312558,,,,,0,0,0,0
1650451390.9195871,public.usertable,1231044,132839,1578508288,16893,public,usertable,1,0,3237176,4620267,1312971,65085,81927,29767,1231044,132839,1459983,1312971,,,,,0,0,0,0
1650451391.94953,public.usertable,1231475,132850,1579016192,16893,public,usertable,1,0,3238343,4621074,1313409,65090,81934,29770,1231475,132850,1460433,1313409,,,,,0,0,0,0
1650451392.9781404,public.usertable,1231840,132860,1579450368,16893,public,usertable,1,0,3239367,4621631,1313783,65093,81943,29770,1231840,132860,1460819,1313783,,,,,0,0,0,0
1650451394.0063899,public.usertable,1232211,132880,1579917312,16893,public,usertable,1,0,3240352,4621784,1314162,65105,81951,29775,1232211,132880,1461218,1314162,,,,,0,0,0,0
1650451395.0343935,public.usertable,1232607,132895,1580417024,16893,public,usertable,1,0,3241442,4622337,1314567,65111,81960,29780,1232607,132895,1461638,1314567,,,,,0,0,0,0
1650451396.0654128,public.usertable,1233021,132905,1580924928,16893,public,usertable,1,0,3242532,4622569,1314990,65116,81969,29783,1233021,132905,1462075,1314990,,,,,0,0,0,0
1650451397.09478,public.usertable,1233636,132924,1581449216,16893,public,usertable,1,0,3244123,4623482,1315617,65126,81981,29788,1233636,132924,1462724,1315617,,,,,0,0,0,0
1650451398.1255414,public.usertable,1234004,132941,1581907968,16893,public,usertable,1,0,3245223,4624027,1315999,65131,81995,29789,1234004,132941,1463125,1315999,,,,,0,0,0,0
1650451399.1559827,public.usertable,1234391,132959,1582391296,16893,public,usertable,1,0,3246358,4625182,1316397,65138,82006,29794,1234391,132959,1463541,1316397,,,,,0,0,0,0
1650451400.1842403,public.usertable,1234782,132968,1582866432,16893,public,usertable,1,0,3247467,4625509,1316796,65139,82014,29795,1234782,132968,1463949,1316796,,,,,0,0,0,0
1650451401.2134254,public.usertable,1235183,132977,1583366144,16893,public,usertable,1,0,3248545,4625818,1317203,65143,82020,29798,1235183,132977,1464366,1317203,,,,,0,0,0,0
1650451402.2452476,public.usertable,1235593,132993,1583865856,16893,public,usertable,1,0,3249650,4626013,1317619,65153,82026,29805,1235593,132993,1464798,1317619,,,,,0,0,0,0
1650451403.2764661,public.usertable,1235919,132998,1584226304,16893,public,usertable,1,0,3250611,4626178,1317951,65155,82032,29807,1235919,132998,1465138,1317951,,,,,0,0,0,0
1650451404.3065245,public.usertable,1236204,133004,1584619520,16893,public,usertable,1,0,3251356,4626501,1318239,65158,82035,29807,1236204,133004,1465432,1318239,,,,,0,0,0,0
1650451405.335954,public.usertable,1236553,133010,1585020928,16893,public,usertable,1,0,3252341,4626901,1318592,65162,82039,29808,1236553,133010,1465793,1318592,,,,,0,0,0,0
1650451406.367548,public.usertable,1236839,133022,1585389568,16893,public,usertable,1,0,3253205,4627551,1318887,65167,82048,29810,1236839,133022,1466102,1318887,,,,,0,0,0,0
1650451407.3964078,public.usertable,1237181,133029,1585782784,16893,public,usertable,1,0,3254138,4627972,1319233,65170,82052,29810,1237181,133029,1466455,1319233,,,,,0,0,0,0
1650451408.4256809,public.usertable,1237520,133036,1586216960,16893,public,usertable,1,0,3255080,4628529,1319577,65176,82057,29812,1237520,133036,1466810,1319577,,,,,0,0,0,0
1650451409.459112,public.usertable,1237852,133032,1586651136,16893,public,usertable,1,0,3256038,4628969,1319915,65178,82063,29814,1237852,133032,1467156,1319915,,,,,0,0,0,0
1650451410.4910712,public.usertable,1238229,133046,1587142656,16893,public,usertable,1,0,3257121,4630041,1320298,65186,82069,29817,1238229,133046,1467553,1320298,,,,,0,0,0,0
1650451411.519379,public.usertable,1238639,133068,1587642368,16893,public,usertable,1,0,3258210,4630942,1320718,65200,82079,29824,1238639,133068,1467997,1320718,,,,,0,0,0,0
1650451412.5502105,public.usertable,1239036,133083,1588142080,16893,public,usertable,1,0,3259317,4631171,1321125,65206,82089,29827,1239036,133083,1468420,1321125,,,,,0,0,0,0
1650451413.5795717,public.usertable,1239448,133096,1588649984,16893,public,usertable,1,0,3260482,4631580,1321545,65215,82097,29831,1239448,133096,1468857,1321545,,,,,0,0,0,0
1650451414.610973,public.usertable,1239844,133110,1589149696,16893,public,usertable,1,0,3261587,4631963,1321951,65224,82107,29837,1239844,133110,1469282,1321951,,,,,0,0,0,0
1650451415.6388686,public.usertable,1240476,133128,1589673984,16893,public,usertable,1,0,3263101,4632267,1322593,65234,82117,29841,1240476,133128,1469944,1322593,,,,,0,0,0,0
1650451416.6685321,public.usertable,1240882,133144,1590181888,16893,public,usertable,1,0,3264197,4633093,1323010,65242,82128,29842,1240882,133144,1470380,1323010,,,,,0,0,0,0
1650451417.7002292,public.usertable,1241286,133152,1590681600,16893,public,usertable,1,0,3265183,4633544,1323419,65247,82133,29845,1241286,133152,1470799,1323419,,,,,0,0,0,0
1650451418.7294185,public.usertable,1241677,133172,1591173120,16893,public,usertable,1,0,3266353,4634121,1323824,65258,82147,29852,1241677,133172,1471229,1323824,,,,,0,0,0,0
1650451419.7578416,public.usertable,1242090,133185,1591672832,16893,public,usertable,1,0,3267355,4634612,1324247,65263,82157,29856,1242090,133185,1471667,1324247,,,,,0,0,0,0
1650451420.7865825,public.usertable,1242480,133196,1592164352,16893,public,usertable,1,0,3268476,4634793,1324644,65267,82164,29858,1242480,133196,1472075,1324644,,,,,0,0,0,0
1650451421.8154635,public.usertable,1242872,133206,1592639488,16893,public,usertable,1,0,3269566,4635184,1325045,65272,82173,29861,1242872,133206,1472490,1325045,,,,,0,0,0,0
1650451422.8466594,public.usertable,1243268,133216,1593131008,16893,public,usertable,1,0,3270651,4635659,1325447,65277,82179,29864,1243268,133216,1472903,1325447,,,,,0,0,0,0
1650451423.877854,public.usertable,1243639,133223,1593589760,16893,public,usertable,1,0,3271659,4635964,1325823,65282,82184,29867,1243639,133223,1473289,1325823,,,,,0,0,0,0
1650451424.908198,public.usertable,1244014,133232,1594048512,16893,public,usertable,1,0,3272579,4636042,1326204,65287,82190,29869,1244014,133232,1473681,1326204,,,,,0,0,0,0
1650451425.9377916,public.usertable,1244387,133235,1594474496,16893,public,usertable,1,0,3273592,4636609,1326581,65291,82194,29870,1244387,133235,1474066,1326581,,,,,0,0,0,0
1650451426.9727926,public.usertable,1244730,133246,1594916864,16893,public,usertable,1,0,3274521,4637156,1326932,65295,82202,29872,1244730,133246,1474429,1326932,,,,,0,0,0,0
1650451428.0017693,public.usertable,1245076,133261,1595342848,16893,public,usertable,1,0,3275528,4637526,1327290,65298,82214,29873,1245076,133261,1474802,1327290,,,,,0,0,0,0
1650451429.0331898,public.usertable,1245440,133269,1595809792,16893,public,usertable,1,0,3276473,4638077,1327661,65305,82221,29876,1245440,133269,1475187,1327661,,,,,0,0,0,0
1650451430.0639422,public.usertable,1245805,133285,1596276736,16893,public,usertable,1,0,3277419,4638350,1328034,65313,82229,29881,1245805,133285,1475576,1328034,,,,,0,0,0,0
1650451431.0932004,public.usertable,1246183,133300,1596735488,16893,public,usertable,1,0,3278414,4639361,1328424,65321,82241,29885,1246183,133300,1475986,1328424,,,,,0,0,0,0
1650451432.1219795,public.usertable,1246528,133314,1597153280,16893,public,usertable,1,0,3279352,4639829,1328778,65326,82250,29888,1246528,133314,1476354,1328778,,,,,0,0,0,0
1650451433.1518722,public.usertable,1246897,133325,1597603840,16893,public,usertable,1,0,3280306,4640247,1329153,65333,82256,29892,1246897,133325,1476742,1329153,,,,,0,0,0,0
1650451434.1822834,public.usertable,1247499,133341,1598119936,16893,public,usertable,1,0,3281865,4640826,1329762,65345,82263,29898,1247499,133341,1477370,1329762,,,,,0,0,0,0
1650451435.2146842,public.usertable,1247914,133353,1598636032,16893,public,usertable,1,0,3282983,4641173,1330186,65349,82272,29900,1247914,133353,1477807,1330186,,,,,0,0,0,0
1650451436.2457387,public.usertable,1248316,133377,1599135744,16893,public,usertable,1,0,3284114,4641494,1330598,65363,82282,29909,1248316,133377,1478243,1330598,,,,,0,0,0,0
1650451437.275043,public.usertable,1248737,133394,1599668224,16893,public,usertable,1,0,3285258,4641962,1331029,65370,82292,29913,1248737,133394,1478691,1331029,,,,,0,0,0,0
1650451438.3053432,public.usertable,1249154,133401,1600176128,16893,public,usertable,1,0,3286347,4642642,1331452,65380,82298,29917,1249154,133401,1479130,1331452,,,,,0,0,0,0
1650451439.3339763,public.usertable,1249563,133410,1600684032,16893,public,usertable,1,0,3287359,4643155,1331867,65383,82304,29918,1249563,133410,1479554,1331867,,,,,0,0,0,0
1650451440.3637874,public.usertable,1249991,133419,1601208320,16893,public,usertable,1,0,3288549,4643471,1332299,65388,82308,29919,1249991,133419,1479995,1332299,,,,,0,0,0,0
1650451441.392623,public.usertable,1250390,133434,1601708032,16893,public,usertable,1,0,3289722,4643785,1332706,65396,82316,29922,1250390,133434,1480418,1332706,,,,,0,0,0,0
1650451442.4225204,public.usertable,1250800,133450,1602215936,16893,public,usertable,1,0,3290864,4644609,1333126,65403,82326,29927,1250800,133450,1480855,1333126,,,,,0,0,0,0
1650451443.453171,public.usertable,1251201,133467,1602715648,16893,public,usertable,1,0,3291999,4644753,1333537,65410,82336,29933,1251201,133467,1481283,1333537,,,,,0,0,0,0
1650451444.4844742,public.usertable,1251622,133479,1603223552,16893,public,usertable,1,0,3293171,4645259,1333963,65417,82341,29936,1251622,133479,1481721,1333963,,,,,0,0,0,0
1650451445.5154037,public.usertable,1252015,133496,1603723264,16893,public,usertable,1,0,3294235,4645418,1334365,65425,82350,29941,1252015,133496,1482140,1334365,,,,,0,0,0,0
1650451446.543849,public.usertable,1252444,133507,1604255744,16893,public,usertable,1,0,3295406,4645982,1334800,65433,82356,29944,1252444,133507,1482589,1334800,,,,,0,0,0,0
1650451447.5725856,public.usertable,1252913,133511,1604829184,16893,public,usertable,1,0,3296693,4646215,1335274,65435,82361,29945,1252913,133511,1483070,1335274,,,,,0,0,0,0
1650451448.6023598,public.usertable,1253350,133515,1605353472,16893,public,usertable,1,0,3297896,4647403,1335720,65445,82370,29950,1253350,133515,1483535,1335720,,,,,0,0,0,0
1650451449.6305704,public.usertable,1253772,133522,1605877760,16893,public,usertable,1,0,3298987,4648077,1336150,65451,82378,29953,1253772,133522,1483979,1336150,,,,,0,0,0,0
1650451450.659343,public.usertable,1254188,133545,1606393856,16893,public,usertable,1,0,3300153,4648153,1336576,65464,82388,29958,1254188,133545,1484428,1336576,,,,,0,0,0,0
1650451451.688968,public.usertable,1254622,133562,1606942720,16893,public,usertable,1,0,3301294,4648592,1337018,65473,82396,29963,1254622,133562,1484887,1337018,,,,,0,0,0,0
1650451452.7180629,public.usertable,1255258,133584,1607458816,16893,public,usertable,1,0,3302956,4648934,1337672,65481,82414,29969,1255258,133584,1485567,1337672,,,,,0,0,0,0
1650451453.749406,public.usertable,1255660,133591,1607950336,16893,public,usertable,1,0,3304051,4649299,1338077,65486,82417,29972,1255660,133591,1485980,1338077,,,,,0,0,0,0
1650451454.779948,public.usertable,1256004,133608,1608384512,16893,public,usertable,1,0,3305116,4649780,1338430,65494,82426,29977,1256004,133608,1486350,1338430,,,,,0,0,0,0
1650451455.809025,public.usertable,1256426,133622,1608908800,16893,public,usertable,1,0,3306208,4650356,1338863,65497,82437,29978,1256426,133622,1486797,1338863,,,,,0,0,0,0
1650451456.8374703,public.usertable,1256844,133628,1609424896,16893,public,usertable,1,0,3307364,4650925,1339285,65506,82441,29982,1256844,133628,1487232,1339285,,,,,0,0,0,0
1650451457.8658571,public.usertable,1257255,133645,1609932800,16893,public,usertable,1,0,3308529,4651106,1339704,65515,82449,29986,1257255,133645,1487668,1339704,,,,,0,0,0,0
1650451458.8970602,public.usertable,1257671,133654,1610440704,16893,public,usertable,1,0,3309620,4651517,1340127,65519,82456,29988,1257671,133654,1488102,1340127,,,,,0,0,0,0
1650451459.9261324,public.usertable,1258094,133667,1610956800,16893,public,usertable,1,0,3310718,4651763,1340560,65522,82466,29989,1258094,133667,1488548,1340560,,,,,0,0,0,0
1650451460.9550388,public.usertable,1258500,133683,1611472896,16893,public,usertable,1,0,3311865,4652058,1340977,65534,82477,29996,1258500,133683,1488988,1340977,,,,,0,0,0,0
1650451461.9902792,public.usertable,1258895,133695,1611964416,16893,public,usertable,1,0,3312949,4652495,1341382,65536,82487,29996,1258895,133695,1489405,1341382,,,,,0,0,0,0
1650451463.021093,public.usertable,1259324,133706,1612496896,16893,public,usertable,1,0,3314073,4653304,1341816,65542,82492,29998,1259324,133706,1489850,1341816,,,,,0,0,0,0
1650451464.0513337,public.usertable,1259744,133716,1613012992,16893,public,usertable,1,0,3315181,4653796,1342243,65548,82499,30002,1259744,133716,1490290,1342243,,,,,0,0,0,0
1650451465.0805964,public.usertable,1260168,133732,1613537280,16893,public,usertable,1,0,3316191,4654058,1342677,65554,82509,30004,1260168,133732,1490740,1342677,,,,,0,0,0,0
1650451466.1095068,public.usertable,1260581,133740,1614036992,16893,public,usertable,1,0,3317351,4654581,1343096,65558,82515,30007,1260581,133740,1491169,1343096,,,,,0,0,0,0
1650451467.1382713,public.usertable,1260981,133753,1614438400,16893,public,usertable,1,0,3318395,4655225,1343505,65562,82524,30010,1260981,133753,1491591,1343505,,,,,0,0,0,0
1650451468.1671555,public.usertable,1261193,133758,1614659584,16893,public,usertable,1,0,3319078,4655367,1343721,65565,82528,30013,1261193,133758,1491814,1343721,,,,,0,0,0,0
1650451469.1966362,public.usertable,1261379,133764,1614938112,16893,public,usertable,1,0,3319552,4655955,1343911,65567,82532,30014,1261379,133764,1492010,1343911,,,,,0,0,0,0
1650451470.2266262,public.usertable,1261602,133768,1615200256,16893,public,usertable,1,0,3320107,4656400,1344139,65571,82537,30014,1261602,133768,1492247,1344139,,,,,0,0,0,0
1650451471.2555654,public.usertable,1261828,133766,1615478784,16893,public,usertable,1,0,3320789,4656815,1344369,65573,82541,30015,1261828,133766,1492483,1344369,,,,,0,0,0,0
1650451472.2852075,public.usertable,1262167,133777,1615757312,16893,public,usertable,1,0,3321731,4657225,1344718,65576,82551,30016,1262167,133777,1492845,1344718,,,,,0,0,0,0
1650451473.3137498,public.usertable,1262343,133784,1615986688,16893,public,usertable,1,0,3322268,4657552,1344900,65579,82557,30018,1262343,133784,1493036,1344900,,,,,0,0,0,0
1650451474.3424885,public.usertable,1262554,133788,1616240640,16893,public,usertable,1,0,3322824,4658011,1345115,65580,82561,30018,1262554,133788,1493256,1345115,,,,,0,0,0,0
1650451475.3721476,public.usertable,1262816,133796,1616568320,16893,public,usertable,1,0,3323522,4658085,1345380,65585,82564,30021,1262816,133796,1493529,1345380,,,,,0,0,0,0
1650451476.4019175,public.usertable,1263124,133808,1616936960,16893,public,usertable,1,0,3324398,4658389,1345693,65592,82569,30026,1263124,133808,1493854,1345693,,,,,0,0,0,0
1650451477.4378138,public.usertable,1263390,133815,1617272832,16893,public,usertable,1,0,3325245,4659031,1345965,65595,82575,30028,1263390,133815,1494135,1345965,,,,,0,0,0,0
1650451478.4666264,public.usertable,1263661,133818,1617608704,16893,public,usertable,1,0,3326078,4659279,1346238,65596,82577,30029,1263661,133818,1494411,1346238,,,,,0,0,0,0
1650451479.4974747,public.usertable,1263944,133835,1617960960,16893,public,usertable,1,0,3326843,4659866,1346533,65602,82589,30033,1263944,133835,1494724,1346533,,,,,0,0,0,0
1650451480.528352,public.usertable,1264222,133844,1618313216,16893,public,usertable,1,0,3327592,4660328,1346818,65607,82596,30037,1264222,133844,1495021,1346818,,,,,0,0,0,0
1650451481.5581918,public.usertable,1264547,133849,1618706432,16893,public,usertable,1,0,3328473,4660472,1347146,65609,82599,30038,1264547,133849,1495354,1347146,,,,,0,0,0,0
1650451482.5869675,public.usertable,1264880,133853,1619099648,16893,public,usertable,1,0,3329355,4660828,1347482,65612,82602,30040,1264880,133853,1495696,1347482,,,,,0,0,0,0
1650451483.6165345,public.usertable,1265183,133862,1619427328,16893,public,usertable,1,0,3330121,4661037,1347789,65617,82606,30043,1265183,133862,1496012,1347789,,,,,0,0,0,0
1650451484.6471746,public.usertable,1265401,133865,1619705856,16893,public,usertable,1,0,3330686,4661124,1348009,65618,82608,30043,1265401,133865,1496235,1348009,,,,,0,0,0,0
1650451485.6752067,public.usertable,1265685,133874,1620115456,16893,public,usertable,1,0,3331533,4661506,1348298,65622,82613,30044,1265685,133874,1496533,1348298,,,,,0,0,0,0
1650451486.7054448,public.usertable,1266014,133886,1620508672,16893,public,usertable,1,0,3332403,4661943,1348633,65628,82619,30048,1266014,133886,1496880,1348633,,,,,0,0,0,0
1650451487.736274,public.usertable,1266387,133894,1621008384,16893,public,usertable,1,0,3333538,4662895,1349014,65633,82627,30052,1266387,133894,1497274,1349014,,,,,0,0,0,0
1650451488.7642834,public.usertable,1266796,133910,1621516288,16893,public,usertable,1,0,3334689,4663236,1349431,65641,82635,30059,1266796,133910,1497707,1349431,,,,,0,0,0,0
1650451489.7932978,public.usertable,1267217,133925,1622016000,16893,public,usertable,1,0,3335836,4663528,1349859,65653,82642,30065,1267217,133925,1498154,1349859,,,,,0,0,0,0
1650451490.8217554,public.usertable,1267601,133942,1622507520,16893,public,usertable,1,0,3336978,4664471,1350254,65661,82653,30069,1267601,133942,1498568,1350254,,,,,0,0,0,0
1650451491.852955,public.usertable,1268204,133959,1622999040,16893,public,usertable,1,0,3338493,4665209,1350871,65668,82667,30071,1268204,133959,1499206,1350871,,,,,0,0,0,0
1650451492.8840773,public.usertable,1268610,133964,1623506944,16893,public,usertable,1,0,3339534,4665921,1351284,65672,82674,30072,1268610,133964,1499630,1351284,,,,,0,0,0,0
1650451493.9160688,public.usertable,1269017,133970,1624006656,16893,public,usertable,1,0,3340589,4666478,1351697,65677,82680,30076,1269017,133970,1500054,1351697,,,,,0,0,0,0
1650451494.946637,public.usertable,1269422,133984,1624506368,16893,public,usertable,1,0,3341728,4666982,1352109,65684,82687,30079,1269422,133984,1500480,1352109,,,,,0,0,0,0
1650451495.9753156,public.usertable,1269817,134000,1625006080,16893,public,usertable,1,0,3342903,4667376,1352513,65693,82696,30083,1269817,134000,1500902,1352513,,,,,0,0,0,0
1650451497.004377,public.usertable,1270223,134012,1625497600,16893,public,usertable,1,0,3344103,4668132,1352927,65702,82704,30085,1270223,134012,1501333,1352927,,,,,0,0,0,0
1650451498.0339189,public.usertable,1270637,134026,1626013696,16893,public,usertable,1,0,3345119,4668384,1353347,65710,82710,30090,1270637,134026,1501767,1353347,,,,,0,0,0,0
1650451499.066344,public.usertable,1271048,134036,1626521600,16893,public,usertable,1,0,3346166,4669327,1353766,65714,82718,30093,1271048,134036,1502198,1353766,,,,,0,0,0,0
1650451500.0967155,public.usertable,1271457,134051,1627029504,16893,public,usertable,1,0,3347336,4669696,1354183,65721,82726,30096,1271457,134051,1502630,1354183,,,,,0,0,0,0
1650451501.1271772,public.usertable,1271870,134065,1627537408,16893,public,usertable,1,0,3348431,4670597,1354608,65727,82738,30098,1271870,134065,1503073,1354608,,,,,0,0,0,0
1650451502.1571975,public.usertable,1272268,134075,1628020736,16893,public,usertable,1,0,3349548,4671776,1355013,65731,82745,30101,1272268,134075,1503489,1355013,,,,,0,0,0,0
1650451503.1852882,public.usertable,1272656,134085,1628512256,16893,public,usertable,1,0,3350669,4672404,1355413,65732,82757,30102,1272656,134085,1503902,1355413,,,,,0,0,0,0
1650451504.2142763,public.usertable,1273067,134097,1629028352,16893,public,usertable,1,0,3351850,4672801,1355835,65736,82768,30103,1273067,134097,1504339,1355835,,,,,0,0,0,0
1650451505.2429578,public.usertable,1273487,134109,1629528064,16893,public,usertable,1,0,3353000,4672977,1356265,65738,82778,30104,1273487,134109,1504781,1356265,,,,,0,0,0,0
1650451506.2737532,public.usertable,1273894,134118,1630052352,16893,public,usertable,1,0,3354179,4673513,1356677,65745,82783,30109,1273894,134118,1505205,1356677,,,,,0,0,0,0
1650451507.30278,public.usertable,1274319,134130,1630576640,16893,public,usertable,1,0,3355345,4673897,1357110,65749,82791,30112,1274319,134130,1505650,1357110,,,,,0,0,0,0
1650451508.3350668,public.usertable,1274735,134150,1631084544,16893,public,usertable,1,0,3356673,4674558,1357541,65754,82806,30115,1274735,134150,1506101,1357541,,,,,0,0,0,0
1650451509.3651965,public.usertable,1275146,134170,1631600640,16893,public,usertable,1,0,3357758,4675060,1357961,65765,82815,30120,1275146,134170,1506541,1357961,,,,,0,0,0,0
1650451510.3942327,public.usertable,1275766,134192,1632108544,16893,public,usertable,1,0,3359473,4675717,1358592,65776,82826,30125,1275766,134192,1507194,1358592,,,,,0,0,0,0
1650451511.4239771,public.usertable,1276184,134213,1632624640,16893,public,usertable,1,0,3360646,4675799,1359024,65783,82840,30129,1276184,134213,1507647,1359024,,,,,0,0,0,0
1650451512.452883,public.usertable,1276616,134220,1633148928,16893,public,usertable,1,0,3361934,4676172,1359467,65784,82851,30130,1276616,134220,1508102,1359467,,,,,0,0,0,0
1650451513.4817939,public.usertable,1276982,134235,1633599488,16893,public,usertable,1,0,3363023,4676643,1359840,65792,82858,30134,1276982,134235,1508490,1359840,,,,,0,0,0,0
1650451514.511727,public.usertable,1277346,134240,1634058240,16893,public,usertable,1,0,3363912,4677108,1360205,65800,82859,30137,1277346,134240,1508864,1360205,,,,,0,0,0,0
1650451515.5402126,public.usertable,1277634,134245,1634410496,16893,public,usertable,1,0,3364622,4677502,1360496,65802,82862,30138,1277634,134245,1509160,1360496,,,,,0,0,0,0
1650451516.568862,public.usertable,1277968,134257,1634820096,16893,public,usertable,1,0,3365594,4677772,1360839,65805,82871,30140,1277968,134257,1509515,1360839,,,,,0,0,0,0
1650451517.5990083,public.usertable,1278353,134269,1635311616,16893,public,usertable,1,0,3366594,4678101,1361230,65811,82877,30142,1278353,134269,1509918,1361230,,,,,0,0,0,0
1650451518.63045,public.usertable,1278741,134277,1635770368,16893,public,usertable,1,0,3367678,4678211,1361620,65817,82879,30145,1278741,134277,1510316,1361620,,,,,0,0,0,0
1650451519.66197,public.usertable,1279081,134282,1636196352,16893,public,usertable,1,0,3368645,4678541,1361968,65820,82887,30147,1279081,134282,1510675,1361968,,,,,0,0,0,0
1650451520.6925218,public.usertable,1279441,134291,1636630528,16893,public,usertable,1,0,3369658,4678838,1362335,65822,82894,30148,1279441,134291,1511051,1362335,,,,,0,0,0,0
1650451521.7211287,public.usertable,1279784,134297,1637048320,16893,public,usertable,1,0,3370519,4679124,1362684,65826,82900,30152,1279784,134297,1511410,1362684,,,,,0,0,0,0
1650451522.751069,public.usertable,1280119,134312,1637457920,16893,public,usertable,1,0,3371528,4679599,1363029,65834,82910,30158,1280119,134312,1511773,1363029,,,,,0,0,0,0
1650451523.782529,public.usertable,1280439,134323,1637867520,16893,public,usertable,1,0,3372401,4680017,1363357,65837,82918,30159,1280439,134323,1512112,1363357,,,,,0,0,0,0
1650451524.8141239,public.usertable,1280792,134334,1638277120,16893,public,usertable,1,0,3373433,4680267,1363714,65844,82922,30162,1280792,134334,1512480,1363714,,,,,0,0,0,0
1650451525.842269,public.usertable,1281147,134346,1638768640,16893,public,usertable,1,0,3374380,4680486,1364075,65852,82928,30164,1281147,134346,1512855,1364075,,,,,0,0,0,0
1650451526.8712227,public.usertable,1281571,134353,1639325696,16893,public,usertable,1,0,3375584,4681160,1364509,65858,82938,30166,1281571,134353,1513305,1364509,,,,,0,0,0,0
1650451527.901213,public.usertable,1282025,134362,1639858176,16893,public,usertable,1,0,3376792,4681270,1364968,65862,82943,30169,1282025,134362,1513773,1364968,,,,,0,0,0,0
1650451528.9330657,public.usertable,1282625,134376,1640341504,16893,public,usertable,1,0,3378531,4682037,1365577,65871,82952,30172,1282625,134376,1514400,1365577,,,,,0,0,0,0
1650451529.9618888,public.usertable,1283030,134391,1640841216,16893,public,usertable,1,0,3379525,4682823,1365994,65874,82964,30174,1283030,134391,1514832,1365994,,,,,0,0,0,0
1650451530.9912367,public.usertable,1283436,134401,1641340928,16893,public,usertable,1,0,3380582,4683263,1366407,65878,82971,30177,1283436,134401,1515256,1366407,,,,,0,0,0,0
1650451532.0214555,public.usertable,1283816,134414,1641816064,16893,public,usertable,1,0,3381691,4683610,1366797,65881,82981,30180,1283816,134414,1515659,1366797,,,,,0,0,0,0
1650451533.053661,public.usertable,1284225,134432,1642315776,16893,public,usertable,1,0,3382857,4683858,1367218,65887,82993,30181,1284225,134432,1516098,1367218,,,,,0,0,0,0
1650451534.084134,public.usertable,1284605,134444,1642790912,16893,public,usertable,1,0,3384045,4684571,1367607,65891,83002,30185,1284605,134444,1516500,1367607,,,,,0,0,0,0
1650451535.1126113,public.usertable,1285014,134452,1643282432,16893,public,usertable,1,0,3385205,4684940,1368021,65894,83007,30186,1285014,134452,1516922,1368021,,,,,0,0,0,0
1650451536.1408832,public.usertable,1285410,134463,1643773952,16893,public,usertable,1,0,3386196,4685507,1368423,65899,83013,30189,1285410,134463,1517335,1368423,,,,,0,0,0,0
1650451537.170017,public.usertable,1285814,134476,1644265472,16893,public,usertable,1,0,3387415,4685765,1368836,65903,83022,30191,1285814,134476,1517761,1368836,,,,,0,0,0,0
1650451538.1994364,public.usertable,1286174,134490,1644716032,16893,public,usertable,1,0,3388418,4685844,1369205,65908,83031,30195,1286174,134490,1518144,1369205,,,,,0,0,0,0
1650451539.2289016,public.usertable,1286535,134500,1645158400,16893,public,usertable,1,0,3389378,4686141,1369572,65912,83037,30196,1286535,134500,1518521,1369572,,,,,0,0,0,0
1650451540.2587671,public.usertable,1286911,134502,1645617152,16893,public,usertable,1,0,3390369,4686558,1369950,65918,83039,30198,1286911,134502,1518907,1369950,,,,,0,0,0,0
1650451541.28839,public.usertable,1287299,134518,1646100480,16893,public,usertable,1,0,3391480,4687088,1370349,65924,83050,30200,1287299,134518,1519323,1370349,,,,,0,0,0,0
1650451542.3172708,public.usertable,1287692,134527,1646608384,16893,public,usertable,1,0,3392556,4687310,1370750,65928,83058,30204,1287692,134527,1519736,1370750,,,,,0,0,0,0
1650451543.3466566,public.usertable,1288113,134535,1647116288,16893,public,usertable,1,0,3393618,4688327,1371176,65936,83063,30209,1288113,134535,1520175,1371176,,,,,0,0,0,0
1650451544.3762085,public.usertable,1288524,134551,1647616000,16893,public,usertable,1,0,3394799,4688491,1371598,65941,83074,30213,1288524,134551,1520613,1371598,,,,,0,0,0,0
1650451545.4046872,public.usertable,1288927,134556,1648115712,16893,public,usertable,1,0,3395838,4688957,1372007,65945,83080,30214,1288927,134556,1521032,1372007,,,,,0,0,0,0
1650451546.4335,public.usertable,1289283,134568,1648451584,16893,public,usertable,1,0,3396665,4689058,1372370,65950,83087,30218,1289283,134568,1521407,1372370,,,,,0,0,0,0
1650451547.4627624,public.usertable,1289522,134575,1648803840,16893,public,usertable,1,0,3397359,4689458,1372611,65955,83089,30219,1289522,134575,1521655,1372611,,,,,0,0,0,0
1650451548.4943843,public.usertable,1290054,134592,1649262592,16893,public,usertable,1,0,3398815,4689795,1373152,65963,83098,30222,1290054,134592,1522213,1373152,,,,,0,0,0,0
1650451549.5245028,public.usertable,1290406,134601,1649688576,16893,public,usertable,1,0,3399803,4690172,1373510,65967,83104,30224,1290406,134601,1522581,1373510,,,,,0,0,0,0
1650451550.5551498,public.usertable,1290741,134608,1650114560,16893,public,usertable,1,0,3400803,4690502,1373851,65968,83110,30225,1290741,134608,1522929,1373851,,,,,0,0,0,0
1650451551.5858793,public.usertable,1291108,134617,1650556928,16893,public,usertable,1,0,3401630,4690699,1374220,65975,83112,30228,1291108,134617,1523307,1374220,,,,,0,0,0,0
1650451552.6177306,public.usertable,1291454,134630,1650974720,16893,public,usertable,1,0,3402555,4690971,1374572,65982,83118,30233,1291454,134630,1523672,1374572,,,,,0,0,0,0
1650451553.6451771,public.usertable,1291777,134637,1651376128,16893,public,usertable,1,0,3403422,4691314,1374900,65984,83123,30234,1291777,134637,1524007,1374900,,,,,0,0,0,0
1650451554.6745355,public.usertable,1292197,134646,1651908608,16893,public,usertable,1,0,3404616,4691563,1375328,65988,83131,30235,1292197,134646,1524447,1375328,,,,,0,0,0,0
1650451555.7031715,public.usertable,1292611,134661,1652416512,16893,public,usertable,1,0,3405735,4691932,1375750,65995,83139,30238,1292611,134661,1524884,1375750,,,,,0,0,0,0
1650451556.7325864,public.usertable,1293031,134673,1652940800,16893,public,usertable,1,0,3406851,4692242,1376178,66001,83147,30239,1293031,134673,1525326,1376178,,,,,0,0,0,0
1650451557.7621856,public.usertable,1293432,134681,1653432320,16893,public,usertable,1,0,3407955,4692765,1376583,66005,83151,30240,1293432,134681,1525739,1376583,,,,,0,0,0,0
1650451558.790956,public.usertable,1293820,134698,1653907456,16893,public,usertable,1,0,3408995,4692879,1376980,66013,83160,30241,1293820,134698,1526153,1376980,,,,,0,0,0,0
1650451559.821034,public.usertable,1294218,134711,1654415360,16893,public,usertable,1,0,3410142,4693121,1377386,66019,83168,30245,1294218,134711,1526573,1377386,,,,,0,0,0,0
1650451560.8502674,public.usertable,1294644,134720,1654915072,16893,public,usertable,1,0,3411281,4693442,1377820,66022,83176,30247,1294644,134720,1527018,1377820,,,,,0,0,0,0
1650451561.8823166,public.usertable,1295068,134730,1655431168,16893,public,usertable,1,0,3412359,4693497,1378249,66027,83181,30252,1295068,134730,1527457,1378249,,,,,0,0,0,0
1650451562.9109862,public.usertable,1295442,134748,1655898112,16893,public,usertable,1,0,3413371,4693931,1378631,66037,83189,30256,1295442,134748,1527857,1378631,,,,,0,0,0,0
1650451563.9399154,public.usertable,1295838,134765,1656406016,16893,public,usertable,1,0,3414483,4694334,1379037,66046,83199,30262,1295838,134765,1528282,1379037,,,,,0,0,0,0
1650451564.969031,public.usertable,1296258,134776,1656922112,16893,public,usertable,1,0,3415594,4694773,1379465,66053,83207,30266,1296258,134776,1528725,1379465,,,,,0,0,0,0
1650451566.0009317,public.usertable,1296633,134790,1657389056,16893,public,usertable,1,0,3416652,4694856,1379846,66064,83213,30275,1296633,134790,1529123,1379846,,,,,0,0,0,0
1650451567.0293417,public.usertable,1297275,134804,1657921536,16893,public,usertable,1,0,3418380,4695686,1380498,66068,83223,30276,1297275,134804,1529789,1380498,,,,,0,0,0,0
1650451568.0587888,public.usertable,1297701,134811,1658445824,16893,public,usertable,1,0,3419495,4696143,1380931,66073,83230,30279,1297701,134811,1530234,1380931,,,,,0,0,0,0
1650451569.0897405,public.usertable,1298095,134818,1658937344,16893,public,usertable,1,0,3420580,4696805,1381334,66079,83239,30283,1298095,134818,1530652,1381334,,,,,0,0,0,0
1650451570.1167848,public.usertable,1298516,134830,1659445248,16893,public,usertable,1,0,3421678,4697336,1381762,66084,83246,30286,1298516,134830,1531092,1381762,,,,,0,0,0,0
1650451571.1466274,public.usertable,1298929,134842,1659961344,16893,public,usertable,1,0,3422820,4698097,1382187,66087,83258,30286,1298929,134842,1531532,1382187,,,,,0,0,0,0
1650451572.1778462,public.usertable,1299347,134853,1660477440,16893,public,usertable,1,0,3423938,4698482,1382609,66094,83262,30290,1299347,134853,1531965,1382609,,,,,0,0,0,0
1650451573.208795,public.usertable,1299754,134866,1660968960,16893,public,usertable,1,0,3425098,4698922,1383022,66101,83268,30293,1299754,134866,1532391,1383022,,,,,0,0,0,0
1650451574.2378085,public.usertable,1300159,134878,1661476864,16893,public,usertable,1,0,3426297,4699202,1383435,66107,83276,30298,1300159,134878,1532818,1383435,,,,,0,0,0,0
1650451575.269487,public.usertable,1300602,134887,1662025728,16893,public,usertable,1,0,3427446,4699343,1383885,66112,83283,30300,1300602,134887,1533280,1383885,,,,,0,0,0,0
1650451576.2980452,public.usertable,1301025,134890,1662550016,16893,public,usertable,1,0,3428608,4699682,1384312,66116,83287,30300,1301025,134890,1533715,1384312,,,,,0,0,0,0
1650451577.3332138,public.usertable,1301424,134903,1663033344,16893,public,usertable,1,0,3429693,4699903,1384720,66120,83296,30303,1301424,134903,1534136,1384720,,,,,0,0,0,0
1650451578.3630147,public.usertable,1301840,134924,1663541248,16893,public,usertable,1,0,3430966,4700399,1385147,66130,83307,30307,1301840,134924,1534584,1385147,,,,,0,0,0,0
1650451579.3921254,public.usertable,1302239,134934,1664040960,16893,public,usertable,1,0,3432131,4700893,1385556,66133,83317,30308,1302239,134934,1535006,1385556,,,,,0,0,0,0
1650451580.4215703,public.usertable,1302645,134943,1664532480,16893,public,usertable,1,0,3433242,4701522,1385965,66139,83320,30311,1302645,134943,1535424,1385965,,,,,0,0,0,0
1650451581.4512086,public.usertable,1303058,134960,1665040384,16893,public,usertable,1,0,3434249,4702121,1386386,66150,83328,30317,1303058,134960,1535864,1386386,,,,,0,0,0,0
1650451582.480661,public.usertable,1303463,134968,1665540096,16893,public,usertable,1,0,3435344,4702895,1386797,66154,83334,30319,1303463,134968,1536285,1386797,,,,,0,0,0,0
1650451583.5105517,public.usertable,1303853,134984,1666023424,16893,public,usertable,1,0,3436447,4703302,1387196,66161,83343,30321,1303853,134984,1536700,1387196,,,,,0,0,0,0
1650451584.540682,public.usertable,1304252,134992,1666539520,16893,public,usertable,1,0,3437639,4703501,1387600,66165,83348,30322,1304252,134992,1537113,1387600,,,,,0,0,0,0
1650451585.5706878,public.usertable,1304902,135004,1667063808,16893,public,usertable,1,0,3439338,4703893,1388259,66172,83357,30324,1304902,135004,1537788,1388259,,,,,0,0,0,0
1650451586.5994709,public.usertable,1305335,135019,1667612672,16893,public,usertable,1,0,3440395,4704224,1388699,66180,83364,30327,1305335,135019,1538243,1388699,,,,,0,0,0,0
1650451587.629194,public.usertable,1305805,135028,1668177920,16893,public,usertable,1,0,3441714,4704913,1389175,66185,83370,30328,1305805,135028,1538730,1389175,,,,,0,0,0,0
1650451588.660625,public.usertable,1306208,135042,1668685824,16893,public,usertable,1,0,3442768,4705227,1389586,66191,83378,30330,1306208,135042,1539155,1389586,,,,,0,0,0,0
1650451589.6897562,public.usertable,1306606,135055,1669177344,16893,public,usertable,1,0,3443788,4705710,1389991,66199,83385,30333,1306606,135055,1539575,1389991,,,,,0,0,0,0
1650451590.7192514,public.usertable,1307010,135062,1669668864,16893,public,usertable,1,0,3444956,4705938,1390398,66203,83388,30336,1307010,135062,1539989,1390398,,,,,0,0,0,0
1650451591.747604,public.usertable,1307423,135067,1670168576,16893,public,usertable,1,0,3446031,4706326,1390814,66209,83391,30340,1307423,135067,1540414,1390814,,,,,0,0,0,0
1650451592.7759602,public.usertable,1307821,135076,1670660096,16893,public,usertable,1,0,3447241,4706646,1391216,66214,83395,30342,1307821,135076,1540825,1391216,,,,,0,0,0,0
1650451593.8065157,public.usertable,1308218,135090,1671143424,16893,public,usertable,1,0,3448408,4706845,1391625,66217,83407,30344,1308218,135090,1541249,1391625,,,,,0,0,0,0
1650451594.8356311,public.usertable,1308614,135103,1671651328,16893,public,usertable,1,0,3449622,4707772,1392033,66223,83419,30349,1308614,135103,1541675,1392033,,,,,0,0,0,0
1650451595.8644779,public.usertable,1309020,135112,1672151040,16893,public,usertable,1,0,3450803,4708148,1392444,66227,83424,30351,1309020,135112,1542095,1392444,,,,,0,0,0,0
1650451596.8953488,public.usertable,1309410,135127,1672617984,16893,public,usertable,1,0,3451826,4708749,1392842,66234,83432,30353,1309410,135127,1542508,1392842,,,,,0,0,0,0
1650451597.925581,public.usertable,1309785,135145,1673084928,16893,public,usertable,1,0,3452860,4709590,1393230,66242,83445,30357,1309785,135145,1542917,1393230,,,,,0,0,0,0
1650451598.9560773,public.usertable,1310164,135164,1673551872,16893,public,usertable,1,0,3453894,4709791,1393620,66250,83456,30361,1310164,135164,1543326,1393620,,,,,0,0,0,0
1650451599.9869025,public.usertable,1310570,135173,1674067968,16893,public,usertable,1,0,3455007,4710082,1394034,66254,83464,30362,1310570,135173,1543752,1394034,,,,,0,0,0,0
1650451601.0170002,public.usertable,1310958,135186,1674543104,16893,public,usertable,1,0,3456157,4710294,1394431,66260,83473,30364,1310958,135186,1544164,1394431,,,,,0,0,0,0
1650451602.045731,public.usertable,1311445,135192,1674919936,16893,public,usertable,1,0,3457496,4710705,1394926,66265,83481,30367,1311445,135192,1544672,1394926,,,,,0,0,0,0
1650451603.0771194,public.usertable,1311445,135192,1674919936,16893,public,usertable,1,0,3457496,4710705,1394926,66265,83481,30367,1311445,135192,1544672,1394926,,,,,0,0,0,0
1650451604.1116397,public.usertable,1311445,135192,1674919936,16893,public,usertable,1,0,3457496,4710705,1394926,66265,83481,30367,1311445,135192,1544672,1394926,,,,,0,0,0,0
1650451605.141285,public.usertable,1311445,135192,1674919936,16893,public,usertable,1,0,3457496,4710705,1394926,66265,83481,30367,1311445,135192,1544672,1394926,,,,,0,0,0,0
1650451606.1716106,public.usertable,1311445,135192,1674919936,16893,public,usertable,1,0,3457496,4710705,1394926,66265,83481,30367,1311445,135192,1544672,1394926,,,,,0,0,0,0
1650451607.1998029,public.usertable,1311445,135192,1674919936,16893,public,usertable,1,0,3457496,4710705,1394926,66265,83481,30367,1311445,135192,1544672,1394926,,,,,0,0,0,0
1650451608.2304888,public.usertable,1311445,135192,1674919936,16893,public,usertable,1,0,3457496,4710705,1394926,66265,83481,30367,1311445,135192,1544672,1394926,,,,,0,0,0,0
1650451609.2578015,public.usertable,1311445,135192,1674919936,16893,public,usertable,1,0,3457496,4710705,1394926,66265,83481,30367,1311445,135192,1544672,1394926,,,,,0,0,0,0
1650451610.288456,public.usertable,1311445,135192,1674919936,16893,public,usertable,1,0,3457496,4710705,1394926,66265,83481,30367,1311445,135192,1544672,1394926,,,,,0,0,0,0
1650451611.320931,public.usertable,1311445,135192,1674919936,16893,public,usertable,1,0,3457496,4710705,1394926,66265,83481,30367,1311445,135192,1544672,1394926,,,,,0,0,0,0
1650451612.350952,public.usertable,1311445,135192,1674919936,16893,public,usertable,1,0,3457496,4710705,1394926,66265,83481,30367,1311445,135192,1544672,1394926,,,,,0,0,0,0
1650451613.3797324,public.usertable,1311445,135192,1674919936,16893,public,usertable,1,0,3457496,4710705,1394926,66265,83481,30367,1311445,135192,1544672,1394926,,,,,0,0,0,0
1650451614.4098096,public.usertable,1311445,135192,1674919936,16893,public,usertable,1,0,3457496,4710705,1394926,66265,83481,30367,1311445,135192,1544672,1394926,,,,,0,0,0,0
1650451615.4392798,public.usertable,1311445,135192,1674919936,16893,public,usertable,1,0,3457496,4710705,1394926,66265,83481,30367,1311445,135192,1544672,1394926,,,,,0,0,0,0
1650451616.4693608,public.usertable,1311445,135192,1674919936,16893,public,usertable,1,0,3457496,4710705,1394926,66265,83481,30367,1311445,135192,1544672,1394926,,,,,0,0,0,0
1650451617.5018523,public.usertable,1311445,135192,1674919936,16893,public,usertable,1,0,3457496,4710705,1394926,66265,83481,30367,1311445,135192,1544672,1394926,,,,,0,0,0,0
1650451618.53408,public.usertable,1311445,135192,1674919936,16893,public,usertable,1,0,3457496,4710705,1394926,66265,83481,30367,1311445,135192,1544672,1394926,,,,,0,0,0,0
1650451619.568072,public.usertable,1311445,135192,1674919936,16893,public,usertable,1,0,3457496,4710705,1394926,66265,83481,30367,1311445,135192,1544672,1394926,,,,,0,0,0,0
1650451620.5969868,public.usertable,1311445,135192,1674919936,16893,public,usertable,1,0,3457496,4710705,1394926,66265,83481,30367,1311445,135192,1544672,1394926,,,,,0,0,0,0
1650451621.6250882,public.usertable,1311445,135192,1674919936,16893,public,usertable,1,0,3457496,4710705,1394926,66265,83481,30367,1311445,135192,1544672,1394926,,,,,0,0,0,0
1650451622.6538153,public.usertable,1311445,135192,1674919936,16893,public,usertable,1,0,3457496,4710705,1394926,66265,83481,30367,1311445,135192,1544672,1394926,,,,,0,0,0,0
1650451623.6853535,public.usertable,1311445,135192,1674919936,16893,public,usertable,1,0,3457496,4710705,1394926,66265,83481,30367,1311445,135192,1544672,1394926,,,,,0,0,0,0
1650451624.7152958,public.usertable,1311445,135192,1674919936,16893,public,usertable,1,0,3457496,4710705,1394926,66265,83481,30367,1311445,135192,1544672,1394926,,,,,0,0,0,0
1650451625.7494287,public.usertable,1311445,135192,1674919936,16893,public,usertable,1,0,3457496,4710705,1394926,66265,83481,30367,1311445,135192,1544672,1394926,,,,,0,0,0,0
