ds,table_name,pg_stat_get_live_tuples,pg_stat_get_dead_tuples,pg_table_size,relid,schemaname,relname,seq_scan,seq_tup_read,idx_scan,idx_tup_fetch,n_tup_ins,n_tup_upd,n_tup_del,n_tup_hot_upd,n_live_tup,n_dead_tup,n_mod_since_analyze,n_ins_since_vacuum,last_vacuum,last_autovacuum,last_analyze,last_autoanalyze,vacuum_count,autovacuum_count,analyze_count,autoanalyze_count
1650434052.4049313,public.usertable,50000,0,58556416,16560,public,usertable,1,0,0,0,50000,0,0,0,50000,0,50000,50000,,,,,0,0,0,0
1650434053.4217548,public.usertable,50000,0,58638336,16560,public,usertable,1,0,1,1,50000,0,0,0,50000,0,50000,50000,,,,,0,0,0,0
1650434054.4503024,public.usertable,50062,210,58974208,16560,public,usertable,1,0,494,5122,50178,96,116,9,50062,210,50390,50178,,,,,0,0,0,0
1650434055.4800375,public.usertable,50135,409,59252736,16560,public,usertable,1,0,1034,14340,50359,189,224,28,50135,409,50772,50359,,,,,0,0,0,0
1650434056.5119386,public.usertable,50178,602,59555840,16560,public,usertable,1,0,1588,21846,50535,250,357,38,50178,602,51142,50535,,,,,0,0,0,0
1650434057.54133,public.usertable,50281,771,59850752,16560,public,usertable,1,0,2096,30522,50745,314,464,52,50281,771,51523,50745,,,,,0,0,0,0
1650434058.5725543,public.usertable,50387,941,60178432,16560,public,usertable,1,0,2647,37124,50951,386,564,72,50387,941,51901,50951,,,,,0,0,0,0
1650434059.6022775,public.usertable,50486,1119,60497920,16560,public,usertable,1,0,3262,45475,51154,468,668,90,50486,1119,52290,51154,,,,,0,0,0,0
1650434060.6320775,public.usertable,50573,1294,60801024,16560,public,usertable,1,0,3877,58248,51341,549,768,106,50573,1294,52658,51341,,,,,0,0,0,0
1650434061.6634705,public.usertable,50686,1445,61087744,16560,public,usertable,1,0,4429,65897,51535,626,849,118,50686,1445,53010,51535,,,,,0,0,0,0
1650434062.6917949,public.usertable,50855,1640,61366272,16560,public,usertable,1,0,5240,72962,51812,721,957,144,50855,1640,53490,51812,,,,,0,0,0,0
1650434063.7203684,public.usertable,51002,1761,61677568,16560,public,usertable,1,0,5793,79942,52028,776,1026,153,51002,1761,53830,52028,,,,,0,0,0,0
1650434064.7487357,public.usertable,51133,1902,61997056,16560,public,usertable,1,0,6335,85711,52244,833,1111,163,51133,1902,54188,52244,,,,,0,0,0,0
1650434065.7792084,public.usertable,51243,2072,62324736,16560,public,usertable,1,0,6908,91881,52450,911,1207,183,51243,2072,54568,52450,,,,,0,0,0,0
1650434066.8077369,public.usertable,51395,2226,62668800,16560,public,usertable,1,0,7587,99542,52681,990,1286,198,51395,2226,54957,52681,,,,,0,0,0,0
1650434067.8372395,public.usertable,51536,2386,63012864,16560,public,usertable,1,0,8222,104382,52904,1076,1368,221,51536,2386,55348,52904,,,,,0,0,0,0
1650434068.8666086,public.usertable,51691,2527,63373312,16560,public,usertable,1,0,8861,110311,53141,1143,1450,235,51691,2527,55734,53141,,,,,0,0,0,0
1650434069.8955183,public.usertable,51848,2666,63709184,16560,public,usertable,1,0,9512,116396,53383,1205,1535,252,51848,2666,56123,53383,,,,,0,0,0,0
1650434070.9257112,public.usertable,52004,2800,64036864,16560,public,usertable,1,0,10126,122065,53616,1268,1612,266,52004,2800,56496,53616,,,,,0,0,0,0
1650434071.9540837,public.usertable,52171,2927,64380928,16560,public,usertable,1,0,10729,130022,53848,1330,1677,279,52171,2927,56855,53848,,,,,0,0,0,0
1650434072.983951,public.usertable,52359,3069,64765952,16560,public,usertable,1,0,11380,134291,54116,1394,1757,298,52359,3069,57267,54116,,,,,0,0,0,0
1650434074.0148962,public.usertable,52519,3211,65093632,16560,public,usertable,1,0,12018,141978,54356,1460,1837,321,52519,3211,57653,54356,,,,,0,0,0,0
1650434075.0437908,public.usertable,52678,3350,65437696,16560,public,usertable,1,0,12640,146934,54610,1506,1932,335,52678,3350,58048,54610,,,,,0,0,0,0
1650434076.0733485,public.usertable,52836,3485,65789952,16560,public,usertable,1,0,13283,152143,54851,1560,2015,347,52836,3485,58426,54851,,,,,0,0,0,0
1650434077.104887,public.usertable,52990,3633,66101248,16560,public,usertable,1,0,13965,161701,55088,1630,2098,371,52990,3633,58816,55088,,,,,0,0,0,0
1650434078.135807,public.usertable,53126,3775,66437120,16560,public,usertable,1,0,14603,165975,55297,1703,2171,395,53126,3775,59171,55297,,,,,0,0,0,0
1650434079.163988,public.usertable,53266,3914,66740224,16560,public,usertable,1,0,15231,173333,55525,1764,2259,410,53266,3914,59548,55525,,,,,0,0,0,0
1650434080.1976995,public.usertable,53394,4044,67059712,16560,public,usertable,1,0,15773,178103,55722,1831,2328,433,53394,4044,59881,55722,,,,,0,0,0,0
1650434081.2266138,public.usertable,53668,4262,67461120,16560,public,usertable,1,0,16893,185343,56123,1935,2455,466,53668,4262,60513,56123,,,,,0,0,0,0
1650434082.2563515,public.usertable,53838,4390,67813376,16560,public,usertable,1,0,17515,193126,56371,1987,2533,478,53838,4390,60891,56371,,,,,0,0,0,0
1650434083.2898862,public.usertable,53961,4483,68034560,16560,public,usertable,1,0,17912,196824,56549,2026,2588,491,53961,4483,61163,56549,,,,,0,0,0,0
1650434084.3196895,public.usertable,54136,4612,68378624,16560,public,usertable,1,0,18630,202453,56798,2084,2662,509,54136,4612,61544,56798,,,,,0,0,0,0
1650434085.3488822,public.usertable,54312,4742,68730880,16560,public,usertable,1,0,19291,208025,57039,2153,2727,531,54312,4742,61919,57039,,,,,0,0,0,0
1650434086.3795927,public.usertable,54517,4869,69099520,16560,public,usertable,1,0,20026,211879,57317,2215,2800,549,54517,4869,62332,57317,,,,,0,0,0,0
1650434087.40894,public.usertable,54674,4981,69427200,16560,public,usertable,1,0,20628,215556,57549,2258,2875,561,54674,4981,62682,57549,,,,,0,0,0,0
1650434088.4371219,public.usertable,54830,5117,69754880,16560,public,usertable,1,0,21323,220625,57777,2326,2947,584,54830,5117,63050,57777,,,,,0,0,0,0
1650434089.466861,public.usertable,54986,5241,70066176,16560,public,usertable,1,0,21949,226917,58008,2377,3022,596,54986,5241,63407,58008,,,,,0,0,0,0
1650434090.4977634,public.usertable,55169,5334,70385664,16560,public,usertable,1,0,22523,232176,58244,2423,3075,613,55169,5334,63742,58244,,,,,0,0,0,0
1650434091.5276914,public.usertable,55315,5446,70688768,16560,public,usertable,1,0,23083,235838,58457,2474,3142,627,55315,5446,64073,58457,,,,,0,0,0,0
1650434092.5575619,public.usertable,55505,5544,71041024,16560,public,usertable,1,0,23689,242365,58714,2516,3209,638,55505,5544,64439,58714,,,,,0,0,0,0
1650434093.5870454,public.usertable,55662,5648,71335936,16560,public,usertable,1,0,24265,249974,58934,2563,3272,649,55662,5648,64769,58934,,,,,0,0,0,0
1650434094.6169362,public.usertable,55808,5747,71614464,16560,public,usertable,1,0,24793,252997,59134,2608,3326,660,55808,5747,65068,59134,,,,,0,0,0,0
1650434095.6477792,public.usertable,55941,5817,71852032,16560,public,usertable,1,0,25217,256977,59302,2648,3361,670,55941,5817,65311,59302,,,,,0,0,0,0
1650434096.6777518,public.usertable,56076,5927,72155136,16560,public,usertable,1,0,25818,259736,59502,2695,3426,684,56076,5927,65623,59502,,,,,0,0,0,0
1650434097.7062075,public.usertable,56268,6028,72482816,16560,public,usertable,1,0,26416,264822,59744,2747,3476,696,56268,6028,65967,59744,,,,,0,0,0,0
1650434098.7346778,public.usertable,56405,6131,72728576,16560,public,usertable,1,0,26886,268538,59947,2785,3542,709,56405,6131,66274,59947,,,,,0,0,0,0
1650434099.7651494,public.usertable,56538,6224,73056256,16560,public,usertable,1,0,27407,272094,60146,2817,3608,718,56538,6224,66571,60146,,,,,0,0,0,0
1650434100.7938306,public.usertable,56705,6337,73383936,16560,public,usertable,1,0,28041,276710,60389,2867,3684,734,56705,6337,66940,60389,,,,,0,0,0,0
1650434101.822979,public.usertable,56919,6441,73736192,16560,public,usertable,1,0,28710,280708,60663,2920,3744,748,56919,6441,67327,60663,,,,,0,0,0,0
1650434102.8538342,public.usertable,57100,6574,74121216,16560,public,usertable,1,0,29447,283127,60927,2972,3827,763,57100,6574,67726,60927,,,,,0,0,0,0
1650434103.8857412,public.usertable,57358,6724,74399744,16560,public,usertable,1,0,30420,289920,61269,3045,3911,787,57358,6724,68225,61269,,,,,0,0,0,0
1650434104.915199,public.usertable,57510,6810,74678272,16560,public,usertable,1,0,30907,292887,61471,3084,3961,796,57510,6810,68516,61471,,,,,0,0,0,0
1650434105.9469776,public.usertable,57623,6886,74899456,16560,public,usertable,1,0,31358,293672,61634,3110,4011,803,57623,6886,68755,61634,,,,,0,0,0,0
1650434106.977247,public.usertable,57764,6980,75177984,16560,public,usertable,1,0,31866,296634,61840,3144,4076,815,57764,6980,69060,61840,,,,,0,0,0,0
1650434108.0061212,public.usertable,57942,7061,75472896,16560,public,usertable,1,0,32431,299957,62070,3180,4128,822,57942,7061,69378,62070,,,,,0,0,0,0
1650434109.0346024,public.usertable,58088,7150,75751424,16560,public,usertable,1,0,32951,303368,62266,3222,4178,835,58088,7150,69666,62266,,,,,0,0,0,0
1650434110.063651,public.usertable,58191,7251,75988992,16560,public,usertable,1,0,33453,305234,62432,3262,4241,845,58191,7251,69935,62432,,,,,0,0,0,0
1650434111.0934155,public.usertable,58314,7313,76193792,16560,public,usertable,1,0,33877,307601,62590,3292,4276,852,58314,7313,70158,62590,,,,,0,0,0,0
1650434112.1259303,public.usertable,58452,7378,76439552,16560,public,usertable,1,0,34319,308749,62767,3322,4315,862,58452,7378,70404,62767,,,,,0,0,0,0
1650434113.1547425,public.usertable,58607,7460,76718080,16560,public,usertable,1,0,34872,311212,62965,3366,4358,881,58607,7460,70689,62965,,,,,0,0,0,0
1650434114.1845133,public.usertable,58760,7564,77045760,16560,public,usertable,1,0,35471,316260,63183,3413,4423,892,58760,7564,71019,63183,,,,,0,0,0,0
1650434115.2138104,public.usertable,58964,7662,77381632,16560,public,usertable,1,0,36111,320318,63438,3462,4474,907,58964,7662,71374,63438,,,,,0,0,0,0
1650434116.2422752,public.usertable,59163,7768,77725696,16560,public,usertable,1,0,36809,323769,63696,3513,4533,925,59163,7768,71742,63696,,,,,0,0,0,0
1650434117.2751732,public.usertable,59350,7871,78086144,16560,public,usertable,1,0,37489,326613,63941,3560,4591,934,59350,7871,72092,63941,,,,,0,0,0,0
1650434118.3107417,public.usertable,59553,7967,78413824,16560,public,usertable,1,0,38140,332028,64201,3605,4648,949,59553,7967,72454,64201,,,,,0,0,0,0
1650434119.3399494,public.usertable,59715,8060,78684160,16560,public,usertable,1,0,38709,336051,64418,3645,4703,965,59715,8060,72766,64418,,,,,0,0,0,0
1650434120.3700607,public.usertable,59878,8139,78946304,16560,public,usertable,1,0,39270,337909,64624,3681,4746,984,59878,8139,73051,64624,,,,,0,0,0,0
1650434121.3993003,public.usertable,60002,8203,79126528,16560,public,usertable,1,0,39667,339837,64786,3709,4784,990,60002,8203,73279,64786,,,,,0,0,0,0
1650434122.4284663,public.usertable,60124,8272,79364096,16560,public,usertable,1,0,40098,341681,64947,3740,4823,1003,60124,8272,73510,64947,,,,,0,0,0,0
1650434123.4595125,public.usertable,60269,8341,79626240,16560,public,usertable,1,0,40572,343631,65130,3774,4861,1014,60269,8341,73765,65130,,,,,0,0,0,0
1650434124.4921181,public.usertable,60425,8416,79896576,16560,public,usertable,1,0,41105,347284,65326,3814,4901,1026,60425,8416,74041,65326,,,,,0,0,0,0
1650434125.521435,public.usertable,60566,8488,80117760,16560,public,usertable,1,0,41591,349944,65507,3857,4941,1040,60566,8488,74305,65507,,,,,0,0,0,0
1650434126.5509984,public.usertable,60779,8573,80355328,16560,public,usertable,1,0,42383,353937,65774,3899,4995,1057,60779,8573,74668,65774,,,,,0,0,0,0
1650434127.5829177,public.usertable,60910,8662,80609280,16560,public,usertable,1,0,42879,357858,65959,3935,5049,1074,60910,8662,74943,65959,,,,,0,0,0,0
1650434128.6145935,public.usertable,61079,8740,80887808,16560,public,usertable,1,0,43484,361076,66170,3978,5091,1092,61079,8740,75239,66170,,,,,0,0,0,0
1650434129.6439214,public.usertable,61184,8842,81133568,16560,public,usertable,1,0,44018,363355,66335,4020,5151,1107,61184,8842,75506,66335,,,,,0,0,0,0
1650434130.674858,public.usertable,61326,8917,81387520,16560,public,usertable,1,0,44487,364849,66523,4052,5197,1114,61326,8917,75772,66523,,,,,0,0,0,0
1650434131.7042015,public.usertable,61495,8998,81682432,16560,public,usertable,1,0,45090,367309,66732,4104,5237,1130,61495,8998,76073,66732,,,,,0,0,0,0
1650434132.735398,public.usertable,61686,9088,82001920,16560,public,usertable,1,0,45754,370670,66982,4139,5296,1142,61686,9088,76417,66982,,,,,0,0,0,0
1650434133.767878,public.usertable,61850,9193,82329600,16560,public,usertable,1,0,46350,372975,67216,4180,5366,1163,61850,9193,76762,67216,,,,,0,0,0,0
1650434134.7975872,public.usertable,62039,9299,82624512,16560,public,usertable,1,0,47057,376799,67465,4230,5426,1182,62039,9299,77121,67465,,,,,0,0,0,0
1650434135.826348,public.usertable,62190,9396,82935808,16560,public,usertable,1,0,47674,379112,67677,4275,5487,1194,62190,9396,77439,67677,,,,,0,0,0,0
1650434136.8550494,public.usertable,62365,9497,83255296,16560,public,usertable,1,0,48305,381056,67904,4327,5539,1211,62365,9497,77770,67904,,,,,0,0,0,0
1650434137.88624,public.usertable,62543,9577,83558400,16560,public,usertable,1,0,48894,383698,68133,4359,5590,1225,62543,9577,78082,68133,,,,,0,0,0,0
1650434138.915791,public.usertable,62703,9678,83869696,16560,public,usertable,1,0,49608,390336,68353,4410,5650,1238,62703,9678,78413,68353,,,,,0,0,0,0
1650434139.945894,public.usertable,62908,9770,84230144,16560,public,usertable,1,0,50267,393941,68609,4454,5701,1254,62908,9770,78764,68609,,,,,0,0,0,0
1650434140.9754426,public.usertable,63131,9858,84582400,16560,public,usertable,1,0,51008,397303,68882,4499,5751,1272,63131,9858,79132,68882,,,,,0,0,0,0
1650434142.0057557,public.usertable,63344,9962,84918272,16560,public,usertable,1,0,51685,399777,69146,4554,5802,1289,63344,9962,79502,69146,,,,,0,0,0,0
1650434143.0376213,public.usertable,63524,10041,85229568,16560,public,usertable,1,0,52289,403959,69374,4594,5850,1304,63524,10041,79818,69374,,,,,0,0,0,0
1650434144.065914,public.usertable,63708,10127,85549056,16560,public,usertable,1,0,52942,411496,69619,4629,5911,1316,63708,10127,80159,69619,,,,,0,0,0,0
1650434145.0937774,public.usertable,63868,10218,85835776,16560,public,usertable,1,0,53448,413597,69839,4661,5971,1326,63868,10218,80471,69839,,,,,0,0,0,0
1650434146.123132,public.usertable,64161,10353,86179840,16560,public,usertable,1,0,54375,419172,70212,4722,6051,1347,64161,10353,80985,70212,,,,,0,0,0,0
1650434147.151859,public.usertable,64374,10453,86540288,16560,public,usertable,1,0,55021,422420,70486,4768,6112,1360,64374,10453,81366,70486,,,,,0,0,0,0
1650434148.1809003,public.usertable,64610,10537,86917120,16560,public,usertable,1,0,55628,424585,70771,4807,6161,1375,64610,10537,81739,70771,,,,,0,0,0,0
1650434149.2112849,public.usertable,64796,10640,87252992,16560,public,usertable,1,0,56303,431165,71021,4856,6225,1396,64796,10640,82102,71021,,,,,0,0,0,0
1650434150.2398748,public.usertable,64988,10732,87588864,16560,public,usertable,1,0,56993,433317,71269,4900,6281,1412,64988,10732,82450,71269,,,,,0,0,0,0
1650434151.269623,public.usertable,65205,10831,87949312,16560,public,usertable,1,0,57705,435571,71541,4951,6336,1425,65205,10831,82828,71541,,,,,0,0,0,0
1650434152.2978415,public.usertable,65439,10922,88317952,16560,public,usertable,1,0,58414,437969,71823,4998,6384,1444,65439,10922,83205,71823,,,,,0,0,0,0
1650434153.3291721,public.usertable,65658,10995,88645632,16560,public,usertable,1,0,59037,440832,72081,5040,6423,1466,65658,10995,83544,72081,,,,,0,0,0,0
1650434154.358085,public.usertable,65887,11098,89047040,16560,public,usertable,1,0,59776,445630,72359,5095,6472,1487,65887,11098,83926,72359,,,,,0,0,0,0
1650434155.387487,public.usertable,66094,11192,89391104,16560,public,usertable,1,0,60500,447888,72617,5144,6523,1505,66094,11192,84284,72617,,,,,0,0,0,0
1650434156.4195879,public.usertable,66310,11281,89751552,16560,public,usertable,1,0,61270,451869,72894,5185,6584,1512,66310,11281,84663,72894,,,,,0,0,0,0
1650434157.452863,public.usertable,66495,11378,90087424,16560,public,usertable,1,0,61920,454036,73140,5225,6645,1524,66495,11378,85010,73140,,,,,0,0,0,0
1650434158.4837735,public.usertable,66716,11476,90456064,16560,public,usertable,1,0,62636,457150,73426,5267,6710,1537,66716,11476,85403,73426,,,,,0,0,0,0
1650434159.513771,public.usertable,66936,11570,90816512,16560,public,usertable,1,0,63287,459906,73703,5305,6767,1555,66936,11570,85775,73703,,,,,0,0,0,0
1650434160.5443835,public.usertable,67146,11666,91185152,16560,public,usertable,1,0,64115,462518,73972,5346,6826,1573,67146,11666,86144,73972,,,,,0,0,0,0
1650434161.5729833,public.usertable,67391,11756,91553792,16560,public,usertable,1,0,64915,466877,74264,5396,6873,1596,67391,11756,86533,74264,,,,,0,0,0,0
1650434162.6032321,public.usertable,67592,11831,91881472,16560,public,usertable,1,0,65535,468818,74515,5430,6923,1611,67592,11831,86868,74515,,,,,0,0,0,0
1650434163.6325145,public.usertable,67797,11928,92200960,16560,public,usertable,1,0,66233,472075,74777,5474,6980,1623,67797,11928,87231,74777,,,,,0,0,0,0
1650434164.6614091,public.usertable,67986,12022,92528640,16560,public,usertable,1,0,66962,474597,75022,5521,7036,1642,67986,12022,87579,75022,,,,,0,0,0,0
1650434165.6907303,public.usertable,68179,12122,92897280,16560,public,usertable,1,0,67761,480828,75271,5572,7092,1667,68179,12122,87935,75271,,,,,0,0,0,0
1650434166.719875,public.usertable,68505,12281,93274112,16560,public,usertable,1,0,68850,488300,75694,5640,7189,1688,68505,12281,88523,75694,,,,,0,0,0,0
1650434167.750255,public.usertable,68748,12373,93667328,16560,public,usertable,1,0,69673,491064,75996,5682,7248,1706,68748,12373,88926,75996,,,,,0,0,0,0
1650434168.7791862,public.usertable,68993,12455,94052352,16560,public,usertable,1,0,70430,495766,76296,5716,7303,1716,68993,12455,89315,76296,,,,,0,0,0,0
1650434169.8107626,public.usertable,69216,12559,94420992,16560,public,usertable,1,0,71143,498349,76575,5766,7359,1732,69216,12559,89700,76575,,,,,0,0,0,0
1650434170.8449206,public.usertable,69438,12654,94797824,16560,public,usertable,1,0,71876,501127,76854,5809,7416,1747,69438,12654,90079,76854,,,,,0,0,0,0
1650434171.8773572,public.usertable,69658,12744,95141888,16560,public,usertable,1,0,72674,505333,77123,5853,7465,1767,69658,12744,90441,77123,,,,,0,0,0,0
1650434172.907197,public.usertable,69876,12822,95502336,16560,public,usertable,1,0,73304,508946,77383,5898,7507,1782,69876,12822,90788,77383,,,,,0,0,0,0
1650434173.9367406,public.usertable,70101,12905,95838208,16560,public,usertable,1,0,73981,512924,77647,5944,7546,1798,70101,12905,91137,77647,,,,,0,0,0,0
1650434174.9676511,public.usertable,70321,12983,96174080,16560,public,usertable,1,0,74642,515777,77907,5986,7586,1810,70321,12983,91479,77907,,,,,0,0,0,0
1650434175.9987783,public.usertable,70486,13079,96493568,16560,public,usertable,1,0,75288,518173,78134,6023,7648,1825,70486,13079,91805,78134,,,,,0,0,0,0
1650434177.0272071,public.usertable,70710,13161,96854016,16560,public,usertable,1,0,75951,522682,78404,6068,7694,1836,70710,13161,92166,78404,,,,,0,0,0,0
1650434178.057965,public.usertable,70933,13253,97214464,16560,public,usertable,1,0,76724,524894,78681,6111,7748,1854,70933,13253,92540,78681,,,,,0,0,0,0
1650434179.0864549,public.usertable,71135,13344,97566720,16560,public,usertable,1,0,77493,526574,78945,6141,7810,1864,71135,13344,92896,78945,,,,,0,0,0,0
1650434180.116004,public.usertable,71317,13436,97869824,16560,public,usertable,1,0,78099,527948,79181,6182,7864,1878,71317,13436,93227,79181,,,,,0,0,0,0
1650434181.1483934,public.usertable,71508,13503,98115584,16560,public,usertable,1,0,78774,529770,79397,6225,7889,1895,71508,13503,93511,79397,,,,,0,0,0,0
1650434182.1777349,public.usertable,71670,13570,98418688,16560,public,usertable,1,0,79359,531852,79600,6252,7930,1901,71670,13570,93782,79600,,,,,0,0,0,0
1650434183.2134666,public.usertable,71832,13649,98705408,16560,public,usertable,1,0,79952,534313,79809,6288,7977,1918,71832,13649,94074,79809,,,,,0,0,0,0
1650434184.2430391,public.usertable,71992,13718,98967552,16560,public,usertable,1,0,80525,535704,80007,6322,8015,1931,71992,13718,94344,80007,,,,,0,0,0,0
1650434185.2729015,public.usertable,72293,13845,99311616,16560,public,usertable,1,0,81496,538894,80384,6376,8091,1951,72293,13845,94851,80384,,,,,0,0,0,0
1650434186.3052568,public.usertable,72540,13933,99704832,16560,public,usertable,1,0,82191,541172,80687,6414,8147,1970,72540,13933,95248,80687,,,,,0,0,0,0
1650434187.3338451,public.usertable,72759,14023,100057088,16560,public,usertable,1,0,82908,544411,80958,6459,8199,1985,72759,14023,95616,80958,,,,,0,0,0,0
1650434188.3623524,public.usertable,72949,14115,100401152,16560,public,usertable,1,0,83734,548192,81207,6498,8258,2001,72949,14115,95963,81207,,,,,0,0,0,0
1650434189.3920639,public.usertable,73158,14209,100753408,16560,public,usertable,1,0,84437,550583,81471,6542,8313,2015,73158,14209,96326,81471,,,,,0,0,0,0
1650434190.4219935,public.usertable,73363,14293,101089280,16560,public,usertable,1,0,85097,554572,81726,6584,8363,2026,73363,14293,96673,81726,,,,,0,0,0,0
1650434191.4512374,public.usertable,73566,14373,101408768,16560,public,usertable,1,0,85720,555679,81972,6622,8406,2044,73566,14373,97000,81972,,,,,0,0,0,0
1650434192.4813726,public.usertable,73783,14462,101769216,16560,public,usertable,1,0,86429,559560,82243,6663,8460,2064,73783,14462,97366,82243,,,,,0,0,0,0
1650434193.5119424,public.usertable,74025,14558,102162432,16560,public,usertable,1,0,87182,560950,82544,6703,8519,2081,74025,14558,97766,82544,,,,,0,0,0,0
1650434194.5441518,public.usertable,74276,14641,102547456,16560,public,usertable,1,0,87963,563281,82842,6743,8566,2097,74276,14641,98151,82842,,,,,0,0,0,0
1650434195.5737884,public.usertable,74505,14735,102932480,16560,public,usertable,1,0,88656,565590,83116,6796,8611,2115,74505,14735,98523,83116,,,,,0,0,0,0
1650434196.6034048,public.usertable,74741,14828,103268352,16560,public,usertable,1,0,89494,567983,83406,6838,8665,2135,74741,14828,98909,83406,,,,,0,0,0,0
1650434197.6322722,public.usertable,74940,14906,103620608,16560,public,usertable,1,0,90177,570819,83656,6871,8716,2148,74940,14906,99243,83656,,,,,0,0,0,0
1650434198.6620414,public.usertable,75192,14980,103989248,16560,public,usertable,1,0,90926,574848,83958,6910,8766,2169,75192,14980,99634,83958,,,,,0,0,0,0
1650434199.691036,public.usertable,75391,15053,104325120,16560,public,usertable,1,0,91598,579023,84209,6939,8818,2177,75391,15053,99966,84209,,,,,0,0,0,0
1650434200.7208357,public.usertable,75601,15151,104660992,16560,public,usertable,1,0,92407,580780,84476,6983,8875,2195,75601,15151,100334,84476,,,,,0,0,0,0
1650434201.7503624,public.usertable,75825,15231,105029632,16560,public,usertable,1,0,93146,582871,84743,7021,8918,2200,75825,15231,100682,84743,,,,,0,0,0,0
1650434202.7785292,public.usertable,76052,15326,105414656,16560,public,usertable,1,0,93993,584846,85028,7065,8976,2224,76052,15326,101069,85028,,,,,0,0,0,0
1650434203.8152456,public.usertable,76265,15424,105734144,16560,public,usertable,1,0,94741,586609,85284,7122,9019,2251,76265,15424,101425,85284,,,,,0,0,0,0
1650434204.8504078,public.usertable,76557,15550,106045440,16560,public,usertable,1,0,95769,587838,85649,7181,9092,2278,76557,15550,101922,85649,,,,,0,0,0,0
1650434205.8788168,public.usertable,76769,15631,106389504,16560,public,usertable,1,0,96498,590485,85909,7222,9140,2291,76769,15631,102271,85909,,,,,0,0,0,0
1650434206.9089742,public.usertable,76991,15695,106733568,16560,public,usertable,1,0,97224,594070,86176,7253,9185,2302,76991,15695,102614,86176,,,,,0,0,0,0
1650434207.9367251,public.usertable,77203,15777,107077632,16560,public,usertable,1,0,97889,596773,86443,7289,9240,2319,77203,15777,102972,86443,,,,,0,0,0,0
1650434208.9683247,public.usertable,77399,15861,107388928,16560,public,usertable,1,0,98560,600983,86688,7328,9289,2336,77399,15861,103305,86688,,,,,0,0,0,0
1650434209.998927,public.usertable,77604,15929,107724800,16560,public,usertable,1,0,99163,604626,86929,7365,9325,2351,77604,15929,103619,86929,,,,,0,0,0,0
1650434211.0271678,public.usertable,77823,16010,108044288,16560,public,usertable,1,0,99814,607435,87190,7404,9367,2373,77823,16010,103961,87190,,,,,0,0,0,0
1650434212.0562174,public.usertable,78024,16083,108371968,16560,public,usertable,1,0,100508,610024,87433,7439,9409,2386,78024,16083,104281,87433,,,,,0,0,0,0
1650434213.0846584,public.usertable,78215,16149,108675072,16560,public,usertable,1,0,101127,612287,87666,7468,9451,2402,78215,16149,104585,87666,,,,,0,0,0,0
1650434214.1156747,public.usertable,78442,16222,109027328,16560,public,usertable,1,0,101847,613354,87937,7500,9495,2412,78442,16222,104932,87937,,,,,0,0,0,0
1650434215.145413,public.usertable,78630,16298,109322240,16560,public,usertable,1,0,102505,615793,88166,7537,9536,2428,78630,16298,105239,88166,,,,,0,0,0,0
1650434216.1743917,public.usertable,78868,16360,109674496,16560,public,usertable,1,0,103134,618056,88443,7567,9575,2438,78868,16360,105585,88443,,,,,0,0,0,0
1650434217.2050989,public.usertable,79062,16443,109985792,16560,public,usertable,1,0,103810,621370,88681,7607,9619,2450,79062,16443,105907,88681,,,,,0,0,0,0
1650434218.2380538,public.usertable,79269,16510,110329856,16560,public,usertable,1,0,104542,624209,88939,7636,9670,2463,79269,16510,106245,88939,,,,,0,0,0,0
1650434219.2665687,public.usertable,79464,16586,110624768,16560,public,usertable,1,0,105150,627227,89177,7670,9713,2475,79464,16586,106560,89177,,,,,0,0,0,0
1650434220.2960792,public.usertable,79624,16652,110862336,16560,public,usertable,1,0,105730,630391,89374,7701,9750,2487,79624,16652,106825,89374,,,,,0,0,0,0
1650434221.3256512,public.usertable,79822,16709,111165440,16560,public,usertable,1,0,106291,631581,89603,7727,9781,2495,79822,16709,107111,89603,,,,,0,0,0,0
1650434222.3541272,public.usertable,80008,16770,111443968,16560,public,usertable,1,0,106876,633640,89824,7759,9816,2507,80008,16770,107399,89824,,,,,0,0,0,0
1650434223.381725,public.usertable,80190,16832,111738880,16560,public,usertable,1,0,107483,636508,90049,7782,9859,2514,80190,16832,107690,90049,,,,,0,0,0,0
1650434224.409725,public.usertable,80464,16929,112033792,16560,public,usertable,1,0,108363,640160,90388,7823,9924,2534,80464,16929,108135,90388,,,,,0,0,0,0
1650434225.4380102,public.usertable,80660,16989,112336896,16560,public,usertable,1,0,108941,642424,90616,7854,9956,2545,80660,16989,108426,90616,,,,,0,0,0,0
1650434226.4705946,public.usertable,80868,17051,112664576,16560,public,usertable,1,0,109678,645477,90867,7890,9999,2556,80868,17051,108756,90867,,,,,0,0,0,0
1650434227.4999888,public.usertable,81082,17105,112975872,16560,public,usertable,1,0,110345,648361,91109,7921,10027,2571,81082,17105,109057,91109,,,,,0,0,0,0
1650434228.5299554,public.usertable,81283,17176,113278976,16560,public,usertable,1,0,110966,649404,91360,7944,10077,2582,81283,17176,109381,91360,,,,,0,0,0,0
1650434229.5592988,public.usertable,81516,17257,113655808,16560,public,usertable,1,0,111720,651596,91648,7972,10132,2592,81516,17257,109752,91648,,,,,0,0,0,0
1650434230.5902593,public.usertable,81728,17338,114008064,16560,public,usertable,1,0,112492,654853,91918,7999,10190,2603,81728,17338,110107,91918,,,,,0,0,0,0
1650434231.622717,public.usertable,81963,17421,114368512,16560,public,usertable,1,0,113226,657838,92194,8051,10231,2629,81963,17421,110476,92194,,,,,0,0,0,0
1650434232.6538615,public.usertable,82198,17501,114753536,16560,public,usertable,1,0,114006,659964,92485,8083,10287,2640,82198,17501,110855,92485,,,,,0,0,0,0
1650434233.6836853,public.usertable,82449,17572,115105792,16560,public,usertable,1,0,114668,662448,92785,8108,10336,2655,82449,17572,111229,92785,,,,,0,0,0,0
1650434234.7131405,public.usertable,82659,17663,115474432,16560,public,usertable,1,0,115465,664387,93051,8143,10392,2670,82659,17663,111586,93051,,,,,0,0,0,0
1650434235.7430909,public.usertable,82887,17746,115818496,16560,public,usertable,1,0,116251,667075,93325,8185,10438,2691,82887,17746,111948,93325,,,,,0,0,0,0
1650434236.7715771,public.usertable,83119,17812,116170752,16560,public,usertable,1,0,116986,670646,93597,8215,10478,2701,83119,17812,112290,93597,,,,,0,0,0,0
1650434237.8003747,public.usertable,83369,17888,116580352,16560,public,usertable,1,0,117786,672375,93897,8250,10528,2708,83369,17888,112675,93897,,,,,0,0,0,0
1650434238.8306704,public.usertable,83587,17950,116867072,16560,public,usertable,1,0,118403,674432,94152,8279,10565,2723,83587,17950,112996,94152,,,,,0,0,0,0
1650434239.8614278,public.usertable,83813,18031,117219328,16560,public,usertable,1,0,119125,675806,94429,8310,10616,2736,83813,18031,113355,94429,,,,,0,0,0,0
1650434240.8917966,public.usertable,83990,18113,117530624,16560,public,usertable,1,0,119787,679505,94658,8344,10668,2744,83990,18113,113670,94658,,,,,0,0,0,0
1650434241.9216905,public.usertable,84195,18175,117825536,16560,public,usertable,1,0,120389,682340,94899,8378,10704,2760,84195,18175,113981,94899,,,,,0,0,0,0
1650434242.9532444,public.usertable,84409,18230,118153216,16560,public,usertable,1,0,121011,685371,95142,8409,10733,2773,84409,18230,114284,95142,,,,,0,0,0,0
1650434243.9821043,public.usertable,84635,18290,118513664,16560,public,usertable,1,0,121661,687174,95395,8447,10760,2787,84635,18290,114602,95395,,,,,0,0,0,0
1650434245.0106385,public.usertable,84956,18378,118800384,16560,public,usertable,1,0,122672,690401,95765,8499,10809,2813,84956,18378,115073,95765,,,,,0,0,0,0
1650434246.0416996,public.usertable,85196,18434,119152640,16560,public,usertable,1,0,123385,694867,96042,8531,10846,2830,85196,18434,115419,96042,,,,,0,0,0,0
1650434247.0723128,public.usertable,85395,18503,119480320,16560,public,usertable,1,0,124096,699135,96286,8566,10891,2845,85395,18503,115743,96286,,,,,0,0,0,0
1650434248.1022189,public.usertable,85634,18570,119824384,16560,public,usertable,1,0,124789,701793,96564,8597,10930,2858,85634,18570,116091,96564,,,,,0,0,0,0
1650434249.133797,public.usertable,85835,18642,120143872,16560,public,usertable,1,0,125422,703671,96807,8637,10972,2874,85835,18642,116416,96807,,,,,0,0,0,0
1650434250.1641333,public.usertable,86035,18733,120496128,16560,public,usertable,1,0,126099,706294,97058,8681,11023,2893,86035,18733,116762,97058,,,,,0,0,0,0
1650434251.1927931,public.usertable,86289,18823,120889344,16560,public,usertable,1,0,126922,708013,97360,8728,11071,2923,86289,18823,117159,97360,,,,,0,0,0,0
1650434252.222051,public.usertable,86557,18911,121290752,16560,public,usertable,1,0,127801,711105,97680,8770,11123,2938,86557,18911,117573,97680,,,,,0,0,0,0
1650434253.2519767,public.usertable,86822,18988,121692160,16560,public,usertable,1,0,128592,713304,97998,8803,11176,2956,86822,18988,117977,97998,,,,,0,0,0,0
1650434254.2815764,public.usertable,87109,19045,122109952,16560,public,usertable,1,0,129355,717264,98320,8835,11211,2964,87109,19045,118366,98320,,,,,0,0,0,0
1650434255.3113267,public.usertable,87375,19127,122519552,16560,public,usertable,1,0,130186,719444,98633,8878,11258,2988,87375,19127,118769,98633,,,,,0,0,0,0
1650434256.3413181,public.usertable,87635,19197,122871808,16560,public,usertable,1,0,130970,724824,98943,8907,11308,2997,87635,19197,119158,98943,,,,,0,0,0,0
1650434257.3701463,public.usertable,87865,19287,123265024,16560,public,usertable,1,0,131692,727700,99231,8944,11366,3013,87865,19287,119541,99231,,,,,0,0,0,0
1650434258.399901,public.usertable,88136,19355,123633664,16560,public,usertable,1,0,132431,729610,99540,8978,11404,3027,88136,19355,119922,99540,,,,,0,0,0,0
1650434259.4291165,public.usertable,88348,19430,123994112,16560,public,usertable,1,0,133177,732641,99801,9015,11453,3038,88348,19430,120269,99801,,,,,0,0,0,0
1650434260.458019,public.usertable,88584,19493,124329984,16560,public,usertable,1,0,133820,734270,100071,9045,11487,3049,88584,19493,120603,100071,,,,,0,0,0,0
1650434261.486344,public.usertable,88801,19564,124706816,16560,public,usertable,1,0,134521,737546,100339,9077,11538,3064,88801,19564,120954,100339,,,,,0,0,0,0
1650434262.5150793,public.usertable,89068,19626,125067264,16560,public,usertable,1,0,135310,741255,100643,9113,11575,3087,89068,19626,121331,100643,,,,,0,0,0,0
1650434263.5480597,public.usertable,89429,19728,125427712,16560,public,usertable,1,0,136324,745113,101068,9157,11639,3105,89429,19728,121864,101068,,,,,0,0,0,0
1650434264.57947,public.usertable,89642,19785,125739008,16560,public,usertable,1,0,136971,746106,101309,9186,11667,3117,89642,19785,122162,101309,,,,,0,0,0,0
1650434265.609489,public.usertable,89832,19835,126017536,16560,public,usertable,1,0,137628,747418,101530,9211,11698,3128,89832,19835,122439,101530,,,,,0,0,0,0
1650434266.6431475,public.usertable,90023,19886,126296064,16560,public,usertable,1,0,138226,750620,101747,9241,11724,3144,90023,19886,122712,101747,,,,,0,0,0,0
1650434267.6726682,public.usertable,90208,19942,126558208,16560,public,usertable,1,0,138815,751974,101969,9263,11761,3154,90208,19942,122993,101969,,,,,0,0,0,0
1650434268.7018802,public.usertable,90411,19998,126894080,16560,public,usertable,1,0,139440,753185,102202,9291,11791,3164,90411,19998,123284,102202,,,,,0,0,0,0
1650434269.7324243,public.usertable,90648,20067,127213568,16560,public,usertable,1,0,140126,756524,102474,9327,11826,3183,90648,20067,123627,102474,,,,,0,0,0,0
1650434270.7618382,public.usertable,90834,20134,127516672,16560,public,usertable,1,0,140682,758875,102698,9359,11864,3199,90834,20134,123921,102698,,,,,0,0,0,0
1650434271.7905867,public.usertable,91054,20191,127827968,16560,public,usertable,1,0,141275,760898,102950,9389,11896,3215,91054,20191,124235,102950,,,,,0,0,0,0
1650434272.8211732,public.usertable,91259,20244,128147456,16560,public,usertable,1,0,141865,762097,103182,9421,11923,3228,91259,20244,124526,103182,,,,,0,0,0,0
1650434273.8517122,public.usertable,91510,20312,128516096,16560,public,usertable,1,0,142589,763787,103467,9457,11957,3240,91510,20312,124881,103467,,,,,0,0,0,0
1650434274.8811946,public.usertable,91745,20381,128876544,16560,public,usertable,1,0,143352,767510,103749,9491,12004,3256,91745,20381,125244,103749,,,,,0,0,0,0
1650434275.9106426,public.usertable,91984,20469,129261568,16560,public,usertable,1,0,144225,769327,104034,9535,12050,3270,91984,20469,125619,104034,,,,,0,0,0,0
1650434276.9392772,public.usertable,92215,20535,129622016,16560,public,usertable,1,0,145028,771327,104306,9564,12091,3282,92215,20535,125961,104306,,,,,0,0,0,0
1650434277.9690552,public.usertable,92468,20606,129990656,16560,public,usertable,1,0,145784,773414,104609,9590,12141,3294,92468,20606,126340,104609,,,,,0,0,0,0
1650434278.9999146,public.usertable,92698,20688,130359296,16560,public,usertable,1,0,146545,775470,104884,9631,12186,3307,92698,20688,126701,104884,,,,,0,0,0,0
1650434280.0338025,public.usertable,92936,20773,130719744,16560,public,usertable,1,0,147321,777351,105176,9665,12240,3323,92936,20773,127081,105176,,,,,0,0,0,0
1650434281.0639598,public.usertable,93153,20828,131063808,16560,public,usertable,1,0,147988,778749,105436,9688,12283,3335,93153,20828,127407,105436,,,,,0,0,0,0
1650434282.0947204,public.usertable,93385,20896,131383296,16560,public,usertable,1,0,148718,780481,105708,9718,12323,3350,93385,20896,127749,105708,,,,,0,0,0,0
1650434283.1237938,public.usertable,93702,21021,131719168,16560,public,usertable,1,0,149845,783166,106089,9782,12387,3374,93702,21021,128258,106089,,,,,0,0,0,0
1650434284.1526008,public.usertable,93919,21081,132046848,16560,public,usertable,1,0,150545,785503,106343,9815,12424,3388,93919,21081,128582,106343,,,,,0,0,0,0
1650434285.1828704,public.usertable,94179,21151,132431872,16560,public,usertable,1,0,151324,787418,106644,9851,12465,3408,94179,21151,128960,106644,,,,,0,0,0,0
1650434286.2143981,public.usertable,94422,21231,132808704,16560,public,usertable,1,0,152192,790745,106941,9880,12519,3425,94422,21231,129340,106941,,,,,0,0,0,0
1650434287.2454784,public.usertable,94684,21303,133201920,16560,public,usertable,1,0,152997,793013,107246,9917,12562,3446,94684,21303,129725,107246,,,,,0,0,0,0
1650434288.2754207,public.usertable,94929,21377,133570560,16560,public,usertable,1,0,153744,794543,107540,9950,12611,3456,94929,21377,130101,107540,,,,,0,0,0,0
1650434289.305376,public.usertable,95205,21436,133980160,16560,public,usertable,1,0,154544,796925,107855,9978,12650,3467,95205,21436,130483,107855,,,,,0,0,0,0
1650434290.334686,public.usertable,95448,21516,134348800,16560,public,usertable,1,0,155363,798242,108138,10020,12690,3483,95448,21516,130848,108138,,,,,0,0,0,0
1650434291.3629775,public.usertable,95654,21585,134660096,16560,public,usertable,1,0,156016,799012,108393,10046,12739,3499,95654,21585,131178,108393,,,,,0,0,0,0
1650434292.3937364,public.usertable,95860,21646,134963200,16560,public,usertable,1,0,156648,800131,108631,10078,12771,3511,95860,21646,131480,108631,,,,,0,0,0,0
1650434293.423343,public.usertable,96107,21702,135331840,16560,public,usertable,1,0,157323,801883,108917,10098,12810,3521,96107,21702,131825,108917,,,,,0,0,0,0
1650434294.4541802,public.usertable,96367,21767,135700480,16560,public,usertable,1,0,158065,805104,109214,10130,12847,3539,96367,21767,132191,109214,,,,,0,0,0,0
1650434295.4852633,public.usertable,96623,21836,136093696,16560,public,usertable,1,0,158841,806443,109512,10166,12889,3553,96623,21836,132567,109512,,,,,0,0,0,0
1650434296.5163922,public.usertable,96903,21911,136503296,16560,public,usertable,1,0,159590,808371,109836,10200,12933,3569,96903,21911,132969,109836,,,,,0,0,0,0
1650434297.5475066,public.usertable,97131,21956,136822784,16560,public,usertable,1,0,160290,811314,110095,10227,12964,3579,97131,21956,133286,110095,,,,,0,0,0,0
1650434298.5767317,public.usertable,97344,22016,137158656,16560,public,usertable,1,0,161006,812985,110347,10257,13003,3593,97344,22016,133607,110347,,,,,0,0,0,0
1650434299.6054592,public.usertable,97603,22074,137543680,16560,public,usertable,1,0,161773,815576,110643,10290,13040,3608,97603,22074,133973,110643,,,,,0,0,0,0
1650434300.6344469,public.usertable,97859,22153,137928704,16560,public,usertable,1,0,162652,817543,110944,10326,13085,3622,97859,22153,134355,110944,,,,,0,0,0,0
1650434301.6647766,public.usertable,98117,22228,138305536,16560,public,usertable,1,0,163546,821299,111247,10366,13130,3643,98117,22228,134743,111247,,,,,0,0,0,0
1650434302.6948729,public.usertable,98465,22343,138665984,16560,public,usertable,1,0,164752,823326,111665,10424,13200,3670,98465,22343,135289,111665,,,,,0,0,0,0
1650434303.7250998,public.usertable,98716,22391,139026432,16560,public,usertable,1,0,165508,826480,111947,10453,13231,3681,98716,22391,135631,111947,,,,,0,0,0,0
1650434304.7537591,public.usertable,99010,22456,139444224,16560,public,usertable,1,0,166371,829806,112282,10487,13272,3700,99010,22456,136041,112282,,,,,0,0,0,0
1650434305.7818346,public.usertable,99278,22517,139845632,16560,public,usertable,1,0,167252,833739,112590,10517,13312,3713,99278,22517,136419,112590,,,,,0,0,0,0
1650434306.817056,public.usertable,99559,22608,140271616,16560,public,usertable,1,0,168039,835650,112924,10560,13365,3732,99559,22608,136849,112924,,,,,0,0,0,0
1650434307.845653,public.usertable,99797,22680,140640256,16560,public,usertable,1,0,168785,838844,113212,10592,13415,3747,99797,22680,137219,113212,,,,,0,0,0,0
1650434308.876671,public.usertable,100067,22745,141008896,16560,public,usertable,1,0,169572,840872,113522,10620,13455,3761,100067,22745,137597,113522,,,,,0,0,0,0
1650434309.9064453,public.usertable,100296,22813,141361152,16560,public,usertable,1,0,170344,843595,113793,10649,13497,3776,100296,22813,137939,113793,,,,,0,0,0,0
1650434310.936798,public.usertable,100545,22878,141721600,16560,public,usertable,1,0,171143,846215,114082,10680,13537,3790,100545,22878,138299,114082,,,,,0,0,0,0
1650434311.9679797,public.usertable,100768,22952,142090240,16560,public,usertable,1,0,171816,847444,114352,10714,13584,3807,100768,22952,138650,114352,,,,,0,0,0,0
1650434312.997354,public.usertable,101047,23018,142491648,16560,public,usertable,1,0,172676,850681,114673,10748,13626,3821,101047,23018,139047,114673,,,,,0,0,0,0
1650434314.0268478,public.usertable,101284,23074,142794752,16560,public,usertable,1,0,173367,852531,114937,10781,13653,3836,101284,23074,139371,114937,,,,,0,0,0,0
1650434315.061617,public.usertable,101460,23117,143040512,16560,public,usertable,1,0,173837,855159,115133,10807,13673,3850,101460,23117,139613,115133,,,,,0,0,0,0
1650434316.0931864,public.usertable,101647,23177,143319040,16560,public,usertable,1,0,174486,857660,115356,10833,13709,3863,101647,23177,139898,115356,,,,,0,0,0,0
1650434317.1215515,public.usertable,101847,23234,143638528,16560,public,usertable,1,0,175135,858266,115587,10861,13740,3879,101847,23234,140188,115587,,,,,0,0,0,0
1650434318.1502,public.usertable,102067,23297,143982592,16560,public,usertable,1,0,175840,859514,115844,10891,13777,3896,102067,23297,140512,115844,,,,,0,0,0,0
1650434319.1803505,public.usertable,102298,23368,144302080,16560,public,usertable,1,0,176508,861438,116108,10931,13810,3910,102298,23368,140849,116108,,,,,0,0,0,0
1650434320.208209,public.usertable,102514,23418,144670720,16560,public,usertable,1,0,177199,863412,116360,10954,13846,3921,102514,23418,141160,116360,,,,,0,0,0,0
1650434321.2385185,public.usertable,102776,23483,145031168,16560,public,usertable,1,0,178056,867124,116664,10986,13888,3932,102776,23483,141538,116664,,,,,0,0,0,0
1650434322.269506,public.usertable,103166,23580,145432576,16560,public,usertable,1,0,179324,871835,117120,11030,13954,3952,103166,23580,142104,117120,,,,,0,0,0,0
1650434323.3005602,public.usertable,103460,23651,145858560,16560,public,usertable,1,0,180314,874346,117454,11072,13994,3974,103460,23651,142520,117454,,,,,0,0,0,0
1650434324.3296914,public.usertable,103727,23730,146259968,16560,public,usertable,1,0,181208,877802,117770,11110,14043,3993,103727,23730,142923,117770,,,,,0,0,0,0
1650434325.359686,public.usertable,103965,23814,146628608,16560,public,usertable,1,0,182066,879375,118055,11153,14090,4012,103965,23814,143298,118055,,,,,0,0,0,0
1650434326.389014,public.usertable,104224,23901,147030016,16560,public,usertable,1,0,182915,882111,118360,11197,14136,4029,104224,23901,143693,118360,,,,,0,0,0,0
1650434327.4192176,public.usertable,104481,23977,147415040,16560,public,usertable,1,0,183815,885310,118672,11225,14191,4044,104481,23977,144088,118672,,,,,0,0,0,0
1650434328.4476683,public.usertable,104761,24040,147816448,16560,public,usertable,1,0,184640,888262,118992,11253,14231,4062,104761,24040,144476,118992,,,,,0,0,0,0
1650434329.4809892,public.usertable,105014,24107,148201472,16560,public,usertable,1,0,185447,891387,119285,11283,14271,4074,105014,24107,144839,119285,,,,,0,0,0,0
1650434330.5100164,public.usertable,105293,24180,148602880,16560,public,usertable,1,0,186358,894434,119604,11321,14311,4094,105293,24180,145236,119604,,,,,0,0,0,0
1650434331.5424423,public.usertable,105546,24265,148987904,16560,public,usertable,1,0,187232,895875,119909,11359,14363,4113,105546,24265,145631,119909,,,,,0,0,0,0
1650434332.5703187,public.usertable,105771,24336,149315584,16560,public,usertable,1,0,187939,896675,120172,11394,14401,4130,105771,24336,145967,120172,,,,,0,0,0,0
1650434333.5988853,public.usertable,105989,24383,149610496,16560,public,usertable,1,0,188516,898637,120424,11412,14435,4137,105989,24383,146271,120424,,,,,0,0,0,0
1650434334.6303606,public.usertable,106182,24435,149897216,16560,public,usertable,1,0,189043,899769,120649,11432,14467,4146,106182,24435,146548,120649,,,,,0,0,0,0
1650434335.659666,public.usertable,106367,24484,150159360,16560,public,usertable,1,0,189649,901437,120864,11456,14497,4154,106367,24484,146817,120864,,,,,0,0,0,0
1650434336.690583,public.usertable,106558,24519,150437888,16560,public,usertable,1,0,190193,903432,121085,11472,14527,4164,106558,24519,147084,121085,,,,,0,0,0,0
1650434337.7207408,public.usertable,106729,24563,150708224,16560,public,usertable,1,0,190746,905560,121281,11496,14552,4177,106729,24563,147329,121281,,,,,0,0,0,0
1650434338.7519765,public.usertable,106927,24603,150986752,16560,public,usertable,1,0,191322,908316,121512,11508,14585,4181,106927,24603,147605,121512,,,,,0,0,0,0
1650434339.7814324,public.usertable,107083,24649,151158784,16560,public,usertable,1,0,191798,909204,121696,11526,14613,4187,107083,24649,147835,121696,,,,,0,0,0,0
1650434340.809536,public.usertable,107295,24711,151396352,16560,public,usertable,1,0,192551,910910,121941,11558,14646,4203,107295,24711,148145,121941,,,,,0,0,0,0
1650434341.8389614,public.usertable,107444,24760,151617536,16560,public,usertable,1,0,193020,911494,122118,11579,14674,4209,107444,24760,148371,122118,,,,,0,0,0,0
1650434342.872213,public.usertable,107626,24802,151871488,16560,public,usertable,1,0,193541,912740,122326,11596,14700,4217,107626,24802,148622,122326,,,,,0,0,0,0
1650434343.9015536,public.usertable,107768,24831,152068096,16560,public,usertable,1,0,193948,914209,122483,11613,14715,4227,107768,24831,148811,122483,,,,,0,0,0,0
1650434344.930703,public.usertable,107925,24859,152281088,16560,public,usertable,1,0,194437,914735,122655,11626,14730,4233,107925,24859,149011,122655,,,,,0,0,0,0
1650434345.9597027,public.usertable,108111,24898,152567808,16560,public,usertable,1,0,194910,916448,122863,11648,14752,4245,108111,24898,149263,122863,,,,,0,0,0,0
1650434346.9892762,public.usertable,108315,24946,152846336,16560,public,usertable,1,0,195584,917648,123100,11673,14785,4258,108315,24946,149558,123100,,,,,0,0,0,0
1650434348.0191357,public.usertable,108519,24990,153141248,16560,public,usertable,1,0,196158,919672,123334,11693,14815,4269,108519,24990,149842,123334,,,,,0,0,0,0
1650434349.048614,public.usertable,108694,25024,153411584,16560,public,usertable,1,0,196683,920093,123534,11704,14840,4274,108694,25024,150078,123534,,,,,0,0,0,0
1650434350.0782156,public.usertable,108919,25090,153747456,16560,public,usertable,1,0,197462,923720,123798,11737,14879,4289,108919,25090,150414,123798,,,,,0,0,0,0
1650434351.1097403,public.usertable,109181,25161,154140672,16560,public,usertable,1,0,198359,925703,124103,11770,14922,4305,109181,25161,150795,124103,,,,,0,0,0,0
1650434352.139962,public.usertable,109427,25232,154501120,16560,public,usertable,1,0,199203,927384,124380,11814,14953,4323,109427,25232,151147,124380,,,,,0,0,0,0
1650434353.1733704,public.usertable,109707,25301,154894336,16560,public,usertable,1,0,200060,929026,124695,11851,14988,4346,109707,25301,151534,124695,,,,,0,0,0,0
1650434354.206659,public.usertable,109970,25357,155271168,16560,public,usertable,1,0,200854,931872,124988,11887,15018,4361,109970,25357,151893,124988,,,,,0,0,0,0
1650434355.2394164,public.usertable,110227,25403,155656192,16560,public,usertable,1,0,201646,934239,125283,11913,15056,4374,110227,25403,152252,125283,,,,,0,0,0,0
1650434356.2680566,public.usertable,110498,25476,156041216,16560,public,usertable,1,0,202506,936412,125598,11945,15100,4391,110498,25476,152643,125598,,,,,0,0,0,0
1650434357.2968402,public.usertable,110747,25522,156409856,16560,public,usertable,1,0,203152,939718,125879,11969,15132,4401,110747,25522,152980,125879,,,,,0,0,0,0
1650434358.3290174,public.usertable,111004,25587,156778496,16560,public,usertable,1,0,203975,942021,126172,12000,15168,4419,111004,25587,153340,126172,,,,,0,0,0,0
1650434359.3576398,public.usertable,111279,25677,157171712,16560,public,usertable,1,0,204865,944611,126493,12050,15214,4451,111279,25677,153757,126493,,,,,0,0,0,0
1650434360.3869321,public.usertable,111563,25738,157597696,16560,public,usertable,1,0,205702,947496,126811,12085,15248,4464,111563,25738,154144,126811,,,,,0,0,0,0
1650434361.4164517,public.usertable,111978,25836,157990912,16560,public,usertable,1,0,206898,950642,127289,12129,15311,4483,111978,25836,154729,127289,,,,,0,0,0,0
1650434362.4457264,public.usertable,112243,25898,158384128,16560,public,usertable,1,0,207705,953538,127593,12158,15350,4497,112243,25898,155101,127593,,,,,0,0,0,0
1650434363.474566,public.usertable,112511,25948,158769152,16560,public,usertable,1,0,208499,956361,127899,12184,15388,4507,112511,25948,155471,127899,,,,,0,0,0,0
1650434364.5040984,public.usertable,112765,26011,159129600,16560,public,usertable,1,0,209308,958500,128187,12221,15422,4526,112765,26011,155830,128187,,,,,0,0,0,0
1650434365.5326362,public.usertable,113068,26078,159547392,16560,public,usertable,1,0,210227,961834,128529,12256,15461,4547,113068,26078,156246,128529,,,,,0,0,0,0
1650434366.561597,public.usertable,113372,26133,159981568,16560,public,usertable,1,0,211158,964502,128861,12285,15489,4560,113372,26133,156635,128861,,,,,0,0,0,0
1650434367.5897646,public.usertable,113619,26196,160325632,16560,public,usertable,1,0,211909,966964,129144,12317,15525,4579,113619,26196,156986,129144,,,,,0,0,0,0
1650434368.6207805,public.usertable,113894,26258,160727040,16560,public,usertable,1,0,212698,968590,129459,12342,15565,4591,113894,26258,157366,129459,,,,,0,0,0,0
1650434369.6497123,public.usertable,114138,26336,161095680,16560,public,usertable,1,0,213544,970843,129743,12385,15605,4616,114138,26336,157733,129743,,,,,0,0,0,0
1650434370.677757,public.usertable,114446,26391,161521664,16560,public,usertable,1,0,214366,971692,130083,12411,15637,4623,114446,26391,158131,130083,,,,,0,0,0,0
1650434371.705799,public.usertable,114732,26460,161923072,16560,public,usertable,1,0,215252,973923,130412,12444,15680,4640,114732,26460,158536,130412,,,,,0,0,0,0
1650434372.734663,public.usertable,114992,26516,162324480,16560,public,usertable,1,0,216117,977303,130713,12478,15721,4658,114992,26516,158912,130713,,,,,0,0,0,0
1650434373.7673938,public.usertable,115247,26590,162693120,16560,public,usertable,1,0,216934,980440,131014,12515,15767,4674,115247,26590,159296,131014,,,,,0,0,0,0
1650434374.8017316,public.usertable,115534,26647,163078144,16560,public,usertable,1,0,217802,982905,131335,12546,15801,4691,115534,26647,159682,131335,,,,,0,0,0,0
1650434375.832989,public.usertable,115787,26716,163495936,16560,public,usertable,1,0,218566,984673,131626,12582,15839,4704,115787,26716,160047,131626,,,,,0,0,0,0
1650434376.8664758,public.usertable,116079,26771,163880960,16560,public,usertable,1,0,219361,986285,131951,12608,15872,4714,116079,26771,160431,131951,,,,,0,0,0,0
1650434377.898089,public.usertable,116339,26835,164274176,16560,public,usertable,1,0,220208,987957,132248,12640,15909,4726,116339,26835,160797,132248,,,,,0,0,0,0
1650434378.9299135,public.usertable,116628,26897,164691968,16560,public,usertable,1,0,220985,991576,132575,12673,15947,4744,116628,26897,161195,132575,,,,,0,0,0,0
1650434379.9592006,public.usertable,116915,26964,165101568,16560,public,usertable,1,0,221853,993878,132902,12704,15987,4758,116915,26964,161593,132902,,,,,0,0,0,0
1650434380.990283,public.usertable,117347,27058,165519360,16560,public,usertable,1,0,223045,996261,133392,12747,16045,4778,117347,27058,162184,133392,,,,,0,0,0,0
1650434382.021418,public.usertable,117630,27124,165920768,16560,public,usertable,1,0,223834,998308,133715,12776,16085,4793,117630,27124,162576,133715,,,,,0,0,0,0
1650434383.053953,public.usertable,117910,27189,166322176,16560,public,usertable,1,0,224733,1000944,134030,12808,16120,4812,117910,27189,162958,134030,,,,,0,0,0,0
1650434384.0837092,public.usertable,118155,27248,166666240,16560,public,usertable,1,0,225587,1003862,134314,12841,16159,4824,118155,27248,163314,134314,,,,,0,0,0,0
1650434385.1168702,public.usertable,118379,27317,167026688,16560,public,usertable,1,0,226364,1006027,134589,12865,16210,4839,118379,27317,163664,134589,,,,,0,0,0,0
1650434386.1461663,public.usertable,118644,27390,167428096,16560,public,usertable,1,0,227214,1007845,134894,12899,16250,4852,118644,27390,164043,134894,,,,,0,0,0,0
1650434387.1759543,public.usertable,118932,27439,167804928,16560,public,usertable,1,0,228012,1008464,135211,12924,16279,4871,118932,27439,164414,135211,,,,,0,0,0,0
1650434388.2046864,public.usertable,119183,27508,168173568,16560,public,usertable,1,0,228765,1009398,135503,12956,16320,4891,119183,27508,164779,135503,,,,,0,0,0,0
1650434389.2364028,public.usertable,119424,27568,168550400,16560,public,usertable,1,0,229579,1011988,135790,12978,16366,4899,119424,27568,165134,135790,,,,,0,0,0,0
1650434390.2649498,public.usertable,119673,27608,168869888,16560,public,usertable,1,0,230322,1013795,136069,13004,16396,4914,119673,27608,165469,136069,,,,,0,0,0,0
1650434391.2943263,public.usertable,119927,27668,169246720,16560,public,usertable,1,0,231052,1017488,136356,13035,16429,4928,119927,27668,165820,136356,,,,,0,0,0,0
1650434392.3232372,public.usertable,120183,27721,169607168,16560,public,usertable,1,0,231824,1019569,136648,13060,16465,4940,120183,27721,166173,136648,,,,,0,0,0,0
1650434393.3538535,public.usertable,120417,27767,169959424,16560,public,usertable,1,0,232636,1021999,136914,13087,16497,4950,120417,27767,166498,136914,,,,,0,0,0,0
1650434394.383739,public.usertable,120675,27832,170319872,16560,public,usertable,1,0,233492,1024230,137216,13116,16541,4966,120675,27832,166873,137216,,,,,0,0,0,0
1650434395.4145238,public.usertable,120939,27877,170680320,16560,public,usertable,1,0,234302,1026735,137512,13139,16573,4980,120939,27877,167224,137512,,,,,0,0,0,0
1650434396.4433346,public.usertable,121201,27948,171089920,16560,public,usertable,1,0,235266,1029850,137821,13169,16620,5002,121201,27948,167610,137821,,,,,0,0,0,0
1650434397.4751396,public.usertable,121479,28003,171474944,16560,public,usertable,1,0,236118,1031581,138127,13197,16648,5014,121479,28003,167972,138127,,,,,0,0,0,0
1650434398.5044265,public.usertable,121742,28059,171835392,16560,public,usertable,1,0,236903,1034272,138421,13222,16679,5023,121742,28059,168322,138421,,,,,0,0,0,0
1650434399.537036,public.usertable,121988,28120,172187648,16560,public,usertable,1,0,237732,1037953,138704,13251,16716,5041,121988,28120,168671,138704,,,,,0,0,0,0
1650434400.5673406,public.usertable,122329,28200,172507136,16560,public,usertable,1,0,238762,1041635,139093,13285,16764,5058,122329,28200,169142,139093,,,,,0,0,0,0
1650434401.6106977,public.usertable,122593,28253,172875776,16560,public,usertable,1,0,239484,1044053,139386,13313,16793,5070,122593,28253,169492,139386,,,,,0,0,0,0
1650434402.6415093,public.usertable,122868,28312,173268992,16560,public,usertable,1,0,240238,1046763,139689,13349,16821,5087,122868,28312,169859,139689,,,,,0,0,0,0
1650434403.6711113,public.usertable,123122,28365,173613056,16560,public,usertable,1,0,240895,1047721,139978,13376,16856,5104,123122,28365,170210,139978,,,,,0,0,0,0
1650434404.7014406,public.usertable,123366,28417,173965312,16560,public,usertable,1,0,241523,1050899,140255,13403,16889,5116,123366,28417,170547,140255,,,,,0,0,0,0
1650434405.729829,public.usertable,123607,28471,174317568,16560,public,usertable,1,0,242234,1051516,140532,13423,16925,5127,123607,28471,170880,140532,,,,,0,0,0,0
1650434406.7616558,public.usertable,123850,28519,174661632,16560,public,usertable,1,0,242941,1055232,140809,13446,16959,5137,123850,28519,171214,140809,,,,,0,0,0,0
1650434407.792938,public.usertable,124097,28567,174997504,16560,public,usertable,1,0,243661,1057235,141087,13465,16990,5147,124097,28567,171542,141087,,,,,0,0,0,0
1650434408.8232355,public.usertable,124325,28601,175300608,16560,public,usertable,1,0,244239,1059320,141342,13480,17017,5152,124325,28601,171839,141342,,,,,0,0,0,0
1650434409.8517718,public.usertable,124535,28639,175579136,16560,public,usertable,1,0,244933,1062134,141580,13498,17045,5162,124535,28639,172123,141580,,,,,0,0,0,0
1650434410.8832912,public.usertable,124694,28678,175816704,16560,public,usertable,1,0,245452,1063345,141756,13521,17062,5174,124694,28678,172339,141756,,,,,0,0,0,0
1650434411.9145563,public.usertable,124862,28720,176054272,16560,public,usertable,1,0,245908,1064814,141954,13538,17092,5181,124862,28720,172584,141954,,,,,0,0,0,0
1650434412.9472883,public.usertable,125056,28757,176316416,16560,public,usertable,1,0,246422,1066379,142167,13556,17111,5192,125056,28757,172834,142167,,,,,0,0,0,0
1650434413.979514,public.usertable,125237,28791,176578560,16560,public,usertable,1,0,246874,1066842,142370,13568,17133,5199,125237,28791,173071,142370,,,,,0,0,0,0
1650434415.0096335,public.usertable,125410,28837,176799744,16560,public,usertable,1,0,247403,1068293,142568,13589,17158,5209,125410,28837,173315,142568,,,,,0,0,0,0
1650434416.038787,public.usertable,125562,28865,177020928,16560,public,usertable,1,0,247815,1068689,142736,13602,17174,5215,125562,28865,173512,142736,,,,,0,0,0,0
1650434417.0692673,public.usertable,125743,28909,177307648,16560,public,usertable,1,0,248422,1070422,142940,13626,17197,5229,125743,28909,173763,142940,,,,,0,0,0,0
1650434418.0993369,public.usertable,125935,28958,177577984,16560,public,usertable,1,0,248993,1071961,143155,13652,17220,5237,125935,28958,174027,143155,,,,,0,0,0,0
1650434419.1292565,public.usertable,126115,28993,177831936,16560,public,usertable,1,0,249431,1072466,143356,13671,17241,5245,126115,28993,174268,143356,,,,,0,0,0,0
1650434420.1574337,public.usertable,126298,29034,178085888,16560,public,usertable,1,0,249999,1073422,143567,13685,17269,5251,126298,29034,174521,143567,,,,,0,0,0,0
1650434421.1864793,public.usertable,126543,29078,178520064,16560,public,usertable,1,0,250719,1074048,143832,13710,17289,5264,126543,29078,174831,143832,,,,,0,0,0,0
1650434422.2169573,public.usertable,126934,29168,178839552,16560,public,usertable,1,0,251911,1075852,144276,13758,17342,5287,126934,29168,175376,144276,,,,,0,0,0,0
1650434423.245861,public.usertable,127171,29227,179191808,16560,public,usertable,1,0,252654,1077344,144551,13784,17380,5297,127171,29227,175715,144551,,,,,0,0,0,0
1650434424.2750015,public.usertable,127415,29277,179527680,16560,public,usertable,1,0,253366,1079069,144819,13815,17404,5310,127415,29277,176038,144819,,,,,0,0,0,0
1650434425.3046756,public.usertable,127653,29332,179879936,16560,public,usertable,1,0,254204,1080941,145087,13842,17434,5321,127653,29332,176363,145087,,,,,0,0,0,0
1650434426.341387,public.usertable,127873,29382,180199424,16560,public,usertable,1,0,254953,1082428,145337,13867,17464,5332,127873,29382,176668,145337,,,,,0,0,0,0
1650434427.3730452,public.usertable,128102,29421,180518912,16560,public,usertable,1,0,255675,1084917,145594,13892,17492,5343,128102,29421,176978,145594,,,,,0,0,0,0
1650434428.4034107,public.usertable,128325,29473,180838400,16560,public,usertable,1,0,256318,1085622,145843,13919,17518,5356,128325,29473,177280,145843,,,,,0,0,0,0
1650434429.4349933,public.usertable,128575,29522,181190656,16560,public,usertable,1,0,257074,1088283,146122,13950,17547,5375,128575,29522,177619,146122,,,,,0,0,0,0
1650434430.4649794,public.usertable,128840,29561,181559296,16560,public,usertable,1,0,257759,1090134,146420,13965,17580,5380,128840,29561,177965,146420,,,,,0,0,0,0
1650434431.493819,public.usertable,129131,29615,181968896,16560,public,usertable,1,0,258633,1092119,146737,13998,17606,5400,129131,29615,178341,146737,,,,,0,0,0,0
1650434432.5224814,public.usertable,129372,29679,182321152,16560,public,usertable,1,0,259348,1092914,147012,14032,17640,5416,129372,29679,178684,147012,,,,,0,0,0,0
1650434433.5530317,public.usertable,129643,29725,182673408,16560,public,usertable,1,0,260018,1094343,147309,14058,17666,5429,129643,29725,179033,147309,,,,,0,0,0,0
1650434434.5858598,public.usertable,129881,29766,183001088,16560,public,usertable,1,0,260747,1095022,147573,14079,17692,5438,129881,29766,179344,147573,,,,,0,0,0,0
1650434435.6175013,public.usertable,130067,29827,183279616,16560,public,usertable,1,0,261410,1096531,147787,14116,17720,5453,130067,29827,179623,147787,,,,,0,0,0,0
1650434436.6462479,public.usertable,130297,29877,183615488,16560,public,usertable,1,0,262101,1098538,148051,14138,17754,5463,130297,29877,179943,148051,,,,,0,0,0,0
1650434437.6768727,public.usertable,130546,29934,183992320,16560,public,usertable,1,0,262919,1099933,148334,14167,17788,5480,130546,29934,180289,148334,,,,,0,0,0,0
1650434438.7057343,public.usertable,130825,29985,184393728,16560,public,usertable,1,0,263719,1103203,148639,14200,17814,5496,130825,29985,180653,148639,,,,,0,0,0,0
1650434439.7364068,public.usertable,131128,30042,184811520,16560,public,usertable,1,0,264609,1104795,148977,14231,17849,5512,131128,30042,181057,148977,,,,,0,0,0,0
1650434440.7648463,public.usertable,131408,30111,185212928,16560,public,usertable,1,0,265572,1106847,149298,14272,17890,5531,131408,30111,181460,149298,,,,,0,0,0,0
1650434441.7939236,public.usertable,131838,30200,185630720,16560,public,usertable,1,0,266764,1110285,149779,14318,17941,5548,131838,30200,182038,149779,,,,,0,0,0,0
1650434442.8218224,public.usertable,132107,30248,186007552,16560,public,usertable,1,0,267588,1112569,150083,14339,17976,5559,132107,30248,182398,150083,,,,,0,0,0,0
1650434443.8524444,public.usertable,132344,30309,186368000,16560,public,usertable,1,0,268320,1114207,150355,14370,18011,5568,132344,30309,182736,150355,,,,,0,0,0,0
1650434444.8846338,public.usertable,132619,30366,186753024,16560,public,usertable,1,0,269009,1115153,150660,14398,18041,5578,132619,30366,183099,150660,,,,,0,0,0,0
1650434445.9157188,public.usertable,132905,30415,187138048,16560,public,usertable,1,0,269786,1116441,150971,14424,18066,5589,132905,30415,183461,150971,,,,,0,0,0,0
1650434446.9451268,public.usertable,133162,30473,187506688,16560,public,usertable,1,0,270526,1119277,151262,14455,18100,5606,133162,30473,183817,151262,,,,,0,0,0,0
1650434447.9731624,public.usertable,133411,30541,187891712,16560,public,usertable,1,0,271287,1120740,151556,14484,18145,5617,133411,30541,184185,151556,,,,,0,0,0,0
1650434449.003769,public.usertable,133699,30602,188293120,16560,public,usertable,1,0,272175,1121568,151882,14510,18183,5628,133699,30602,184575,151882,,,,,0,0,0,0
1650434450.0357032,public.usertable,133969,30653,188678144,16560,public,usertable,1,0,273027,1123408,152190,14532,18221,5640,133969,30653,184943,152190,,,,,0,0,0,0
1650434451.067553,public.usertable,134260,30715,189095936,16560,public,usertable,1,0,273784,1124265,152518,14559,18258,5652,134260,30715,185335,152518,,,,,0,0,0,0
1650434452.0962658,public.usertable,134555,30759,189472768,16560,public,usertable,1,0,274558,1125971,152831,14586,18276,5662,134555,30759,185693,152831,,,,,0,0,0,0
1650434453.1268787,public.usertable,134818,30819,189857792,16560,public,usertable,1,0,275464,1128548,153135,14616,18317,5679,134818,30819,186068,153135,,,,,0,0,0,0
1650434454.1563034,public.usertable,135096,30868,190267392,16560,public,usertable,1,0,276329,1130089,153444,14637,18348,5688,135096,30868,186429,153444,,,,,0,0,0,0
1650434455.1867714,public.usertable,135400,30917,190676992,16560,public,usertable,1,0,277303,1132569,153787,14668,18387,5706,135400,30917,186842,153787,,,,,0,0,0,0
1650434456.2183867,public.usertable,135669,30986,191078400,16560,public,usertable,1,0,278129,1133994,154098,14699,18429,5719,135669,30986,187226,154098,,,,,0,0,0,0
1650434457.2473905,public.usertable,135932,31041,191447040,16560,public,usertable,1,0,278983,1135423,154391,14727,18459,5731,135932,31041,187577,154391,,,,,0,0,0,0
1650434458.2775242,public.usertable,136213,31074,191856640,16560,public,usertable,1,0,279791,1137527,154704,14746,18491,5738,136213,31074,187941,154704,,,,,0,0,0,0
1650434459.307182,public.usertable,136523,31126,192274432,16560,public,usertable,1,0,280713,1140810,155051,14767,18528,5747,136523,31126,188346,155051,,,,,0,0,0,0
1650434460.3380196,public.usertable,136799,31180,192634880,16560,public,usertable,1,0,281544,1141640,155359,14791,18560,5760,136799,31180,188710,155359,,,,,0,0,0,0
1650434461.3675063,public.usertable,137181,31260,192995328,16560,public,usertable,1,0,282811,1144151,155791,14828,18610,5783,137181,31260,189229,155791,,,,,0,0,0,0
1650434462.3970852,public.usertable,137447,31319,193380352,16560,public,usertable,1,0,283593,1146492,156098,14851,18651,5794,137447,31319,189600,156098,,,,,0,0,0,0
1650434463.4274986,public.usertable,137740,31377,193789952,16560,public,usertable,1,0,284444,1149100,156424,14879,18684,5808,137740,31377,189987,156424,,,,,0,0,0,0
1650434464.4567888,public.usertable,138026,31434,194183168,16560,public,usertable,1,0,285272,1150443,156740,14908,18714,5819,138026,31434,190362,156740,,,,,0,0,0,0
1650434465.4857657,public.usertable,138296,31482,194576384,16560,public,usertable,1,0,286028,1151734,157043,14930,18747,5828,138296,31482,190720,157043,,,,,0,0,0,0
1650434466.517736,public.usertable,138605,31540,195010560,16560,public,usertable,1,0,286898,1152671,157389,14959,18784,5843,138605,31540,191132,157389,,,,,0,0,0,0
1650434467.548591,public.usertable,138863,31604,195379200,16560,public,usertable,1,0,287705,1153522,157686,14986,18823,5856,138863,31604,191495,157686,,,,,0,0,0,0
1650434468.5833519,public.usertable,139159,31657,195796992,16560,public,usertable,1,0,288606,1155323,158012,15012,18853,5866,139159,31657,191877,158012,,,,,0,0,0,0
1650434469.613835,public.usertable,139477,31713,196247552,16560,public,usertable,1,0,289470,1157341,158362,15045,18885,5880,139477,31713,192292,158362,,,,,0,0,0,0
1650434470.6434162,public.usertable,139786,31752,196665344,16560,public,usertable,1,0,290237,1158722,158700,15062,18914,5886,139786,31752,192676,158700,,,,,0,0,0,0
1650434471.6749935,public.usertable,140101,31809,197083136,16560,public,usertable,1,0,291214,1160274,159052,15098,18951,5904,140101,31809,193101,159052,,,,,0,0,0,0
1650434472.7052095,public.usertable,140398,31858,197509120,16560,public,usertable,1,0,292076,1164555,159382,15124,18984,5917,140398,31858,193490,159382,,,,,0,0,0,0
1650434473.7376478,public.usertable,140728,31897,197943296,16560,public,usertable,1,0,292984,1166400,159743,15143,19015,5924,140728,31897,193901,159743,,,,,0,0,0,0
1650434474.7710764,public.usertable,141009,31940,198352896,16560,public,usertable,1,0,293752,1167586,160050,15165,19041,5934,141009,31940,194256,160050,,,,,0,0,0,0
1650434475.7995348,public.usertable,141312,31991,198737920,16560,public,usertable,1,0,294625,1168699,160383,15191,19071,5942,141312,31991,194645,160383,,,,,0,0,0,0
1650434476.8293602,public.usertable,141582,32038,199131136,16560,public,usertable,1,0,295439,1170423,160687,15210,19105,5951,141582,32038,195002,160687,,,,,0,0,0,0
1650434477.8577669,public.usertable,141846,32084,199483392,16560,public,usertable,1,0,296279,1172597,160976,15240,19130,5968,141846,32084,195346,160976,,,,,0,0,0,0
1650434478.8867967,public.usertable,142080,32152,199827456,16560,public,usertable,1,0,297099,1173761,161252,15267,19172,5976,142080,32152,195691,161252,,,,,0,0,0,0
1650434479.915261,public.usertable,142327,32188,200155136,16560,public,usertable,1,0,297795,1174545,161522,15282,19195,5982,142327,32188,195999,161522,,,,,0,0,0,0
1650434480.944343,public.usertable,142658,32260,200458240,16560,public,usertable,1,0,298914,1176319,161890,15318,19232,6001,142658,32260,196440,161890,,,,,0,0,0,0
1650434481.9824934,public.usertable,142861,32301,200753152,16560,public,usertable,1,0,299490,1177941,162121,15333,19260,6006,142861,32301,196714,162121,,,,,0,0,0,0
1650434483.0113282,public.usertable,143059,32344,201031680,16560,public,usertable,1,0,300085,1179761,162345,15356,19286,6018,143059,32344,196987,162345,,,,,0,0,0,0
1650434484.042144,public.usertable,143245,32370,201285632,16560,public,usertable,1,0,300665,1181807,162552,15372,19307,6027,143245,32370,197231,162552,,,,,0,0,0,0
1650434485.0771735,public.usertable,143473,32398,201580544,16560,public,usertable,1,0,301246,1183451,162798,15384,19325,6034,143473,32398,197507,162798,,,,,0,0,0,0
1650434486.1064398,public.usertable,143702,32440,201924608,16560,public,usertable,1,0,301888,1184976,163058,15400,19356,6042,143702,32440,197814,163058,,,,,0,0,0,0
1650434487.1385407,public.usertable,143950,32476,202235904,16560,public,usertable,1,0,302503,1185719,163328,15416,19378,6049,143950,32476,198122,163328,,,,,0,0,0,0
1650434488.1681461,public.usertable,144213,32516,202645504,16560,public,usertable,1,0,303277,1188207,163620,15440,19407,6057,144213,32516,198467,163620,,,,,0,0,0,0
1650434489.198471,public.usertable,144500,32567,203030528,16560,public,usertable,1,0,304155,1190741,163944,15463,19444,6069,144500,32567,198851,163944,,,,,0,0,0,0
1650434490.22738,public.usertable,144774,32619,203415552,16560,public,usertable,1,0,304960,1192101,164249,15487,19475,6084,144774,32619,199211,164249,,,,,0,0,0,0
1650434491.2558815,public.usertable,145056,32674,203792384,16560,public,usertable,1,0,305827,1193361,164560,15515,19504,6093,145056,32674,199579,164560,,,,,0,0,0,0
1650434492.2845385,public.usertable,145326,32724,204144640,16560,public,usertable,1,0,306551,1194565,164858,15540,19532,6106,145326,32724,199930,164858,,,,,0,0,0,0
1650434493.3122888,public.usertable,145582,32765,204513280,16560,public,usertable,1,0,307221,1195984,165142,15553,19560,6113,145582,32765,200255,165142,,,,,0,0,0,0
1650434494.3422406,public.usertable,145858,32810,204914688,16560,public,usertable,1,0,307970,1197249,165448,15573,19590,6123,145858,32810,200611,165448,,,,,0,0,0,0
1650434495.3717575,public.usertable,146144,32857,205299712,16560,public,usertable,1,0,308735,1199850,165760,15599,19616,6135,146144,32857,200975,165760,,,,,0,0,0,0
1650434496.4035785,public.usertable,146442,32900,205733888,16560,public,usertable,1,0,309701,1202234,166080,15629,19638,6150,146442,32900,201347,166080,,,,,0,0,0,0
1650434497.4337506,public.usertable,146765,32941,206118912,16560,public,usertable,1,0,310565,1204508,166431,15656,19666,6164,146765,32941,201753,166431,,,,,0,0,0,0
1650434498.463978,public.usertable,147035,32997,206528512,16560,public,usertable,1,0,311469,1207029,166735,15682,19700,6177,147035,32997,202117,166735,,,,,0,0,0,0
1650434499.4984753,public.usertable,147321,33038,206938112,16560,public,usertable,1,0,312297,1208050,167049,15701,19728,6181,147321,33038,202478,167049,,,,,0,0,0,0
1650434500.530477,public.usertable,147756,33127,207331328,16560,public,usertable,1,0,313481,1208429,167541,15737,19785,6201,147756,33127,203063,167541,,,,,0,0,0,0
1650434501.5596917,public.usertable,148056,33171,207740928,16560,public,usertable,1,0,314325,1210901,167870,15756,19814,6212,148056,33171,203440,167870,,,,,0,0,0,0
1650434502.5934854,public.usertable,148356,33221,208134144,16560,public,usertable,1,0,315156,1212319,168197,15783,19841,6228,148356,33221,203821,168197,,,,,0,0,0,0
1650434503.6229239,public.usertable,148616,33266,208502784,16560,public,usertable,1,0,315949,1213837,168491,15799,19875,6237,148616,33266,204165,168491,,,,,0,0,0,0
1650434504.65285,public.usertable,148865,33318,208846848,16560,public,usertable,1,0,316717,1214840,168774,15820,19909,6246,148865,33318,204503,168774,,,,,0,0,0,0
1650434505.68431,public.usertable,149153,33358,209231872,16560,public,usertable,1,0,317547,1217520,169078,15848,19925,6259,149153,33358,204851,169078,,,,,0,0,0,0
1650434506.712603,public.usertable,149420,33412,209616896,16560,public,usertable,1,0,318404,1218910,169380,15874,19960,6275,149420,33412,205214,169380,,,,,0,0,0,0
1650434507.741772,public.usertable,149688,33468,209985536,16560,public,usertable,1,0,319240,1220489,169675,15907,19987,6288,149688,33468,205569,169675,,,,,0,0,0,0
1650434508.772322,public.usertable,149965,33521,210386944,16560,public,usertable,1,0,320101,1222288,169985,15928,20020,6296,149965,33521,205933,169985,,,,,0,0,0,0
1650434509.8037946,public.usertable,150273,33549,210771968,16560,public,usertable,1,0,320812,1224551,170318,15942,20045,6304,150273,33549,206305,170318,,,,,0,0,0,0
1650434510.833209,public.usertable,150536,33601,211132416,16560,public,usertable,1,0,321436,1226075,170609,15967,20073,6322,150536,33601,206649,170609,,,,,0,0,0,0
1650434511.8662903,public.usertable,150757,33645,211443712,16560,public,usertable,1,0,322118,1227786,170860,15981,20103,6329,150757,33645,206944,170860,,,,,0,0,0,0
1650434512.895023,public.usertable,151013,33682,211755008,16560,public,usertable,1,0,322889,1229163,171140,15996,20127,6337,151013,33682,207263,171140,,,,,0,0,0,0
1650434513.9238787,public.usertable,151224,33722,212090880,16560,public,usertable,1,0,323603,1230550,171373,16018,20149,6345,151224,33722,207540,171373,,,,,0,0,0,0
1650434514.952405,public.usertable,151524,33758,212492288,16560,public,usertable,1,0,324429,1232548,171698,16036,20174,6355,151524,33758,207908,171698,,,,,0,0,0,0
1650434515.9814446,public.usertable,151770,33804,212819968,16560,public,usertable,1,0,325233,1235040,171974,16054,20204,6364,151770,33804,208232,171974,,,,,0,0,0,0
1650434517.0117345,public.usertable,151974,33852,213090304,16560,public,usertable,1,0,325890,1235373,172208,16072,20234,6369,151974,33852,208514,172208,,,,,0,0,0,0
1650434518.0437324,public.usertable,152158,33887,213336064,16560,public,usertable,1,0,326545,1237011,172414,16089,20256,6374,152158,33887,208759,172414,,,,,0,0,0,0
1650434519.0730474,public.usertable,152315,33918,213557248,16560,public,usertable,1,0,327042,1237174,172588,16103,20273,6381,152315,33918,208964,172588,,,,,0,0,0,0
1650434520.1036491,public.usertable,152478,33947,213794816,16560,public,usertable,1,0,327509,1239153,172771,16115,20293,6387,152478,33947,209179,172771,,,,,0,0,0,0
1650434521.1339614,public.usertable,152718,33993,214163456,16560,public,usertable,1,0,328234,1240368,173039,16133,20321,6395,152718,33993,209493,173039,,,,,0,0,0,0
1650434522.1656256,public.usertable,153077,34079,214499328,16560,public,usertable,1,0,329377,1241709,173439,16184,20362,6420,153077,34079,209985,173439,,,,,0,0,0,0
1650434523.1968937,public.usertable,153319,34121,214818816,16560,public,usertable,1,0,330014,1243156,173709,16204,20390,6429,153319,34121,210303,173709,,,,,0,0,0,0
1650434524.22649,public.usertable,153560,34149,215146496,16560,public,usertable,1,0,330625,1244638,173968,16217,20408,6437,153560,34149,210593,173968,,,,,0,0,0,0
1650434525.2559345,public.usertable,153834,34209,215539712,16560,public,usertable,1,0,331450,1247132,174282,16242,20448,6449,153834,34209,210972,174282,,,,,0,0,0,0
1650434526.2849813,public.usertable,154107,34251,215891968,16560,public,usertable,1,0,332333,1248157,174581,16260,20474,6457,154107,34251,211315,174581,,,,,0,0,0,0
1650434527.3159235,public.usertable,154273,34279,216145920,16560,public,usertable,1,0,332776,1249676,174771,16271,20498,6462,154273,34279,211540,174771,,,,,0,0,0,0
1650434528.3479767,public.usertable,154474,34304,216416256,16560,public,usertable,1,0,333338,1249830,174987,16284,20513,6466,154474,34304,211784,174987,,,,,0,0,0,0
1650434529.375865,public.usertable,154700,34336,216711168,16560,public,usertable,1,0,333877,1251016,175231,16303,20531,6476,154700,34336,212065,175231,,,,,0,0,0,0
1650434530.4055607,public.usertable,154890,34376,216981504,16560,public,usertable,1,0,334399,1251657,175446,16320,20556,6483,154890,34376,212322,175446,,,,,0,0,0,0
1650434531.4359217,public.usertable,155091,34396,217235456,16560,public,usertable,1,0,334909,1253222,175659,16331,20568,6493,155091,34396,212558,175659,,,,,0,0,0,0
1650434532.4666722,public.usertable,155281,34429,217513984,16560,public,usertable,1,0,335430,1254724,175869,16351,20588,6502,155281,34429,212808,175869,,,,,0,0,0,0
1650434533.497152,public.usertable,155474,34471,217767936,16560,public,usertable,1,0,335961,1255496,176079,16376,20605,6512,155474,34471,213060,176079,,,,,0,0,0,0
1650434534.5270972,public.usertable,155689,34499,218046464,16560,public,usertable,1,0,336550,1256601,176312,16391,20623,6522,155689,34499,213326,176312,,,,,0,0,0,0
1650434535.5584712,public.usertable,155851,34534,218275840,16560,public,usertable,1,0,336998,1258175,176499,16405,20648,6527,155851,34534,213552,176499,,,,,0,0,0,0
1650434536.58883,public.usertable,156045,34571,218554368,16560,public,usertable,1,0,337615,1259559,176715,16421,20670,6535,156045,34571,213806,176715,,,,,0,0,0,0
1650434537.6188736,public.usertable,156242,34609,218832896,16560,public,usertable,1,0,338309,1260548,176937,16442,20695,6547,156242,34609,214074,176937,,,,,0,0,0,0
1650434538.6510167,public.usertable,156491,34629,219160576,16560,public,usertable,1,0,338954,1261644,177198,16452,20707,6554,156491,34629,214357,177198,,,,,0,0,0,0
1650434539.6809177,public.usertable,156747,34659,219488256,16560,public,usertable,1,0,339726,1263947,177476,16471,20729,6562,156747,34659,214676,177476,,,,,0,0,0,0
1650434540.7093925,public.usertable,156959,34699,219750400,16560,public,usertable,1,0,340231,1265042,177709,16496,20750,6579,156959,34699,214955,177709,,,,,0,0,0,0
1650434541.7381349,public.usertable,157138,34734,220012544,16560,public,usertable,1,0,340826,1266905,177911,16517,20773,6592,157138,34734,215201,177911,,,,,0,0,0,0
1650434542.7670536,public.usertable,157326,34753,220258304,16560,public,usertable,1,0,341346,1267698,178114,16528,20788,6596,157326,34753,215430,178114,,,,,0,0,0,0
1650434543.7979524,public.usertable,157503,34775,220479488,16560,public,usertable,1,0,341826,1268773,178308,16540,20805,6603,157503,34775,215653,178308,,,,,0,0,0,0
1650434544.8275094,public.usertable,157661,34800,220692480,16560,public,usertable,1,0,342303,1269341,178481,16550,20820,6608,157661,34800,215851,178481,,,,,0,0,0,0
1650434545.8577654,public.usertable,157969,34851,221011968,16560,public,usertable,1,0,343173,1270892,178820,16576,20851,6621,157969,34851,216247,178820,,,,,0,0,0,0
1650434546.887808,public.usertable,158202,34892,221347840,16560,public,usertable,1,0,343952,1272662,179080,16598,20878,6629,158202,34892,216556,179080,,,,,0,0,0,0
1650434547.9186068,public.usertable,158437,34952,221683712,16560,public,usertable,1,0,344666,1273946,179346,16627,20909,6643,158437,34952,216882,179346,,,,,0,0,0,0
1650434548.95097,public.usertable,158692,34981,222019584,16560,public,usertable,1,0,345428,1274950,179626,16636,20934,6650,158692,34981,217196,179626,,,,,0,0,0,0
1650434549.977848,public.usertable,158931,35025,222363648,16560,public,usertable,1,0,346138,1277360,179895,16654,20964,6659,158931,35025,217513,179895,,,,,0,0,0,0
1650434551.0057366,public.usertable,159204,35076,222740480,16560,public,usertable,1,0,347099,1278929,180202,16676,20998,6668,159204,35076,217876,180202,,,,,0,0,0,0
1650434552.0338137,public.usertable,159445,35129,223100928,16560,public,usertable,1,0,347810,1279509,180474,16700,21029,6678,159445,35129,218203,180474,,,,,0,0,0,0
1650434553.0634356,public.usertable,159741,35179,223485952,16560,public,usertable,1,0,348596,1280812,180793,16731,21052,6691,159741,35179,218576,180793,,,,,0,0,0,0
1650434554.092059,public.usertable,159993,35234,223846400,16560,public,usertable,1,0,349452,1282121,181079,16757,21086,6705,159993,35234,218922,181079,,,,,0,0,0,0
1650434555.1213214,public.usertable,160242,35276,224190464,16560,public,usertable,1,0,350205,1282903,181357,16775,21115,6714,160242,35276,219247,181357,,,,,0,0,0,0
1650434556.1537352,public.usertable,160486,35315,224526336,16560,public,usertable,1,0,350954,1284127,181627,16794,21141,6726,160486,35315,219562,181627,,,,,0,0,0,0
1650434557.1831067,public.usertable,160773,35354,224911360,16560,public,usertable,1,0,351759,1284953,181941,16810,21168,6733,160773,35354,219919,181941,,,,,0,0,0,0
1650434558.2144587,public.usertable,161039,35397,225271808,16560,public,usertable,1,0,352500,1286088,182232,16830,21193,6741,161039,35397,220255,182232,,,,,0,0,0,0
1650434559.2466373,public.usertable,161267,35452,225615872,16560,public,usertable,1,0,353210,1287813,182493,16855,21226,6755,161267,35452,220574,182493,,,,,0,0,0,0
1650434560.2760243,public.usertable,161553,35509,225992704,16560,public,usertable,1,0,353982,1289660,182811,16880,21258,6768,161553,35509,220949,182811,,,,,0,0,0,0
1650434561.3055503,public.usertable,161787,35559,226344960,16560,public,usertable,1,0,354782,1291281,183075,16914,21288,6785,161787,35559,221277,183075,,,,,0,0,0,0
1650434562.3353906,public.usertable,162073,35603,226713600,16560,public,usertable,1,0,355674,1291807,183382,16944,21309,6806,162073,35603,221635,183382,,,,,0,0,0,0
1650434563.3647828,public.usertable,162329,35650,227090432,16560,public,usertable,1,0,356574,1292758,183667,16968,21338,6821,162329,35650,221973,183667,,,,,0,0,0,0
1650434564.3942719,public.usertable,162641,35680,227475456,16560,public,usertable,1,0,357364,1293137,183994,16986,21353,6832,162641,35680,222333,183994,,,,,0,0,0,0
1650434565.4237614,public.usertable,163026,35736,227819520,16560,public,usertable,1,0,358503,1297159,184418,17020,21392,6849,163026,35736,222830,184418,,,,,0,0,0,0
1650434566.4520013,public.usertable,163246,35781,228130816,16560,public,usertable,1,0,359221,1300473,184660,17047,21414,6859,163246,35781,223121,184660,,,,,0,0,0,0
1650434567.4806232,public.usertable,163559,35817,228540416,16560,public,usertable,1,0,360127,1302113,184995,17066,21436,6870,163559,35817,223497,184995,,,,,0,0,0,0
1650434568.512377,public.usertable,163847,35860,228933632,16560,public,usertable,1,0,360953,1304693,185307,17087,21460,6877,163847,35860,223854,185307,,,,,0,0,0,0
1650434569.542828,public.usertable,164125,35910,229326848,16560,public,usertable,1,0,361770,1307012,185616,17110,21491,6887,164125,35910,224217,185616,,,,,0,0,0,0
1650434570.5724542,public.usertable,164429,35959,229752832,16560,public,usertable,1,0,362722,1310303,185955,17138,21526,6901,164429,35959,224619,185955,,,,,0,0,0,0
1650434571.6014578,public.usertable,164708,36004,230105088,16560,public,usertable,1,0,363493,1313023,186258,17164,21550,6914,164708,36004,224972,186258,,,,,0,0,0,0
1650434572.6325366,public.usertable,164951,36043,230481920,16560,public,usertable,1,0,364250,1314184,186529,17179,21578,6919,164951,36043,225286,186529,,,,,0,0,0,0
1650434573.66206,public.usertable,165259,36081,230875136,16560,public,usertable,1,0,365033,1314845,186859,17197,21600,6927,165259,36081,225656,186859,,,,,0,0,0,0
1650434574.6904256,public.usertable,165521,36125,231243776,16560,public,usertable,1,0,365729,1316943,187150,17212,21629,6936,165521,36125,225991,187150,,,,,0,0,0,0
1650434575.719861,public.usertable,165815,36166,231636992,16560,public,usertable,1,0,366664,1318346,187478,17227,21663,6946,165815,36166,226368,187478,,,,,0,0,0,0
1650434576.7508278,public.usertable,166066,36229,231964672,16560,public,usertable,1,0,367501,1320077,187771,17250,21705,6953,166066,36229,226726,187771,,,,,0,0,0,0
1650434577.781155,public.usertable,166290,36287,232325120,16560,public,usertable,1,0,368292,1320437,188027,17279,21737,6970,166290,36287,227043,188027,,,,,0,0,0,0
1650434578.8133504,public.usertable,166536,36350,232660992,16560,public,usertable,1,0,369117,1321138,188312,17303,21776,6984,166536,36350,227391,188312,,,,,0,0,0,0
1650434579.843098,public.usertable,166775,36390,233005056,16560,public,usertable,1,0,369807,1321842,188576,17319,21801,6993,166775,36390,227696,188576,,,,,0,0,0,0
1650434580.8717222,public.usertable,167063,36430,233390080,16560,public,usertable,1,0,370650,1324057,188886,17342,21823,7006,167063,36430,228051,188886,,,,,0,0,0,0
1650434581.902487,public.usertable,167363,36471,233783296,16560,public,usertable,1,0,371489,1324979,189204,17366,21841,7019,167363,36471,228411,189204,,,,,0,0,0,0
1650434582.9335337,public.usertable,167619,36514,234135552,16560,public,usertable,1,0,372294,1325711,189487,17382,21868,7023,167619,36514,228737,189487,,,,,0,0,0,0
1650434583.962559,public.usertable,167873,36565,234512384,16560,public,usertable,1,0,373072,1327370,189775,17404,21902,7031,167873,36565,229081,189775,,,,,0,0,0,0
1650434584.994525,public.usertable,168299,36648,234905600,16560,public,usertable,1,0,374420,1328797,190243,17448,21944,7051,168299,36648,229635,190243,,,,,0,0,0,0
1650434586.0229287,public.usertable,168571,36701,235298816,16560,public,usertable,1,0,375196,1330142,190556,17466,21985,7061,168571,36701,230007,190556,,,,,0,0,0,0
1650434587.0513203,public.usertable,168845,36740,235659264,16560,public,usertable,1,0,375972,1332308,190854,17490,22009,7071,168845,36740,230353,190854,,,,,0,0,0,0
1650434588.0840733,public.usertable,169118,36788,236052480,16560,public,usertable,1,0,376798,1333972,191157,17514,22039,7084,169118,36788,230710,191157,,,,,0,0,0,0
1650434589.1158159,public.usertable,169425,36829,236470272,16560,public,usertable,1,0,377703,1335552,191488,17537,22063,7096,169425,36829,231088,191488,,,,,0,0,0,0
1650434590.145465,public.usertable,169735,36861,236863488,16560,public,usertable,1,0,378572,1338182,191828,17555,22093,7108,169735,36861,231476,191828,,,,,0,0,0,0
1650434591.1780117,public.usertable,170000,36912,237232128,16560,public,usertable,1,0,379322,1338649,192119,17583,22119,7126,170000,36912,231821,192119,,,,,0,0,0,0
1650434592.2089589,public.usertable,170273,36965,237608960,16560,public,usertable,1,0,380126,1339127,192416,17614,22143,7138,170273,36965,232173,192416,,,,,0,0,0,0
1650434593.240667,public.usertable,170540,37016,237969408,16560,public,usertable,1,0,380899,1340276,192714,17638,22174,7149,170540,37016,232526,192714,,,,,0,0,0,0
1650434594.2702222,public.usertable,170783,37053,238313472,16560,public,usertable,1,0,381589,1341342,192982,17658,22199,7164,170783,37053,232839,192982,,,,,0,0,0,0
1650434595.299763,public.usertable,171039,37102,238673920,16560,public,usertable,1,0,382325,1342003,193269,17676,22230,7168,171039,37102,233175,193269,,,,,0,0,0,0
1650434596.328717,public.usertable,171299,37131,239034368,16560,public,usertable,1,0,383039,1342933,193547,17694,22248,7175,171299,37131,233489,193547,,,,,0,0,0,0
1650434597.3571255,public.usertable,171556,37175,239362048,16560,public,usertable,1,0,383769,1344684,193833,17716,22277,7187,171556,37175,233826,193833,,,,,0,0,0,0
1650434598.3862734,public.usertable,171824,37208,239714304,16560,public,usertable,1,0,384599,1346364,194123,17731,22299,7195,171824,37208,234153,194123,,,,,0,0,0,0
1650434599.4184089,public.usertable,172079,37247,240082944,16560,public,usertable,1,0,385297,1347389,194398,17755,22319,7205,172079,37247,234472,194398,,,,,0,0,0,0
1650434600.4511592,public.usertable,172338,37292,240451584,16560,public,usertable,1,0,386107,1349627,194689,17774,22351,7214,172338,37292,234814,194689,,,,,0,0,0,0
1650434601.4799185,public.usertable,172630,37335,240844800,16560,public,usertable,1,0,386925,1351372,195008,17793,22378,7226,172630,37335,235179,195008,,,,,0,0,0,0
1650434602.5112998,public.usertable,172908,37389,241229824,16560,public,usertable,1,0,387850,1353725,195322,17824,22414,7246,172908,37389,235560,195322,,,,,0,0,0,0
1650434603.5400245,public.usertable,173191,37421,241582080,16560,public,usertable,1,0,388594,1355302,195624,17842,22433,7255,173191,37421,235899,195624,,,,,0,0,0,0
1650434604.5718186,public.usertable,173569,37476,241926144,16560,public,usertable,1,0,389677,1357550,196041,17862,22472,7263,173569,37476,236375,196041,,,,,0,0,0,0
1650434605.5996952,public.usertable,173784,37515,242221056,16560,public,usertable,1,0,390321,1358268,196276,17882,22492,7272,173784,37515,236650,196276,,,,,0,0,0,0
1650434606.6289513,public.usertable,174013,37544,242532352,16560,public,usertable,1,0,390901,1360312,196524,17899,22511,7281,174013,37544,236934,196524,,,,,0,0,0,0
1650434607.6592274,public.usertable,174241,37580,242860032,16560,public,usertable,1,0,391584,1360826,196775,17915,22534,7288,174241,37580,237224,196775,,,,,0,0,0,0
1650434608.687892,public.usertable,174485,37611,243179520,16560,public,usertable,1,0,392236,1362487,197042,17925,22557,7293,174485,37611,237524,197042,,,,,0,0,0,0
1650434609.7182324,public.usertable,174760,37654,243531776,16560,public,usertable,1,0,393054,1364035,197340,17947,22580,7306,174760,37654,237867,197340,,,,,0,0,0,0
1650434610.7491937,public.usertable,174999,37692,243884032,16560,public,usertable,1,0,393775,1364455,197600,17967,22601,7316,174999,37692,238168,197600,,,,,0,0,0,0
1650434611.7777834,public.usertable,175310,37722,244293632,16560,public,usertable,1,0,394660,1366736,197934,17986,22624,7325,175310,37722,238544,197934,,,,,0,0,0,0
1650434612.8063743,public.usertable,175610,37768,244711424,16560,public,usertable,1,0,395536,1369053,198266,18008,22656,7335,175610,37768,238930,198266,,,,,0,0,0,0
1650434613.836165,public.usertable,175936,37821,245161984,16560,public,usertable,1,0,396554,1371413,198629,18030,22693,7341,175936,37821,239352,198629,,,,,0,0,0,0
1650434614.8660278,public.usertable,176262,37872,245620736,16560,public,usertable,1,0,397570,1373409,198987,18055,22725,7354,176262,37872,239767,198987,,,,,0,0,0,0
1650434615.8972347,public.usertable,176601,37916,246054912,16560,public,usertable,1,0,398416,1374229,199343,18085,22742,7368,176601,37916,240170,199343,,,,,0,0,0,0
1650434616.9260926,public.usertable,176922,37972,246472704,16560,public,usertable,1,0,399302,1375672,199693,18113,22771,7382,176922,37972,240577,199693,,,,,0,0,0,0
1650434617.9585228,public.usertable,177215,37999,246865920,16560,public,usertable,1,0,400091,1376846,200008,18128,22793,7387,177215,37999,240929,200008,,,,,0,0,0,0
1650434618.9875453,public.usertable,177517,38047,247291904,16560,public,usertable,1,0,400989,1378581,200339,18157,22822,7397,177517,38047,241318,200339,,,,,0,0,0,0
1650434620.0160098,public.usertable,177807,38104,247676928,16560,public,usertable,1,0,401937,1380235,200665,18188,22858,7411,177807,38104,241711,200665,,,,,0,0,0,0
1650434621.0459783,public.usertable,178079,38134,248029184,16560,public,usertable,1,0,402728,1381407,200959,18204,22880,7419,178079,38134,242043,200959,,,,,0,0,0,0
1650434622.0744567,public.usertable,178337,38168,248389632,16560,public,usertable,1,0,403459,1382699,201231,18228,22894,7431,178337,38168,242353,201231,,,,,0,0,0,0
1650434623.1058354,public.usertable,178606,38215,248774656,16560,public,usertable,1,0,404210,1383898,201523,18255,22917,7442,178606,38215,242695,201523,,,,,0,0,0,0
1650434624.1351295,public.usertable,178886,38250,249151488,16560,public,usertable,1,0,405055,1385498,201829,18266,22943,7447,178886,38250,243038,201829,,,,,0,0,0,0
1650434625.17151,public.usertable,179315,38326,249536512,16560,public,usertable,1,0,406408,1388468,202299,18303,22984,7469,179315,38326,243586,202299,,,,,0,0,0,0
1650434626.2029836,public.usertable,179602,38363,249921536,16560,public,usertable,1,0,407288,1390448,202613,18322,23011,7477,179602,38363,243946,202613,,,,,0,0,0,0
1650434627.2338006,public.usertable,179840,38398,250241024,16560,public,usertable,1,0,407995,1392392,202869,18343,23029,7491,179840,38398,244241,202869,,,,,0,0,0,0
1650434628.2631938,public.usertable,180122,38446,250634240,16560,public,usertable,1,0,408848,1393464,203177,18369,23055,7501,180122,38446,244601,203177,,,,,0,0,0,0
1650434629.29266,public.usertable,180420,38484,251019264,16560,public,usertable,1,0,409632,1394630,203499,18385,23079,7512,180420,38484,244963,203499,,,,,0,0,0,0
1650434630.321232,public.usertable,180726,38520,251420672,16560,public,usertable,1,0,410420,1395981,203824,18406,23098,7524,180726,38520,245328,203824,,,,,0,0,0,0
1650434631.350886,public.usertable,181006,38557,251789312,16560,public,usertable,1,0,411232,1397392,204130,18419,23124,7532,181006,38557,245673,204130,,,,,0,0,0,0
1650434632.3791966,public.usertable,181237,38599,252125184,16560,public,usertable,1,0,411933,1398062,204381,18443,23144,7542,181237,38599,245968,204381,,,,,0,0,0,0
1650434633.4137173,public.usertable,181508,38637,252485632,16560,public,usertable,1,0,412786,1400907,204682,18465,23174,7553,181508,38637,246321,204682,,,,,0,0,0,0
1650434634.4438703,public.usertable,181786,38684,252878848,16560,public,usertable,1,0,413651,1402219,204991,18489,23205,7566,181786,38684,246685,204991,,,,,0,0,0,0
1650434635.4749296,public.usertable,182067,38729,253263872,16560,public,usertable,1,0,414448,1402870,205302,18505,23235,7574,182067,38729,247042,205302,,,,,0,0,0,0
1650434636.5048368,public.usertable,182381,38755,253657088,16560,public,usertable,1,0,415359,1404611,205637,18521,23256,7586,182381,38755,247414,205637,,,,,0,0,0,0
1650434637.5353732,public.usertable,182652,38804,254009344,16560,public,usertable,1,0,416131,1406017,205935,18545,23283,7602,182652,38804,247763,205935,,,,,0,0,0,0
1650434638.5670214,public.usertable,182933,38831,254361600,16560,public,usertable,1,0,416924,1407996,206231,18559,23298,7612,182933,38831,248088,206231,,,,,0,0,0,0
1650434639.5984006,public.usertable,183206,38873,254713856,16560,public,usertable,1,0,417738,1409981,206524,18583,23318,7621,183206,38873,248425,206524,,,,,0,0,0,0
1650434640.6266184,public.usertable,183423,38906,255016960,16560,public,usertable,1,0,418397,1411310,206765,18600,23342,7629,183423,38906,248707,206765,,,,,0,0,0,0
1650434641.6557384,public.usertable,183669,38923,255352832,16560,public,usertable,1,0,419083,1412687,207028,18614,23359,7637,183669,38923,249001,207028,,,,,0,0,0,0
1650434642.684358,public.usertable,183902,38957,255664128,16560,public,usertable,1,0,419791,1413985,207280,18633,23378,7647,183902,38957,249291,207280,,,,,0,0,0,0
1650434643.7127032,public.usertable,184146,38987,256000000,16560,public,usertable,1,0,420461,1414571,207540,18648,23394,7655,184146,38987,249582,207540,,,,,0,0,0,0
1650434644.741473,public.usertable,184395,39017,256327680,16560,public,usertable,1,0,421174,1415741,207811,18658,23416,7660,184395,39017,249885,207811,,,,,0,0,0,0
1650434645.7702203,public.usertable,184632,39062,256663552,16560,public,usertable,1,0,421936,1416422,208077,18676,23445,7669,184632,39062,250198,208077,,,,,0,0,0,0
1650434646.8020494,public.usertable,185006,39104,256991232,16560,public,usertable,1,0,422943,1418925,208480,18699,23474,7679,185006,39104,250653,208480,,,,,0,0,0,0
1650434647.833301,public.usertable,185260,39136,257327104,16560,public,usertable,1,0,423598,1420137,208750,18716,23490,7688,185260,39136,250956,208750,,,,,0,0,0,0
1650434648.8632216,public.usertable,185497,39168,257638400,16560,public,usertable,1,0,424254,1420474,209005,18732,23508,7701,185497,39168,251245,209005,,,,,0,0,0,0
1650434649.8918335,public.usertable,185787,39204,257998848,16560,public,usertable,1,0,425093,1422976,209312,18755,23525,7717,185787,39204,251592,209312,,,,,0,0,0,0
1650434650.9203053,public.usertable,186045,39233,258351104,16560,public,usertable,1,0,425777,1423812,209590,18767,23545,7722,186045,39233,251902,209590,,,,,0,0,0,0
1650434651.9503658,public.usertable,186313,39274,258719744,16560,public,usertable,1,0,426484,1424831,209886,18783,23573,7730,186313,39274,252242,209886,,,,,0,0,0,0
1650434652.9799635,public.usertable,186569,39309,259055616,16560,public,usertable,1,0,427224,1427209,210169,18799,23600,7739,186569,39309,252568,210169,,,,,0,0,0,0
1650434654.00899,public.usertable,186782,39357,259358720,16560,public,usertable,1,0,427982,1429211,210408,18825,23626,7754,186782,39357,252859,210408,,,,,0,0,0,0
1650434655.0393553,public.usertable,187017,39394,259678208,16560,public,usertable,1,0,428657,1430413,210664,18842,23647,7760,187017,39394,253153,210664,,,,,0,0,0,0
1650434656.0697293,public.usertable,187078,39414,259694592,16560,public,usertable,1,0,428888,1430500,210739,18850,23661,7766,187078,39414,253250,210739,,,,,0,0,0,0
1650434657.1005285,public.usertable,187078,39414,259694592,16560,public,usertable,1,0,428888,1430500,210739,18850,23661,7766,187078,39414,253250,210739,,,,,0,0,0,0
1650434658.1298444,public.usertable,187078,39414,259694592,16560,public,usertable,1,0,428888,1430500,210739,18850,23661,7766,187078,39414,253250,210739,,,,,0,0,0,0
